stay_date,hotel_key,lead_time,bing_ppc_brand,google_ppc_brand,total_vws
01/05/2021,242,3,153,973,1126
01/05/2021,47,3,31,107,138
01/05/2021,221,3,25,115,140
01/05/2021,488,3,24,113,137
01/05/2021,704,3,8,69,77
01/05/2021,759,3,20,95,115
01/05/2021,154,3,42,223,265
01/05/2021,18,3,48,205,253
01/05/2021,765,3,49,132,181
01/05/2021,751,3,8,29,37
01/05/2021,236,3,18,134,152
01/05/2021,826,3,51,300,351
01/05/2021,879,3,1,15,16
01/05/2021,823,3,43,151,194
01/05/2021,878,3,3,10,13
01/05/2021,265,3,54,171,225
01/05/2021,660,3,16,110,126
01/05/2021,371,3,23,121,144
01/05/2021,701,3,26,102,128
01/05/2021,514,3,18,74,92
01/05/2021,111,3,88,386,474
01/05/2021,391,3,59,297,356
01/05/2021,1,3,32,189,221
01/05/2021,865,3,30,211,241
01/05/2021,183,3,15,109,124
01/05/2021,228,3,57,193,250
01/05/2021,917,3,1,19,20
01/05/2021,106,3,97,614,711
01/05/2021,594,3,63,344,407
01/05/2021,755,3,55,445,500
01/05/2021,262,3,51,161,212
01/05/2021,617,3,27,83,110
01/05/2021,848,3,73,318,391
01/05/2021,519,3,43,225,268
01/05/2021,475,3,89,368,457
01/05/2021,451,3,170,680,850
01/05/2021,193,3,51,210,261
01/05/2021,932,3,0,4,4
01/05/2021,797,3,59,202,261
01/05/2021,360,3,30,162,192
01/05/2021,114,3,54,191,245
01/05/2021,79,3,40,183,223
01/05/2021,293,3,79,477,556
01/05/2021,637,3,90,511,601
01/05/2021,846,3,2,39,41
01/05/2021,43,3,42,273,315
01/05/2021,783,3,70,458,528
01/05/2021,907,3,81,334,415
01/05/2021,712,3,15,132,147
01/05/2021,280,3,12,46,58
01/05/2021,465,3,29,162,191
01/05/2021,824,3,39,141,180
01/05/2021,311,3,36,234,270
01/05/2021,333,3,87,1164,1251
01/05/2021,217,3,93,624,717
01/05/2021,566,3,13,98,111
01/05/2021,356,3,61,360,421
01/05/2021,500,3,13,58,71
01/05/2021,2,3,35,194,229
01/05/2021,486,3,47,180,227
01/05/2021,203,3,31,198,229
01/05/2021,158,3,26,115,141
01/05/2021,339,3,5,28,33
01/05/2021,53,3,46,171,217
01/05/2021,732,3,12,64,76
01/05/2021,96,3,43,332,375
01/05/2021,818,3,78,317,395
01/05/2021,531,3,45,217,262
01/05/2021,820,3,31,132,163
01/05/2021,441,3,48,138,186
01/05/2021,757,3,76,228,304
01/05/2021,830,3,128,537,665
01/05/2021,921,3,0,7,7
01/05/2021,643,3,37,212,249
01/05/2021,256,3,56,191,247
01/05/2021,791,3,42,174,216
01/05/2021,410,3,65,430,495
01/05/2021,386,3,94,607,701
01/05/2021,327,3,84,457,541
01/05/2021,490,3,15,40,55
01/05/2021,378,3,17,90,107
01/05/2021,537,3,69,302,371
01/05/2021,702,3,28,111,139
01/05/2021,558,3,12,79,91
01/05/2021,858,3,93,435,528
01/05/2021,613,3,10,78,88
01/05/2021,406,3,78,336,414
01/05/2021,93,3,45,217,262
01/05/2021,903,3,3,7,10
01/05/2021,398,3,10,47,57
01/05/2021,586,3,113,723,836
01/05/2021,504,3,17,110,127
01/05/2021,889,3,2,9,11
01/05/2021,795,3,30,149,179
01/05/2021,883,3,2,65,67
01/05/2021,492,3,25,71,96
01/05/2021,175,3,31,186,217
01/05/2021,477,3,16,84,100
01/05/2021,69,3,34,145,179
01/05/2021,688,3,48,169,217
01/05/2021,272,3,45,228,273
01/05/2021,248,3,47,381,428
01/05/2021,83,3,155,765,920
01/05/2021,402,3,72,320,392
01/05/2021,804,3,139,719,858
01/05/2021,479,3,17,81,98
01/05/2021,264,3,49,148,197
01/05/2021,408,3,31,135,166
01/05/2021,535,3,45,151,196
01/05/2021,104,3,56,241,297
01/05/2021,112,3,19,73,92
01/05/2021,934,3,0,10,10
01/05/2021,899,3,80,452,532
01/05/2021,901,3,0,3,3
01/05/2021,289,3,69,267,336
01/05/2021,61,3,29,279,308
01/05/2021,124,3,21,81,102
01/05/2021,30,3,49,195,244
01/05/2021,850,3,128,480,608
01/05/2021,185,3,20,112,132
01/05/2021,144,3,38,275,313
01/05/2021,842,3,7,11,18
01/05/2021,604,3,81,357,438
01/05/2021,225,3,53,166,219
01/05/2021,880,3,1,10,11
01/05/2021,346,3,16,72,88
01/05/2021,31,3,29,174,203
01/05/2021,664,3,62,230,292
01/05/2021,363,3,130,342,472
01/05/2021,160,3,9,36,45
01/05/2021,725,3,35,165,200
01/05/2021,21,3,53,272,325
01/05/2021,827,3,123,490,613
01/05/2021,618,3,42,141,183
01/05/2021,94,3,0,1,1
01/05/2021,845,3,29,97,126
01/05/2021,483,3,37,166,203
01/05/2021,208,3,14,75,89
01/05/2021,214,3,94,629,723
01/05/2021,719,3,23,71,94
01/05/2021,44,3,63,203,266
01/05/2021,532,3,154,791,945
01/05/2021,577,3,25,221,246
01/05/2021,874,3,14,26,40
01/05/2021,595,3,38,144,182
01/05/2021,876,3,0,6,6
01/05/2021,598,3,153,795,948
01/05/2021,584,3,114,610,724
01/05/2021,136,3,69,243,312
01/05/2021,362,3,128,346,474
01/05/2021,439,3,32,126,158
01/05/2021,686,3,22,158,180
01/05/2021,431,3,33,162,195
01/05/2021,714,3,36,218,254
01/05/2021,838,3,28,104,132
01/05/2021,647,3,17,137,154
01/05/2021,110,3,26,122,148
01/05/2021,484,3,29,133,162
01/05/2021,574,3,49,172,221
01/05/2021,404,3,64,320,384
01/05/2021,506,3,25,90,115
01/05/2021,382,3,0,6,6
01/05/2021,832,3,36,126,162
01/05/2021,352,3,54,182,236
01/05/2021,728,3,37,239,276
01/05/2021,658,3,29,203,232
01/05/2021,900,3,1,5,6
01/05/2021,918,3,2,6,8
01/05/2021,632,3,6,39,45
01/05/2021,675,3,30,132,162
01/05/2021,863,3,31,90,121
01/05/2021,60,3,6,60,66
01/05/2021,418,3,37,156,193
01/05/2021,194,3,1,7,8
01/05/2021,752,3,83,531,614
01/05/2021,534,3,18,130,148
01/05/2021,383,3,139,712,851
01/05/2021,681,3,42,177,219
01/05/2021,235,3,25,174,199
01/05/2021,877,3,1,17,18
01/05/2021,140,3,11,80,91
01/05/2021,453,3,31,177,208
01/05/2021,635,3,52,336,388
01/05/2021,692,3,27,47,74
01/05/2021,663,3,46,134,180
01/05/2021,463,3,115,453,568
01/05/2021,457,3,29,104,133
01/05/2021,840,3,13,143,156
01/05/2021,655,3,66,194,260
01/05/2021,461,3,32,140,172
01/05/2021,661,3,24,42,66
01/05/2021,469,3,35,267,302
01/05/2021,651,3,34,175,209
01/05/2021,580,3,46,241,287
01/05/2021,680,3,64,230,294
01/05/2021,517,3,26,83,109
01/05/2021,425,3,38,252,290
01/05/2021,421,3,113,457,570
01/05/2021,578,3,17,140,157
01/05/2021,694,3,23,110,133
01/05/2021,260,3,169,736,905
01/05/2021,24,3,20,86,106
01/05/2021,835,3,34,246,280
01/05/2021,121,3,120,478,598
01/05/2021,505,3,26,179,205
01/05/2021,837,3,128,552,680
01/05/2021,32,3,56,160,216
01/05/2021,831,3,22,149,171
01/05/2021,709,3,76,233,309
01/05/2021,257,3,122,493,615
01/05/2021,855,3,40,181,221
01/05/2021,176,3,46,211,257
01/05/2021,277,3,42,174,216
01/05/2021,103,3,112,418,530
01/05/2021,314,3,22,71,93
01/05/2021,434,3,5,48,53
01/05/2021,389,3,58,321,379
01/05/2021,336,3,102,436,538
01/05/2021,13,3,27,94,121
01/05/2021,377,3,30,135,165
01/05/2021,36,3,29,176,205
01/05/2021,273,3,66,320,386
01/05/2021,503,3,17,76,93
01/05/2021,405,3,30,215,245
01/05/2021,395,3,22,103,125
01/05/2021,605,3,81,430,511
01/05/2021,599,3,144,772,916
01/05/2021,283,3,28,164,192
01/05/2021,640,3,40,190,230
01/05/2021,468,3,32,169,201
01/05/2021,847,3,1,34,35
01/05/2021,819,3,50,281,331
01/05/2021,379,3,79,318,397
01/05/2021,849,3,27,252,279
01/05/2021,50,3,31,273,304
01/05/2021,573,3,47,169,216
01/05/2021,896,3,138,599,737
01/05/2021,23,3,21,94,115
01/05/2021,470,3,26,181,207
01/05/2021,801,3,39,194,233
01/05/2021,553,3,63,254,317
01/05/2021,197,3,61,229,290
01/05/2021,554,3,49,281,330
01/05/2021,270,3,15,90,105
01/05/2021,674,3,48,160,208
01/05/2021,307,3,40,252,292
01/05/2021,376,3,23,92,115
01/05/2021,35,3,33,189,222
01/05/2021,919,3,29,149,178
01/05/2021,372,3,106,354,460
01/05/2021,665,3,34,235,269
01/05/2021,85,3,68,142,210
01/05/2021,659,3,29,217,246
01/05/2021,627,3,21,78,99
01/05/2021,639,3,34,131,165
01/05/2021,295,3,24,90,114
01/05/2021,778,3,75,310,385
01/05/2021,420,3,137,592,729
01/05/2021,259,3,134,548,682
01/05/2021,151,3,28,143,171
01/05/2021,365,3,36,216,252
01/05/2021,817,3,33,167,200
01/05/2021,271,3,20,92,112
01/05/2021,593,3,102,547,649
01/05/2021,255,3,12,24,36
01/05/2021,243,3,157,981,1138
01/05/2021,689,3,49,221,270
01/05/2021,620,3,0,2,2
01/05/2021,526,3,19,67,86
01/05/2021,131,3,78,328,406
01/05/2021,190,3,37,137,174
01/05/2021,342,3,17,108,125
01/05/2021,184,3,20,110,130
01/05/2021,939,3,0,1,1
01/05/2021,513,3,32,183,215
01/05/2021,26,3,46,209,255
01/05/2021,317,3,89,393,482
01/05/2021,240,3,151,867,1018
01/05/2021,63,3,23,121,144
01/05/2021,576,3,6,44,50
01/05/2021,345,3,31,111,142
01/05/2021,148,3,41,223,264
01/05/2021,812,3,34,145,179
01/05/2021,810,3,15,37,52
01/05/2021,146,3,117,734,851
01/05/2021,116,3,57,201,258
01/05/2021,81,3,20,75,95
01/05/2021,388,3,63,304,367
01/05/2021,291,3,113,822,935
01/05/2021,645,3,32,185,217
01/05/2021,773,3,17,92,109
01/05/2021,552,3,63,254,317
01/05/2021,771,3,45,455,500
01/05/2021,351,3,91,362,453
01/05/2021,331,3,23,125,148
01/05/2021,606,3,42,269,311
01/05/2021,329,3,81,463,544
01/05/2021,301,3,137,828,965
01/05/2021,550,3,53,229,282
01/05/2021,814,3,22,96,118
01/05/2021,313,3,19,69,88
01/05/2021,808,3,85,447,532
01/05/2021,891,3,26,121,147
01/05/2021,911,3,6,34,40
01/05/2021,319,3,4,41,45
01/05/2021,299,3,64,333,397
01/05/2021,716,3,19,95,114
01/05/2021,724,3,118,497,615
01/05/2021,844,3,2,23,25
01/05/2021,459,3,43,154,197
01/05/2021,98,3,85,538,623
01/05/2021,698,3,59,464,523
01/05/2021,55,3,12,73,85
01/05/2021,181,3,19,92,111
01/05/2021,508,3,45,329,374
01/05/2021,856,3,28,114,142
01/05/2021,337,3,13,73,86
01/05/2021,335,3,15,143,158
01/05/2021,592,3,44,249,293
01/05/2021,869,3,123,334,457
01/05/2021,590,3,0,1,1
01/05/2021,254,3,24,111,135
01/05/2021,779,3,24,101,125
01/05/2021,867,3,20,142,162
01/05/2021,419,3,132,506,638
01/05/2021,207,3,18,93,111
01/05/2021,629,3,30,169,199
01/05/2021,396,3,18,73,91
01/05/2021,20,3,10,53,63
01/05/2021,781,3,124,803,927
01/05/2021,515,3,45,213,258
01/05/2021,65,3,26,261,287
01/05/2021,347,3,134,456,590
01/05/2021,224,3,61,193,254
01/05/2021,789,3,33,188,221
01/05/2021,130,3,91,293,384
01/05/2021,282,3,23,61,84
01/05/2021,676,3,13,96,109
01/05/2021,125,3,44,150,194
01/05/2021,196,3,15,37,52
01/05/2021,646,3,29,175,204
01/05/2021,774,3,17,87,104
01/05/2021,7,3,35,191,226
01/05/2021,798,3,85,282,367
01/05/2021,105,3,57,218,275
01/05/2021,157,3,49,205,254
01/05/2021,298,3,164,993,1157
01/05/2021,166,3,19,206,225
01/05/2021,935,3,0,1,1
01/05/2021,585,3,98,284,382
01/05/2021,123,3,21,101,122
01/05/2021,497,3,48,376,424
01/05/2021,884,3,2,58,60
01/05/2021,344,3,50,224,274
01/05/2021,756,3,62,445,507
01/05/2021,129,3,112,467,579
01/05/2021,428,3,33,134,167
01/05/2021,9,3,40,162,202
01/05/2021,115,3,20,89,109
01/05/2021,68,3,25,272,297
01/05/2021,662,3,82,298,380
01/05/2021,542,3,35,127,162
01/05/2021,135,3,71,253,324
01/05/2021,616,3,47,169,216
01/05/2021,933,3,0,1,1
01/05/2021,413,3,78,502,580
01/05/2021,648,3,31,152,183
01/05/2021,287,3,179,992,1171
01/05/2021,776,3,24,156,180
01/05/2021,153,3,40,223,263
01/05/2021,17,3,27,98,125
01/05/2021,607,3,126,882,1008
01/05/2021,147,3,36,253,289
01/05/2021,571,3,12,30,42
01/05/2021,864,3,19,118,137
01/05/2021,888,3,1,24,25
01/05/2021,198,3,45,192,237
01/05/2021,332,3,21,151,172
01/05/2021,361,3,124,338,462
01/05/2021,589,3,22,87,109
01/05/2021,42,3,22,82,104
01/05/2021,579,3,25,115,140
01/05/2021,58,3,87,690,777
01/05/2021,322,3,28,97,125
01/05/2021,438,3,24,117,141
01/05/2021,715,3,71,250,321
01/05/2021,509,3,38,302,340
01/05/2021,603,3,64,363,427
01/05/2021,308,3,40,219,259
01/05/2021,403,3,72,346,418
01/05/2021,218,3,97,632,729
01/05/2021,764,3,14,56,70
01/05/2021,472,3,70,253,323
01/05/2021,761,3,19,65,84
01/05/2021,471,3,23,75,98
01/05/2021,8,3,64,392,456
01/05/2021,303,3,100,645,745
01/05/2021,800,3,35,146,181
01/05/2021,546,3,27,91,118
01/05/2021,447,3,35,160,195
01/05/2021,268,3,60,294,354
01/05/2021,22,3,35,174,209
01/05/2021,730,3,17,91,108
01/05/2021,682,3,16,76,92
01/05/2021,244,3,76,443,519
01/05/2021,161,3,121,446,567
01/05/2021,37,3,27,80,107
01/05/2021,473,3,22,93,115
01/05/2021,802,3,89,503,592
01/05/2021,309,3,6,53,59
01/05/2021,195,3,31,87,118
01/05/2021,95,3,83,527,610
01/05/2021,443,3,38,215,253
01/05/2021,59,3,36,256,292
01/05/2021,612,3,129,814,943
01/05/2021,452,3,33,187,220
01/05/2021,426,3,32,114,146
01/05/2021,481,3,42,144,186
01/05/2021,326,3,8,53,61
01/05/2021,310,3,95,572,667
01/05/2021,227,3,59,217,276
01/05/2021,772,3,51,261,312
01/05/2021,127,3,19,95,114
01/05/2021,52,3,36,228,264
01/05/2021,861,3,57,130,187
01/05/2021,275,3,39,177,216
01/05/2021,906,3,7,15,22
01/05/2021,742,3,39,160,199
01/05/2021,691,3,22,170,192
01/05/2021,222,3,25,113,138
01/05/2021,237,3,133,697,830
01/05/2021,929,3,0,1,1
01/05/2021,458,3,40,117,157
01/05/2021,788,3,79,229,308
01/05/2021,318,3,74,338,412
01/05/2021,786,3,59,372,431
01/05/2021,155,3,102,689,791
01/05/2021,628,3,24,104,128
01/05/2021,54,3,27,76,103
01/05/2021,528,3,21,62,83
01/05/2021,489,3,14,41,55
01/05/2021,478,3,40,149,189
01/05/2021,565,3,102,427,529
01/05/2021,735,3,15,68,83
01/05/2021,178,3,50,218,268
01/05/2021,306,3,0,2,2
01/05/2021,279,3,28,124,152
01/05/2021,642,3,39,187,226
01/05/2021,760,3,35,203,238
01/05/2021,754,3,30,257,287
01/05/2021,518,3,29,79,108
01/05/2021,3,3,32,188,220
01/05/2021,292,3,149,947,1096
01/05/2021,464,3,109,479,588
01/05/2021,72,3,101,721,822
01/05/2021,202,3,67,474,541
01/05/2021,204,3,15,33,48
01/05/2021,422,3,76,459,535
01/05/2021,139,3,98,486,584
01/05/2021,622,3,119,493,612
01/05/2021,782,3,69,444,513
01/05/2021,92,3,28,172,200
01/05/2021,813,3,26,103,129
01/05/2021,685,3,48,162,210
01/05/2021,624,3,13,69,82
01/05/2021,703,3,20,69,89
01/05/2021,263,3,79,372,451
01/05/2021,233,3,42,183,225
01/05/2021,748,3,12,107,119
01/05/2021,216,3,21,97,118
01/05/2021,369,3,67,343,410
01/05/2021,731,3,17,96,113
01/05/2021,86,3,24,154,178
01/05/2021,381,3,4,6,10
01/05/2021,634,3,21,122,143
01/05/2021,440,3,52,151,203
01/05/2021,511,3,19,224,243
01/05/2021,487,3,33,131,164
01/05/2021,841,3,3,84,87
01/05/2021,583,3,47,241,288
01/05/2021,652,3,9,64,73
01/05/2021,145,3,35,219,254
01/05/2021,792,3,33,119,152
01/05/2021,922,3,0,6,6
01/05/2021,687,3,34,171,205
01/05/2021,25,3,29,167,196
01/05/2021,353,3,16,75,91
01/05/2021,46,3,19,82,101
01/05/2021,809,3,14,69,83
01/05/2021,200,3,22,145,167
01/05/2021,444,3,32,134,166
01/05/2021,677,3,21,95,116
01/05/2021,904,3,112,534,646
01/05/2021,448,3,175,705,880
01/05/2021,555,3,96,408,504
01/05/2021,119,3,96,403,499
01/05/2021,507,3,67,401,468
01/05/2021,581,3,43,198,241
01/05/2021,442,3,28,160,188
01/05/2021,133,3,31,215,246
01/05/2021,591,3,26,103,129
01/05/2021,608,3,146,924,1070
01/05/2021,231,3,33,107,140
01/05/2021,245,3,163,899,1062
01/05/2021,45,3,29,143,172
01/05/2021,134,3,69,243,312
01/05/2021,126,3,55,274,329
01/05/2021,412,3,40,299,339
01/05/2021,510,3,21,76,97
01/05/2021,706,3,73,202,275
01/05/2021,930,3,0,4,4
01/05/2021,543,3,126,534,660
01/05/2021,341,3,105,451,556
01/05/2021,199,3,11,57,68
01/05/2021,39,3,43,278,321
01/05/2021,582,3,140,748,888
01/05/2021,102,3,74,424,498
01/05/2021,743,3,19,85,104
01/05/2021,429,3,38,195,233
01/05/2021,250,3,115,290,405
01/05/2021,623,3,45,217,262
01/05/2021,392,3,23,95,118
01/05/2021,885,3,2,58,60
01/05/2021,177,3,16,99,115
01/05/2021,854,3,86,349,435
01/05/2021,767,3,131,801,932
01/05/2021,33,3,73,380,453
01/05/2021,588,3,25,95,120
01/05/2021,120,3,43,156,199
01/05/2021,366,3,25,80,105
01/05/2021,232,3,30,142,172
01/05/2021,274,3,0,14,14
01/05/2021,860,3,47,158,205
01/05/2021,108,3,23,101,124
01/05/2021,480,3,15,71,86
01/05/2021,354,3,3,9,12
01/05/2021,138,3,93,399,492
01/05/2021,51,3,92,523,615
01/05/2021,163,3,27,116,143
01/05/2021,909,3,2,11,13
01/05/2021,836,3,81,575,656
01/05/2021,684,3,33,160,193
01/05/2021,128,3,20,113,133
01/05/2021,213,3,94,609,703
01/05/2021,936,3,5,27,32
01/05/2021,266,3,18,90,108
01/05/2021,600,3,149,821,970
01/05/2021,321,3,26,107,133
01/05/2021,427,3,82,274,356
01/05/2021,252,3,15,84,99
01/05/2021,875,3,8,74,82
01/05/2021,417,3,84,536,620
01/05/2021,394,3,18,96,114
01/05/2021,433,3,153,657,810
01/05/2021,862,3,47,193,240
01/05/2021,167,3,56,301,357
01/05/2021,467,3,4,53,57
01/05/2021,739,3,11,82,93
01/05/2021,816,3,93,535,628
01/05/2021,12,3,22,52,74
01/05/2021,209,3,33,158,191
01/05/2021,496,3,21,81,102
01/05/2021,173,3,26,71,97
01/05/2021,529,3,24,110,134
01/05/2021,390,3,64,386,450
01/05/2021,142,3,23,61,84
01/05/2021,527,3,20,89,109
01/05/2021,881,3,0,12,12
01/05/2021,793,3,32,188,220
01/05/2021,928,3,0,1,1
01/05/2021,449,3,54,231,285
01/05/2021,671,3,62,415,477
01/05/2021,722,3,9,63,72
01/05/2021,602,3,93,446,539
01/05/2021,775,3,18,107,125
01/05/2021,41,3,36,243,279
01/05/2021,758,3,50,273,323
01/05/2021,430,3,25,145,170
01/05/2021,538,3,33,154,187
01/05/2021,563,3,27,114,141
01/05/2021,872,3,33,107,140
01/05/2021,839,3,27,180,207
01/05/2021,137,3,90,407,497
01/05/2021,113,3,21,83,104
01/05/2021,569,3,51,197,248
01/05/2021,373,3,28,112,140
01/05/2021,650,3,32,180,212
01/05/2021,551,3,69,265,334
01/05/2021,575,3,9,53,62
01/05/2021,302,3,113,811,924
01/05/2021,908,3,1,18,19
01/05/2021,367,3,40,266,306
01/05/2021,693,3,22,107,129
01/05/2021,727,3,51,192,243
01/05/2021,926,3,3,11,14
01/05/2021,387,3,48,197,245
01/05/2021,536,3,51,182,233
01/05/2021,914,3,0,9,9
01/05/2021,77,3,81,645,726
01/05/2021,564,3,41,176,217
01/05/2021,323,3,18,76,94
01/05/2021,887,3,1,14,15
01/05/2021,219,3,13,88,101
01/05/2021,75,3,98,734,832
01/05/2021,215,3,14,72,86
01/05/2021,556,3,101,437,538
01/05/2021,633,3,39,135,174
01/05/2021,384,3,48,216,264
01/05/2021,349,3,16,115,131
01/05/2021,619,3,40,131,171
01/05/2021,544,3,36,170,206
01/05/2021,359,3,41,155,196
01/05/2021,82,3,72,331,403
01/05/2021,495,3,30,93,123
01/05/2021,843,3,22,103,125
01/05/2021,328,3,24,119,143
01/05/2021,261,3,167,734,901
01/05/2021,892,3,18,26,44
01/05/2021,288,3,39,124,163
01/05/2021,910,3,2,57,59
01/05/2021,454,3,9,88,97
01/05/2021,631,3,6,35,41
01/05/2021,91,3,45,175,220
01/05/2021,205,3,27,174,201
01/05/2021,435,3,18,85,103
01/05/2021,737,3,12,79,91
01/05/2021,533,3,18,75,93
01/05/2021,374,3,26,101,127
01/05/2021,749,3,8,14,22
01/05/2021,625,3,23,116,139
01/05/2021,246,3,169,993,1162
01/05/2021,87,3,66,325,391
01/05/2021,572,3,47,155,202
01/05/2021,370,3,39,263,302
01/05/2021,710,3,15,126,141
01/05/2021,100,3,55,139,194
01/05/2021,122,3,46,161,207
01/05/2021,171,3,7,57,64
01/05/2021,89,3,48,223,271
01/05/2021,71,3,29,186,215
01/05/2021,745,3,27,135,162
01/05/2021,700,3,42,310,352
01/05/2021,615,3,49,250,299
01/05/2021,852,3,103,297,400
01/05/2021,753,3,54,458,512
01/05/2021,278,3,12,47,59
01/05/2021,493,3,35,108,143
01/05/2021,78,3,107,588,695
01/05/2021,338,3,29,188,217
01/05/2021,304,3,39,249,288
01/05/2021,330,3,31,189,220
01/05/2021,807,3,17,83,100
01/05/2021,212,3,103,655,758
01/05/2021,210,3,48,177,225
01/05/2021,117,3,103,426,529
01/05/2021,411,3,85,622,707
01/05/2021,902,3,26,111,137
01/05/2021,898,3,23,80,103
01/05/2021,853,3,27,75,102
01/05/2021,48,3,32,233,265
01/05/2021,833,3,28,67,95
01/05/2021,540,3,60,252,312
01/05/2021,312,3,35,116,151
01/05/2021,397,3,19,85,104
01/05/2021,768,3,92,769,861
01/05/2021,557,3,23,102,125
01/05/2021,348,3,20,63,83
01/05/2021,249,3,174,1085,1259
01/05/2021,851,3,21,55,76
01/05/2021,300,3,145,966,1111
01/05/2021,670,3,139,657,796
01/05/2021,401,3,17,103,120
01/05/2021,450,3,31,115,146
01/05/2021,182,3,27,127,154
01/05/2021,416,3,17,87,104
01/05/2021,446,3,27,161,188
01/05/2021,239,3,98,683,781
01/05/2021,491,3,54,371,425
01/05/2021,790,3,59,368,427
01/05/2021,882,3,1,2,3
01/05/2021,784,3,89,481,570
01/05/2021,267,3,23,99,122
01/05/2021,522,3,75,444,519
01/05/2021,707,3,71,198,269
01/05/2021,666,3,29,128,157
01/05/2021,296,3,46,156,202
01/05/2021,66,3,11,65,76
01/05/2021,281,3,26,102,128
01/05/2021,462,3,3,46,49
01/05/2021,247,3,131,794,925
01/05/2021,399,3,89,391,480
01/05/2021,162,3,125,443,568
01/05/2021,192,3,31,144,175
01/05/2021,269,3,18,76,94
01/05/2021,393,3,14,88,102
01/05/2021,186,3,47,152,199
01/05/2021,56,3,31,268,299
01/05/2021,825,3,59,201,260
01/05/2021,253,3,20,95,115
01/05/2021,251,3,25,111,136
01/05/2021,654,3,55,342,397
01/05/2021,683,3,43,193,236
01/05/2021,436,3,30,154,184
01/05/2021,15,3,78,347,425
01/05/2021,474,3,30,143,173
01/05/2021,350,3,17,106,123
01/05/2021,512,3,17,76,93
01/05/2021,597,3,13,76,89
01/05/2021,626,3,25,96,121
01/05/2021,84,3,107,333,440
01/05/2021,143,3,95,612,707
01/05/2021,34,3,25,94,119
01/05/2021,206,3,5,18,23
01/05/2021,385,3,52,158,210
01/05/2021,76,3,100,708,808
01/05/2021,699,3,37,137,174
01/05/2021,750,3,62,508,570
01/05/2021,805,3,31,86,117
01/05/2021,285,3,20,116,136
01/05/2021,180,3,24,94,118
01/05/2021,220,3,24,129,153
01/05/2021,886,3,0,10,10
01/05/2021,432,3,10,83,93
01/05/2021,294,3,62,259,321
01/05/2021,857,3,86,372,458
01/05/2021,286,3,45,246,291
01/05/2021,305,3,41,231,272
01/05/2021,276,3,27,101,128
01/05/2021,189,3,25,113,138
01/05/2021,570,3,37,204,241
01/05/2021,28,3,14,104,118
01/05/2021,777,3,26,133,159
01/05/2021,400,3,8,75,83
01/05/2021,895,3,26,91,117
01/05/2021,785,3,133,801,934
01/05/2021,897,3,10,20,30
01/05/2021,380,3,40,161,201
01/05/2021,423,3,116,1415,1531
01/05/2021,187,3,39,165,204
01/05/2021,238,3,151,926,1077
01/05/2021,696,3,37,145,182
01/05/2021,720,3,23,67,90
01/05/2021,649,3,43,105,148
01/05/2021,297,3,109,648,757
01/05/2021,169,3,29,242,271
01/05/2021,747,3,24,108,132
01/05/2021,726,3,19,125,144
01/05/2021,315,3,21,128,149
01/05/2021,548,3,32,122,154
01/05/2021,871,3,69,297,366
01/05/2021,234,3,32,150,182
01/05/2021,521,3,16,98,114
01/05/2021,118,3,74,314,388
01/05/2021,325,3,22,202,224
01/05/2021,873,3,44,214,258
01/05/2021,284,3,12,51,63
01/05/2021,787,3,152,848,1000
01/05/2021,230,3,46,150,196
01/05/2021,923,3,0,1,1
01/05/2021,799,3,7,32,39
01/05/2021,539,3,51,214,265
01/05/2021,734,3,16,114,130
01/05/2021,364,3,134,354,488
01/05/2021,6,3,32,200,232
01/05/2021,258,3,156,706,862
01/05/2021,49,3,31,226,257
01/05/2021,562,3,15,63,78
01/05/2021,641,3,19,45,64
01/05/2021,828,3,68,248,316
01/05/2021,343,3,18,89,107
01/05/2021,414,3,31,138,169
01/05/2021,621,3,20,82,102
01/05/2021,358,3,86,510,596
01/05/2021,905,3,3,7,10
01/05/2021,445,3,29,198,227
01/05/2021,494,3,24,169,193
01/05/2021,156,3,39,170,209
01/05/2021,179,3,23,123,146
01/05/2021,201,3,13,76,89
01/05/2021,653,3,9,68,77
01/05/2021,455,3,8,48,56
01/05/2021,741,3,10,74,84
01/05/2021,705,3,6,61,67
01/05/2021,780,3,159,832,991
01/05/2021,409,3,43,201,244
01/05/2021,866,3,80,513,593
01/05/2021,614,3,19,80,99
01/05/2021,717,3,25,108,133
01/05/2021,829,3,58,223,281
01/05/2021,711,3,14,124,138
01/05/2021,424,3,125,1396,1521
01/05/2021,70,3,93,696,789
01/05/2021,638,3,42,161,203
01/05/2021,170,3,32,255,287
01/05/2021,11,3,21,115,136
01/05/2021,149,3,47,239,286
01/05/2021,567,3,60,216,276
01/05/2021,524,3,43,182,225
01/05/2021,168,3,24,134,158
01/05/2021,547,3,134,555,689
01/05/2021,673,3,31,173,204
01/05/2021,561,3,14,71,85
01/05/2021,587,3,9,34,43
01/05/2021,721,3,161,858,1019
01/05/2021,90,3,30,159,189
01/05/2021,27,3,138,540,678
01/05/2021,811,3,19,100,119
01/05/2021,229,3,69,312,381
01/05/2021,159,3,64,462,526
01/05/2021,164,3,22,199,221
01/05/2021,770,3,122,720,842
01/05/2021,713,3,94,1269,1363
01/05/2021,736,3,7,47,54
01/05/2021,794,3,99,396,495
01/05/2021,746,3,19,114,133
01/05/2021,456,3,16,26,42
01/05/2021,931,3,0,2,2
01/05/2021,290,3,131,870,1001
01/05/2021,174,3,17,86,103
01/05/2021,916,3,0,1,1
01/05/2021,107,3,118,661,779
01/05/2021,559,3,105,425,530
01/05/2021,5,3,31,186,217
01/05/2021,407,3,60,412,472
01/05/2021,679,3,72,302,374
01/05/2021,821,3,71,231,302
01/05/2021,668,3,5,14,19
01/05/2021,38,3,39,265,304
01/05/2021,530,3,32,79,111
01/05/2021,316,3,18,152,170
01/05/2021,476,3,20,114,134
01/05/2021,357,3,80,478,558
01/05/2021,738,3,47,219,266
01/05/2021,485,3,26,131,157
01/05/2021,868,3,79,399,478
01/05/2021,466,3,30,161,191
01/05/2021,99,3,107,643,750
01/05/2021,723,3,37,148,185
01/05/2021,890,3,12,145,157
01/05/2021,101,3,75,515,590
01/05/2021,172,3,28,250,278
01/05/2021,815,3,150,752,902
01/05/2021,803,3,59,287,346
01/05/2021,334,3,84,391,475
01/05/2021,64,3,6,34,40
01/05/2021,460,3,35,120,155
01/05/2021,88,3,33,135,168
01/05/2021,19,3,54,293,347
01/05/2021,520,3,33,170,203
01/05/2021,152,3,38,258,296
01/05/2021,437,3,35,197,232
01/05/2021,525,3,45,190,235
01/05/2021,4,3,53,333,386
01/05/2021,915,3,1,10,11
01/05/2021,806,3,84,565,649
01/05/2021,67,3,23,231,254
01/05/2021,211,3,93,627,720
01/05/2021,57,3,27,299,326
01/05/2021,368,3,41,237,278
01/05/2021,657,3,55,293,348
01/05/2021,226,3,30,153,183
01/05/2021,560,3,98,416,514
01/05/2021,669,3,49,167,216
01/05/2021,498,3,31,93,124
01/05/2021,501,3,21,78,99
01/05/2021,656,3,23,150,173
01/05/2021,894,3,75,360,435
01/05/2021,188,3,32,157,189
01/05/2021,610,3,109,774,883
01/05/2021,499,3,41,228,269
01/05/2021,355,3,18,79,97
01/05/2021,97,3,70,285,355
01/05/2021,80,3,15,72,87
01/05/2021,870,3,9,48,57
01/05/2021,859,3,2,22,24
01/05/2021,697,3,63,484,547
01/05/2021,601,3,51,390,441
01/05/2021,340,3,10,40,50
01/05/2021,636,3,29,97,126
01/05/2021,733,3,14,98,112
02/05/2021,499,3,31,167,198
02/05/2021,80,3,7,52,59
02/05/2021,656,3,14,111,125
02/05/2021,870,3,5,30,35
02/05/2021,859,3,3,16,19
02/05/2021,601,3,49,259,308
02/05/2021,355,3,13,47,60
02/05/2021,733,3,8,60,68
02/05/2021,501,3,11,51,62
02/05/2021,610,3,66,510,576
02/05/2021,697,3,60,325,385
02/05/2021,894,3,70,253,323
02/05/2021,188,3,35,117,152
02/05/2021,340,3,4,30,34
02/05/2021,97,3,55,187,242
02/05/2021,636,3,13,70,83
02/05/2021,528,3,27,48,75
02/05/2021,786,3,50,265,315
02/05/2021,306,3,0,2,2
02/05/2021,628,3,20,84,104
02/05/2021,489,3,10,19,29
02/05/2021,318,3,76,262,338
02/05/2021,155,3,85,483,568
02/05/2021,478,3,31,132,163
02/05/2021,735,3,13,36,49
02/05/2021,279,3,33,103,136
02/05/2021,458,3,21,96,117
02/05/2021,565,3,98,296,394
02/05/2021,178,3,40,139,179
02/05/2021,54,3,21,53,74
02/05/2021,237,3,98,484,582
02/05/2021,788,3,57,178,235
02/05/2021,835,3,30,176,206
02/05/2021,434,3,5,40,45
02/05/2021,121,3,114,372,486
02/05/2021,831,3,16,104,120
02/05/2021,389,3,36,205,241
02/05/2021,837,3,94,347,441
02/05/2021,257,3,105,349,454
02/05/2021,505,3,25,128,153
02/05/2021,855,3,28,125,153
02/05/2021,32,3,40,113,153
02/05/2021,314,3,13,50,63
02/05/2021,277,3,30,101,131
02/05/2021,709,3,67,181,248
02/05/2021,103,3,89,235,324
02/05/2021,176,3,35,133,168
02/05/2021,402,3,72,244,316
02/05/2021,479,3,16,51,67
02/05/2021,104,3,39,156,195
02/05/2021,83,3,126,591,717
02/05/2021,264,3,37,89,126
02/05/2021,899,3,78,349,427
02/05/2021,688,3,29,116,145
02/05/2021,535,3,29,107,136
02/05/2021,248,3,45,285,330
02/05/2021,804,3,103,489,592
02/05/2021,272,3,29,147,176
02/05/2021,408,3,23,108,131
02/05/2021,112,3,16,61,77
02/05/2021,934,3,0,15,15
02/05/2021,755,3,46,356,402
02/05/2021,262,3,43,95,138
02/05/2021,183,3,17,53,70
02/05/2021,865,3,19,133,152
02/05/2021,594,3,56,241,297
02/05/2021,848,3,51,219,270
02/05/2021,106,3,76,437,513
02/05/2021,917,3,2,118,120
02/05/2021,193,3,28,124,152
02/05/2021,617,3,13,43,56
02/05/2021,451,3,130,434,564
02/05/2021,475,3,87,250,337
02/05/2021,519,3,34,162,196
02/05/2021,932,3,0,3,3
02/05/2021,228,3,28,111,139
02/05/2021,47,3,22,74,96
02/05/2021,242,3,124,693,817
02/05/2021,759,3,16,56,72
02/05/2021,704,3,5,44,49
02/05/2021,488,3,22,70,92
02/05/2021,879,3,1,15,16
02/05/2021,18,3,34,135,169
02/05/2021,826,3,29,195,224
02/05/2021,154,3,37,150,187
02/05/2021,751,3,3,11,14
02/05/2021,221,3,17,76,93
02/05/2021,236,3,7,72,79
02/05/2021,765,3,28,77,105
02/05/2021,514,3,14,63,77
02/05/2021,111,3,82,231,313
02/05/2021,391,3,37,198,235
02/05/2021,660,3,16,84,100
02/05/2021,265,3,43,100,143
02/05/2021,701,3,24,60,84
02/05/2021,878,3,1,6,7
02/05/2021,1,3,22,140,162
02/05/2021,823,3,30,112,142
02/05/2021,371,3,31,107,138
02/05/2021,398,3,9,31,40
02/05/2021,903,3,1,1,2
02/05/2021,504,3,21,71,92
02/05/2021,702,3,27,67,94
02/05/2021,378,3,15,65,80
02/05/2021,558,3,11,52,63
02/05/2021,858,3,91,318,409
02/05/2021,175,3,22,119,141
02/05/2021,613,3,13,62,75
02/05/2021,889,3,1,4,5
02/05/2021,406,3,64,202,266
02/05/2021,586,3,79,474,553
02/05/2021,883,3,3,270,273
02/05/2021,477,3,11,52,63
02/05/2021,795,3,24,114,138
02/05/2021,69,3,23,110,133
02/05/2021,537,3,64,183,247
02/05/2021,93,3,29,163,192
02/05/2021,492,3,18,48,66
02/05/2021,846,3,2,130,132
02/05/2021,797,3,57,153,210
02/05/2021,360,3,22,102,124
02/05/2021,907,3,76,197,273
02/05/2021,783,3,59,361,420
02/05/2021,465,3,19,103,122
02/05/2021,356,3,65,301,366
02/05/2021,280,3,12,52,64
02/05/2021,79,3,30,129,159
02/05/2021,637,3,85,392,477
02/05/2021,293,3,49,303,352
02/05/2021,824,3,29,87,116
02/05/2021,500,3,10,53,63
02/05/2021,114,3,36,145,181
02/05/2021,43,3,31,177,208
02/05/2021,311,3,28,161,189
02/05/2021,712,3,15,76,91
02/05/2021,333,3,68,849,917
02/05/2021,566,3,12,58,70
02/05/2021,217,3,65,411,476
02/05/2021,256,3,49,124,173
02/05/2021,830,3,120,413,533
02/05/2021,158,3,19,77,96
02/05/2021,818,3,84,274,358
02/05/2021,2,3,24,149,173
02/05/2021,203,3,20,125,145
02/05/2021,441,3,33,81,114
02/05/2021,327,3,67,352,419
02/05/2021,96,3,35,224,259
02/05/2021,410,3,39,304,343
02/05/2021,757,3,50,175,225
02/05/2021,820,3,19,81,100
02/05/2021,490,3,10,18,28
02/05/2021,386,3,70,411,481
02/05/2021,339,3,4,22,26
02/05/2021,921,3,0,1,1
02/05/2021,732,3,6,44,50
02/05/2021,486,3,28,98,126
02/05/2021,531,3,42,139,181
02/05/2021,53,3,44,133,177
02/05/2021,643,3,28,142,170
02/05/2021,791,3,33,117,150
02/05/2021,694,3,18,67,85
02/05/2021,425,3,24,140,164
02/05/2021,421,3,123,372,495
02/05/2021,517,3,27,57,84
02/05/2021,580,3,33,155,188
02/05/2021,461,3,18,89,107
02/05/2021,661,3,9,30,39
02/05/2021,578,3,18,94,112
02/05/2021,260,3,145,549,694
02/05/2021,24,3,9,42,51
02/05/2021,651,3,35,110,145
02/05/2021,469,3,20,167,187
02/05/2021,680,3,47,138,185
02/05/2021,719,3,16,46,62
02/05/2021,44,3,57,156,213
02/05/2021,577,3,13,148,161
02/05/2021,874,3,12,22,34
02/05/2021,595,3,28,98,126
02/05/2021,532,3,134,563,697
02/05/2021,876,3,0,2,2
02/05/2021,604,3,60,253,313
02/05/2021,124,3,12,43,55
02/05/2021,185,3,24,70,94
02/05/2021,842,3,8,13,21
02/05/2021,61,3,12,149,161
02/05/2021,144,3,30,180,210
02/05/2021,30,3,54,154,208
02/05/2021,289,3,49,154,203
02/05/2021,850,3,102,343,445
02/05/2021,31,3,25,113,138
02/05/2021,880,3,1,17,18
02/05/2021,21,3,36,181,217
02/05/2021,363,3,101,275,376
02/05/2021,214,3,67,410,477
02/05/2021,725,3,22,102,124
02/05/2021,845,3,16,56,72
02/05/2021,160,3,3,26,29
02/05/2021,225,3,28,107,135
02/05/2021,827,3,127,414,541
02/05/2021,483,3,26,99,125
02/05/2021,618,3,26,70,96
02/05/2021,346,3,12,42,54
02/05/2021,664,3,35,143,178
02/05/2021,208,3,10,54,64
02/05/2021,655,3,32,129,161
02/05/2021,692,3,18,30,48
02/05/2021,877,3,1,8,9
02/05/2021,635,3,43,216,259
02/05/2021,840,3,18,136,154
02/05/2021,140,3,10,47,57
02/05/2021,463,3,81,298,379
02/05/2021,663,3,28,87,115
02/05/2021,457,3,27,66,93
02/05/2021,453,3,22,123,145
02/05/2021,838,3,13,75,88
02/05/2021,714,3,35,136,171
02/05/2021,362,3,100,274,374
02/05/2021,136,3,46,197,243
02/05/2021,832,3,22,69,91
02/05/2021,382,3,3,1,4
02/05/2021,574,3,26,86,112
02/05/2021,439,3,28,86,114
02/05/2021,728,3,20,118,138
02/05/2021,404,3,61,227,288
02/05/2021,484,3,20,84,104
02/05/2021,686,3,24,98,122
02/05/2021,431,3,31,94,125
02/05/2021,110,3,14,78,92
02/05/2021,584,3,95,433,528
02/05/2021,598,3,136,614,750
02/05/2021,506,3,14,62,76
02/05/2021,647,3,14,79,93
02/05/2021,352,3,49,132,181
02/05/2021,418,3,28,101,129
02/05/2021,681,3,30,117,147
02/05/2021,658,3,22,160,182
02/05/2021,900,3,1,2,3
02/05/2021,675,3,19,94,113
02/05/2021,194,3,2,3,5
02/05/2021,60,3,2,34,36
02/05/2021,632,3,6,24,30
02/05/2021,918,3,1,3,4
02/05/2021,752,3,70,407,477
02/05/2021,534,3,16,87,103
02/05/2021,383,3,92,517,609
02/05/2021,235,3,29,156,185
02/05/2021,863,3,17,42,59
02/05/2021,326,3,6,36,42
02/05/2021,742,3,28,105,133
02/05/2021,906,3,6,9,15
02/05/2021,222,3,14,74,88
02/05/2021,452,3,32,118,150
02/05/2021,310,3,82,424,506
02/05/2021,127,3,14,63,77
02/05/2021,227,3,31,127,158
02/05/2021,691,3,25,118,143
02/05/2021,275,3,34,127,161
02/05/2021,481,3,28,83,111
02/05/2021,772,3,40,152,192
02/05/2021,52,3,31,128,159
02/05/2021,426,3,23,91,114
02/05/2021,612,3,86,530,616
02/05/2021,861,3,66,126,192
02/05/2021,911,3,4,18,22
02/05/2021,891,3,33,76,109
02/05/2021,698,3,57,327,384
02/05/2021,459,3,22,102,124
02/05/2021,181,3,21,62,83
02/05/2021,724,3,114,385,499
02/05/2021,913,3,1,0,1
02/05/2021,337,3,10,47,57
02/05/2021,808,3,65,303,368
02/05/2021,550,3,45,126,171
02/05/2021,301,3,96,506,602
02/05/2021,299,3,41,193,234
02/05/2021,814,3,21,56,77
02/05/2021,716,3,15,67,82
02/05/2021,313,3,12,43,55
02/05/2021,329,3,66,349,415
02/05/2021,319,3,9,36,45
02/05/2021,856,3,21,73,94
02/05/2021,55,3,7,44,51
02/05/2021,844,3,1,18,19
02/05/2021,98,3,59,372,431
02/05/2021,508,3,38,235,273
02/05/2021,674,3,30,113,143
02/05/2021,376,3,11,52,63
02/05/2021,85,3,68,113,181
02/05/2021,627,3,17,48,65
02/05/2021,554,3,41,183,224
02/05/2021,665,3,26,162,188
02/05/2021,372,3,71,266,337
02/05/2021,639,3,32,80,112
02/05/2021,919,3,21,88,109
02/05/2021,35,3,30,124,154
02/05/2021,270,3,15,75,90
02/05/2021,659,3,21,150,171
02/05/2021,295,3,11,44,55
02/05/2021,197,3,35,148,183
02/05/2021,307,3,36,178,214
02/05/2021,377,3,27,101,128
02/05/2021,640,3,33,122,155
02/05/2021,36,3,23,114,137
02/05/2021,283,3,25,110,135
02/05/2021,503,3,9,50,59
02/05/2021,273,3,66,278,344
02/05/2021,13,3,14,64,78
02/05/2021,599,3,131,592,723
02/05/2021,605,3,65,301,366
02/05/2021,395,3,23,66,89
02/05/2021,336,3,108,343,451
02/05/2021,468,3,20,116,136
02/05/2021,405,3,19,137,156
02/05/2021,470,3,18,104,122
02/05/2021,50,3,21,165,186
02/05/2021,849,3,17,149,166
02/05/2021,23,3,10,54,64
02/05/2021,379,3,67,212,279
02/05/2021,847,3,2,131,133
02/05/2021,896,3,131,473,604
02/05/2021,819,3,73,238,311
02/05/2021,553,3,45,148,193
02/05/2021,801,3,21,147,168
02/05/2021,573,3,32,91,123
02/05/2021,291,3,73,523,596
02/05/2021,645,3,22,112,134
02/05/2021,552,3,46,140,186
02/05/2021,388,3,39,172,211
02/05/2021,81,3,9,52,61
02/05/2021,351,3,73,275,348
02/05/2021,606,3,32,198,230
02/05/2021,773,3,19,75,94
02/05/2021,116,3,38,139,177
02/05/2021,771,3,34,309,343
02/05/2021,331,3,24,88,112
02/05/2021,259,3,118,422,540
02/05/2021,778,3,66,194,260
02/05/2021,271,3,8,51,59
02/05/2021,620,3,0,1,1
02/05/2021,184,3,23,58,81
02/05/2021,365,3,31,156,187
02/05/2021,689,3,43,145,188
02/05/2021,817,3,38,122,160
02/05/2021,190,3,30,105,135
02/05/2021,151,3,17,100,117
02/05/2021,342,3,13,67,80
02/05/2021,420,3,136,417,553
02/05/2021,526,3,28,51,79
02/05/2021,243,3,123,681,804
02/05/2021,593,3,92,391,483
02/05/2021,255,3,8,12,20
02/05/2021,131,3,54,233,287
02/05/2021,240,3,120,614,734
02/05/2021,576,3,8,29,37
02/05/2021,345,3,27,91,118
02/05/2021,513,3,28,132,160
02/05/2021,317,3,90,281,371
02/05/2021,63,3,20,64,84
02/05/2021,146,3,111,535,646
02/05/2021,148,3,39,151,190
02/05/2021,810,3,14,28,42
02/05/2021,26,3,37,129,166
02/05/2021,812,3,20,106,126
02/05/2021,195,3,22,46,68
02/05/2021,802,3,80,370,450
02/05/2021,95,3,72,409,481
02/05/2021,473,3,19,60,79
02/05/2021,161,3,101,320,421
02/05/2021,309,3,8,50,58
02/05/2021,59,3,30,144,174
02/05/2021,443,3,24,142,166
02/05/2021,37,3,22,48,70
02/05/2021,244,3,66,302,368
02/05/2021,428,3,26,95,121
02/05/2021,129,3,85,339,424
02/05/2021,68,3,17,148,165
02/05/2021,662,3,40,178,218
02/05/2021,9,3,30,108,138
02/05/2021,135,3,48,202,250
02/05/2021,884,3,3,261,264
02/05/2021,344,3,38,164,202
02/05/2021,542,3,24,97,121
02/05/2021,756,3,49,384,433
02/05/2021,616,3,32,98,130
02/05/2021,115,3,20,63,83
02/05/2021,207,3,10,62,72
02/05/2021,20,3,11,44,55
02/05/2021,224,3,33,111,144
02/05/2021,869,3,96,270,366
02/05/2021,419,3,109,343,452
02/05/2021,629,3,23,117,140
02/05/2021,65,3,15,150,165
02/05/2021,282,3,15,64,79
02/05/2021,130,3,64,221,285
02/05/2021,515,3,27,146,173
02/05/2021,396,3,20,53,73
02/05/2021,254,3,18,75,93
02/05/2021,347,3,108,329,437
02/05/2021,590,3,0,3,3
02/05/2021,779,3,24,56,80
02/05/2021,867,3,18,108,126
02/05/2021,781,3,96,549,645
02/05/2021,676,3,12,68,80
02/05/2021,592,3,45,167,212
02/05/2021,789,3,24,111,135
02/05/2021,335,3,17,102,119
02/05/2021,166,3,13,149,162
02/05/2021,646,3,19,101,120
02/05/2021,125,3,25,103,128
02/05/2021,774,3,18,67,85
02/05/2021,7,3,24,138,162
02/05/2021,298,3,104,619,723
02/05/2021,123,3,15,60,75
02/05/2021,157,3,37,143,180
02/05/2021,798,3,59,204,263
02/05/2021,497,3,37,240,277
02/05/2021,935,3,0,1,1
02/05/2021,105,3,41,134,175
02/05/2021,196,3,13,21,34
02/05/2021,585,3,65,214,279
02/05/2021,303,3,71,419,490
02/05/2021,761,3,10,52,62
02/05/2021,800,3,23,97,120
02/05/2021,447,3,27,115,142
02/05/2021,22,3,29,111,140
02/05/2021,471,3,14,53,67
02/05/2021,268,3,40,190,230
02/05/2021,8,3,53,271,324
02/05/2021,546,3,22,44,66
02/05/2021,682,3,10,55,65
02/05/2021,730,3,16,40,56
02/05/2021,607,3,79,596,675
02/05/2021,147,3,28,177,205
02/05/2021,17,3,17,52,69
02/05/2021,413,3,49,363,412
02/05/2021,589,3,21,57,78
02/05/2021,198,3,36,110,146
02/05/2021,332,3,21,101,122
02/05/2021,776,3,17,99,116
02/05/2021,888,3,2,119,121
02/05/2021,864,3,13,78,91
02/05/2021,42,3,12,47,59
02/05/2021,287,3,114,608,722
02/05/2021,153,3,36,155,191
02/05/2021,571,3,6,14,20
02/05/2021,361,3,98,269,367
02/05/2021,648,3,31,104,135
02/05/2021,218,3,71,413,484
02/05/2021,438,3,15,79,94
02/05/2021,764,3,7,35,42
02/05/2021,579,3,16,82,98
02/05/2021,472,3,52,163,215
02/05/2021,509,3,29,214,243
02/05/2021,715,3,51,175,226
02/05/2021,322,3,26,64,90
02/05/2021,603,3,51,259,310
02/05/2021,58,3,60,489,549
02/05/2021,403,3,76,249,325
02/05/2021,308,3,35,153,188
02/05/2021,4,3,50,257,307
02/05/2021,498,3,23,57,80
02/05/2021,806,3,63,375,438
02/05/2021,368,3,34,190,224
02/05/2021,152,3,28,175,203
02/05/2021,57,3,18,160,178
02/05/2021,437,3,35,157,192
02/05/2021,657,3,43,203,246
02/05/2021,525,3,43,140,183
02/05/2021,915,3,1,15,16
02/05/2021,211,3,66,411,477
02/05/2021,669,3,30,120,150
02/05/2021,226,3,31,110,141
02/05/2021,560,3,97,292,389
02/05/2021,67,3,16,114,130
02/05/2021,210,3,36,141,177
02/05/2021,338,3,24,135,159
02/05/2021,807,3,28,56,84
02/05/2021,78,3,101,418,519
02/05/2021,411,3,59,443,502
02/05/2021,493,3,30,65,95
02/05/2021,212,3,75,439,514
02/05/2021,117,3,114,342,456
02/05/2021,330,3,32,163,195
02/05/2021,304,3,35,183,218
02/05/2021,902,3,23,73,96
02/05/2021,173,3,23,54,77
02/05/2021,167,3,58,234,292
02/05/2021,816,3,89,406,495
02/05/2021,496,3,16,66,82
02/05/2021,390,3,40,249,289
02/05/2021,394,3,20,58,78
02/05/2021,12,3,14,30,44
02/05/2021,862,3,42,121,163
02/05/2021,209,3,17,115,132
02/05/2021,433,3,110,413,523
02/05/2021,527,3,33,57,90
02/05/2021,739,3,12,44,56
02/05/2021,142,3,20,51,71
02/05/2021,881,3,1,104,105
02/05/2021,529,3,33,74,107
02/05/2021,467,3,0,27,27
02/05/2021,46,3,31,54,85
02/05/2021,581,3,33,122,155
02/05/2021,687,3,37,123,160
02/05/2021,133,3,19,143,162
02/05/2021,245,3,131,659,790
02/05/2021,442,3,26,107,133
02/05/2021,119,3,72,285,357
02/05/2021,792,3,44,102,146
02/05/2021,555,3,93,283,376
02/05/2021,448,3,123,448,571
02/05/2021,809,3,15,49,64
02/05/2021,904,3,76,348,424
02/05/2021,677,3,13,62,75
02/05/2021,231,3,34,101,135
02/05/2021,608,3,94,613,707
02/05/2021,353,3,12,37,49
02/05/2021,25,3,29,89,118
02/05/2021,507,3,50,275,325
02/05/2021,922,3,0,1,1
02/05/2021,444,3,17,87,104
02/05/2021,200,3,19,98,117
02/05/2021,145,3,33,147,180
02/05/2021,652,3,8,24,32
02/05/2021,591,3,23,73,96
02/05/2021,3,3,22,140,162
02/05/2021,92,3,21,99,120
02/05/2021,813,3,33,72,105
02/05/2021,782,3,64,349,413
02/05/2021,518,3,13,46,59
02/05/2021,622,3,127,431,558
02/05/2021,202,3,53,372,425
02/05/2021,292,3,103,580,683
02/05/2021,642,3,31,117,148
02/05/2021,422,3,66,308,374
02/05/2021,139,3,74,323,397
02/05/2021,204,3,14,27,41
02/05/2021,464,3,85,321,406
02/05/2021,754,3,15,157,172
02/05/2021,72,3,67,491,558
02/05/2021,760,3,20,137,157
02/05/2021,685,3,31,113,144
02/05/2021,369,3,64,255,319
02/05/2021,440,3,43,102,145
02/05/2021,381,3,4,2,6
02/05/2021,511,3,18,157,175
02/05/2021,624,3,11,44,55
02/05/2021,731,3,14,59,73
02/05/2021,703,3,20,43,63
02/05/2021,841,3,4,278,282
02/05/2021,263,3,65,253,318
02/05/2021,634,3,21,80,101
02/05/2021,86,3,14,106,120
02/05/2021,216,3,21,61,82
02/05/2021,748,3,12,67,79
02/05/2021,583,3,26,150,176
02/05/2021,487,3,27,75,102
02/05/2021,233,3,33,123,156
02/05/2021,128,3,13,68,81
02/05/2021,936,3,4,20,24
02/05/2021,600,3,116,624,740
02/05/2021,213,3,70,427,497
02/05/2021,427,3,55,163,218
02/05/2021,909,3,0,11,11
02/05/2021,51,3,91,416,507
02/05/2021,321,3,20,63,83
02/05/2021,252,3,12,55,67
02/05/2021,836,3,54,408,462
02/05/2021,875,3,9,53,62
02/05/2021,138,3,80,301,381
02/05/2021,163,3,31,79,110
02/05/2021,684,3,38,114,152
02/05/2021,266,3,10,64,74
02/05/2021,354,3,1,5,6
02/05/2021,417,3,56,387,443
02/05/2021,582,3,114,540,654
02/05/2021,45,3,25,100,125
02/05/2021,134,3,46,196,242
02/05/2021,743,3,17,67,84
02/05/2021,126,3,38,192,230
02/05/2021,543,3,120,417,537
02/05/2021,412,3,21,209,230
02/05/2021,706,3,63,167,230
02/05/2021,930,3,0,7,7
02/05/2021,39,3,33,185,218
02/05/2021,199,3,10,49,59
02/05/2021,341,3,102,357,459
02/05/2021,510,3,10,35,45
02/05/2021,102,3,56,273,329
02/05/2021,250,3,87,223,310
02/05/2021,108,3,22,55,77
02/05/2021,392,3,23,59,82
02/05/2021,232,3,31,101,132
02/05/2021,120,3,25,110,135
02/05/2021,854,3,60,234,294
02/05/2021,588,3,21,69,90
02/05/2021,480,3,14,47,61
02/05/2021,860,3,41,101,142
02/05/2021,274,3,1,113,114
02/05/2021,767,3,132,612,744
02/05/2021,429,3,26,151,177
02/05/2021,885,3,3,261,264
02/05/2021,366,3,22,57,79
02/05/2021,623,3,30,139,169
02/05/2021,33,3,58,281,339
02/05/2021,177,3,12,64,76
02/05/2021,852,3,113,302,415
02/05/2021,122,3,27,115,142
02/05/2021,615,3,38,172,210
02/05/2021,370,3,30,204,234
02/05/2021,753,3,41,334,375
02/05/2021,171,3,10,50,60
02/05/2021,89,3,35,148,183
02/05/2021,71,3,17,124,141
02/05/2021,745,3,24,93,117
02/05/2021,700,3,40,254,294
02/05/2021,278,3,13,52,65
02/05/2021,710,3,14,72,86
02/05/2021,100,3,36,74,110
02/05/2021,926,3,2,8,10
02/05/2021,908,3,1,6,7
02/05/2021,536,3,38,126,164
02/05/2021,302,3,71,518,589
02/05/2021,693,3,15,72,87
02/05/2021,387,3,26,110,136
02/05/2021,914,3,0,6,6
02/05/2021,367,3,32,207,239
02/05/2021,727,3,31,134,165
02/05/2021,449,3,35,158,193
02/05/2021,793,3,24,119,143
02/05/2021,722,3,6,37,43
02/05/2021,671,3,40,287,327
02/05/2021,41,3,28,155,183
02/05/2021,602,3,68,314,382
02/05/2021,775,3,12,73,85
02/05/2021,575,3,7,35,42
02/05/2021,839,3,25,117,142
02/05/2021,569,3,33,111,144
02/05/2021,430,3,19,96,115
02/05/2021,551,3,50,159,209
02/05/2021,563,3,32,79,111
02/05/2021,758,3,33,201,234
02/05/2021,872,3,27,88,115
02/05/2021,373,3,24,74,98
02/05/2021,538,3,22,112,134
02/05/2021,650,3,22,116,138
02/05/2021,137,3,69,292,361
02/05/2021,113,3,18,44,62
02/05/2021,205,3,16,131,147
02/05/2021,631,3,5,25,30
02/05/2021,749,3,9,25,34
02/05/2021,435,3,16,62,78
02/05/2021,737,3,11,49,60
02/05/2021,533,3,15,32,47
02/05/2021,374,3,21,54,75
02/05/2021,91,3,28,89,117
02/05/2021,246,3,132,684,816
02/05/2021,625,3,20,66,86
02/05/2021,87,3,42,211,253
02/05/2021,572,3,30,92,122
02/05/2021,215,3,13,45,58
02/05/2021,544,3,30,94,124
02/05/2021,887,3,1,7,8
02/05/2021,633,3,14,92,106
02/05/2021,349,3,13,76,89
02/05/2021,323,3,16,44,60
02/05/2021,384,3,38,133,171
02/05/2021,619,3,42,90,132
02/05/2021,556,3,99,305,404
02/05/2021,564,3,34,110,144
02/05/2021,75,3,65,485,550
02/05/2021,77,3,56,372,428
02/05/2021,219,3,12,62,74
02/05/2021,82,3,66,247,313
02/05/2021,328,3,29,76,105
02/05/2021,288,3,22,66,88
02/05/2021,843,3,16,80,96
02/05/2021,892,3,11,25,36
02/05/2021,359,3,30,110,140
02/05/2021,261,3,143,547,690
02/05/2021,910,3,3,263,266
02/05/2021,495,3,24,56,80
02/05/2021,454,3,5,57,62
02/05/2021,460,3,28,89,117
02/05/2021,520,3,34,124,158
02/05/2021,334,3,65,273,338
02/05/2021,101,3,71,356,427
02/05/2021,64,3,4,15,19
02/05/2021,88,3,13,67,80
02/05/2021,803,3,42,196,238
02/05/2021,19,3,37,207,244
02/05/2021,815,3,121,570,691
02/05/2021,738,3,37,134,171
02/05/2021,890,3,7,69,76
02/05/2021,868,3,77,306,383
02/05/2021,723,3,31,115,146
02/05/2021,466,3,24,106,130
02/05/2021,485,3,20,83,103
02/05/2021,99,3,81,441,522
02/05/2021,172,3,23,191,214
02/05/2021,799,3,5,29,34
02/05/2021,521,3,22,53,75
02/05/2021,284,3,5,25,30
02/05/2021,325,3,17,140,157
02/05/2021,6,3,21,146,167
02/05/2021,923,3,0,1,1
02/05/2021,234,3,26,89,115
02/05/2021,230,3,27,69,96
02/05/2021,734,3,13,79,92
02/05/2021,258,3,130,532,662
02/05/2021,539,3,44,123,167
02/05/2021,118,3,52,214,266
02/05/2021,364,3,101,284,385
02/05/2021,873,3,34,121,155
02/05/2021,49,3,20,141,161
02/05/2021,787,3,126,631,757
02/05/2021,186,3,38,87,125
02/05/2021,15,3,64,211,275
02/05/2021,269,3,10,45,55
02/05/2021,162,3,101,320,421
02/05/2021,393,3,18,60,78
02/05/2021,192,3,25,91,116
02/05/2021,597,3,15,52,67
02/05/2021,251,3,26,84,110
02/05/2021,654,3,36,199,235
02/05/2021,399,3,84,236,320
02/05/2021,512,3,13,59,72
02/05/2021,253,3,14,74,88
02/05/2021,350,3,12,65,77
02/05/2021,683,3,38,121,159
02/05/2021,436,3,21,99,120
02/05/2021,474,3,29,75,104
02/05/2021,56,3,21,150,171
02/05/2021,247,3,88,510,598
02/05/2021,462,3,1,22,23
02/05/2021,825,3,33,136,169
02/05/2021,48,3,19,148,167
02/05/2021,833,3,21,45,66
02/05/2021,249,3,135,752,887
02/05/2021,557,3,17,66,83
02/05/2021,768,3,73,541,614
02/05/2021,540,3,47,145,192
02/05/2021,851,3,16,38,54
02/05/2021,898,3,20,55,75
02/05/2021,670,3,132,489,621
02/05/2021,312,3,35,80,115
02/05/2021,853,3,16,44,60
02/05/2021,397,3,20,54,74
02/05/2021,300,3,96,604,700
02/05/2021,348,3,12,48,60
02/05/2021,182,3,31,78,109
02/05/2021,267,3,12,62,74
02/05/2021,450,3,24,90,114
02/05/2021,491,3,44,243,287
02/05/2021,790,3,42,212,254
02/05/2021,784,3,75,352,427
02/05/2021,239,3,71,506,577
02/05/2021,66,3,3,22,25
02/05/2021,401,3,6,68,74
02/05/2021,416,3,10,53,63
02/05/2021,522,3,68,316,384
02/05/2021,446,3,27,155,182
02/05/2021,296,3,38,80,118
02/05/2021,707,3,64,164,228
02/05/2021,281,3,30,101,131
02/05/2021,666,3,22,77,99
02/05/2021,882,3,0,8,8
02/05/2021,649,3,35,71,106
02/05/2021,169,3,23,186,209
02/05/2021,720,3,19,41,60
02/05/2021,315,3,9,89,98
02/05/2021,747,3,22,72,94
02/05/2021,726,3,13,77,90
02/05/2021,548,3,28,83,111
02/05/2021,871,3,69,184,253
02/05/2021,297,3,69,401,470
02/05/2021,294,3,51,192,243
02/05/2021,857,3,72,273,345
02/05/2021,206,3,3,10,13
02/05/2021,626,3,18,53,71
02/05/2021,886,3,0,6,6
02/05/2021,750,3,50,405,455
02/05/2021,385,3,39,99,138
02/05/2021,285,3,17,61,78
02/05/2021,76,3,65,472,537
02/05/2021,84,3,96,260,356
02/05/2021,699,3,33,94,127
02/05/2021,432,3,4,55,59
02/05/2021,805,3,20,45,65
02/05/2021,220,3,16,89,105
02/05/2021,180,3,27,88,115
02/05/2021,143,3,93,401,494
02/05/2021,34,3,16,63,79
02/05/2021,696,3,27,90,117
02/05/2021,187,3,24,102,126
02/05/2021,400,3,4,44,48
02/05/2021,28,3,11,57,68
02/05/2021,895,3,21,59,80
02/05/2021,570,3,28,129,157
02/05/2021,238,3,119,666,785
02/05/2021,777,3,26,78,104
02/05/2021,305,3,36,160,196
02/05/2021,189,3,20,76,96
02/05/2021,423,3,99,1014,1113
02/05/2021,286,3,33,135,168
02/05/2021,897,3,9,7,16
02/05/2021,276,3,31,94,125
02/05/2021,785,3,106,609,715
02/05/2021,380,3,19,111,130
02/05/2021,107,3,88,460,548
02/05/2021,357,3,80,377,457
02/05/2021,38,3,28,169,197
02/05/2021,407,3,34,286,320
02/05/2021,316,3,20,131,151
02/05/2021,679,3,50,180,230
02/05/2021,5,3,21,136,157
02/05/2021,559,3,101,299,400
02/05/2021,290,3,87,540,627
02/05/2021,530,3,23,75,98
02/05/2021,174,3,12,49,61
02/05/2021,821,3,53,176,229
02/05/2021,668,3,3,11,14
02/05/2021,476,3,15,76,91
02/05/2021,70,3,63,468,531
02/05/2021,866,3,67,394,461
02/05/2021,409,3,32,144,176
02/05/2021,705,3,3,39,42
02/05/2021,717,3,23,72,95
02/05/2021,780,3,144,609,753
02/05/2021,638,3,43,136,179
02/05/2021,11,3,14,73,87
02/05/2021,170,3,25,197,222
02/05/2021,424,3,104,1027,1131
02/05/2021,614,3,20,61,81
02/05/2021,711,3,14,71,85
02/05/2021,829,3,42,142,184
02/05/2021,445,3,29,156,185
02/05/2021,562,3,14,32,46
02/05/2021,455,3,5,35,40
02/05/2021,201,3,10,59,69
02/05/2021,179,3,15,76,91
02/05/2021,156,3,38,122,160
02/05/2021,653,3,6,30,36
02/05/2021,741,3,10,48,58
02/05/2021,494,3,18,119,137
02/05/2021,621,3,25,82,107
02/05/2021,828,3,60,166,226
02/05/2021,905,3,7,5,12
02/05/2021,343,3,14,52,66
02/05/2021,641,3,15,28,43
02/05/2021,414,3,25,110,135
02/05/2021,358,3,87,409,496
02/05/2021,794,3,68,253,321
02/05/2021,149,3,40,161,201
02/05/2021,547,3,126,432,558
02/05/2021,168,3,22,100,122
02/05/2021,164,3,20,156,176
02/05/2021,770,3,126,528,654
02/05/2021,524,3,42,138,180
02/05/2021,736,3,7,27,34
02/05/2021,90,3,14,110,124
02/05/2021,587,3,5,29,34
02/05/2021,721,3,141,608,749
02/05/2021,561,3,12,46,58
02/05/2021,456,3,17,25,42
02/05/2021,159,3,39,331,370
02/05/2021,746,3,23,81,104
02/05/2021,27,3,141,415,556
02/05/2021,673,3,29,122,151
02/05/2021,567,3,39,114,153
02/05/2021,713,3,73,928,1001
02/05/2021,811,3,14,68,82
02/05/2021,229,3,66,185,251
03/05/2021,456,3,11,16,27
03/05/2021,229,3,28,78,106
03/05/2021,567,3,29,58,87
03/05/2021,159,3,28,88,116
03/05/2021,794,3,54,155,209
03/05/2021,770,3,58,163,221
03/05/2021,524,3,26,81,107
03/05/2021,561,3,5,27,32
03/05/2021,168,3,18,50,68
03/05/2021,721,3,120,281,401
03/05/2021,673,3,22,74,96
03/05/2021,811,3,21,54,75
03/05/2021,713,3,35,296,331
03/05/2021,547,3,119,264,383
03/05/2021,90,3,14,57,71
03/05/2021,746,3,18,53,71
03/05/2021,27,3,91,133,224
03/05/2021,736,3,3,14,17
03/05/2021,164,3,8,47,55
03/05/2021,937,3,1,0,1
03/05/2021,587,3,2,20,22
03/05/2021,149,3,28,68,96
03/05/2021,42,3,12,35,47
03/05/2021,153,3,15,63,78
03/05/2021,198,3,30,63,93
03/05/2021,413,3,22,125,147
03/05/2021,864,3,20,61,81
03/05/2021,607,3,54,201,255
03/05/2021,147,3,19,77,96
03/05/2021,17,3,8,27,35
03/05/2021,332,3,13,62,75
03/05/2021,776,3,18,48,66
03/05/2021,589,3,8,30,38
03/05/2021,648,3,21,46,67
03/05/2021,287,3,59,292,351
03/05/2021,571,3,1,6,7
03/05/2021,888,3,1,14,15
03/05/2021,361,3,81,129,210
03/05/2021,463,3,63,189,252
03/05/2021,877,3,2,10,12
03/05/2021,692,3,9,15,24
03/05/2021,453,3,20,65,85
03/05/2021,457,3,21,37,58
03/05/2021,840,3,22,97,119
03/05/2021,140,3,10,41,51
03/05/2021,635,3,17,74,91
03/05/2021,655,3,29,68,97
03/05/2021,663,3,24,50,74
03/05/2021,878,3,0,2,2
03/05/2021,823,3,16,37,53
03/05/2021,514,3,7,26,33
03/05/2021,391,3,33,87,120
03/05/2021,111,3,44,99,143
03/05/2021,660,3,13,47,60
03/05/2021,701,3,16,33,49
03/05/2021,265,3,16,40,56
03/05/2021,1,3,16,88,104
03/05/2021,371,3,17,42,59
03/05/2021,314,3,8,24,32
03/05/2021,389,3,30,93,123
03/05/2021,835,3,18,70,88
03/05/2021,277,3,23,48,71
03/05/2021,434,3,6,14,20
03/05/2021,831,3,29,99,128
03/05/2021,176,3,20,45,65
03/05/2021,121,3,105,234,339
03/05/2021,837,3,57,178,235
03/05/2021,709,3,43,68,111
03/05/2021,103,3,46,100,146
03/05/2021,855,3,24,73,97
03/05/2021,257,3,95,195,290
03/05/2021,32,3,30,58,88
03/05/2021,505,3,22,71,93
03/05/2021,733,3,10,47,57
03/05/2021,97,3,39,93,132
03/05/2021,601,3,26,71,97
03/05/2021,499,3,24,92,116
03/05/2021,636,3,15,30,45
03/05/2021,870,3,4,27,31
03/05/2021,340,3,11,12,23
03/05/2021,610,3,47,179,226
03/05/2021,501,3,7,34,41
03/05/2021,894,3,36,58,94
03/05/2021,697,3,26,70,96
03/05/2021,188,3,26,73,99
03/05/2021,80,3,11,34,45
03/05/2021,859,3,5,4,9
03/05/2021,355,3,14,30,44
03/05/2021,656,3,6,28,34
03/05/2021,178,3,22,45,67
03/05/2021,54,3,16,32,48
03/05/2021,458,3,20,54,74
03/05/2021,237,3,59,212,271
03/05/2021,155,3,31,122,153
03/05/2021,628,3,17,31,48
03/05/2021,318,3,30,74,104
03/05/2021,565,3,76,136,212
03/05/2021,786,3,31,88,119
03/05/2021,788,3,40,102,142
03/05/2021,478,3,16,18,34
03/05/2021,489,3,6,17,23
03/05/2021,279,3,27,90,117
03/05/2021,528,3,12,29,41
03/05/2021,735,3,6,19,25
03/05/2021,236,3,3,23,26
03/05/2021,488,3,9,27,36
03/05/2021,759,3,13,31,44
03/05/2021,751,3,2,2,4
03/05/2021,221,3,15,40,55
03/05/2021,765,3,20,56,76
03/05/2021,242,3,62,243,305
03/05/2021,154,3,13,56,69
03/05/2021,47,3,12,26,38
03/05/2021,826,3,26,85,111
03/05/2021,18,3,12,63,75
03/05/2021,704,3,4,28,32
03/05/2021,879,3,0,19,19
03/05/2021,112,3,15,42,57
03/05/2021,479,3,9,21,30
03/05/2021,934,3,0,17,17
03/05/2021,408,3,16,48,64
03/05/2021,535,3,19,42,61
03/05/2021,899,3,35,130,165
03/05/2021,804,3,61,217,278
03/05/2021,688,3,19,49,68
03/05/2021,264,3,22,39,61
03/05/2021,402,3,28,64,92
03/05/2021,248,3,23,88,111
03/05/2021,83,3,99,246,345
03/05/2021,272,3,12,73,85
03/05/2021,104,3,30,75,105
03/05/2021,193,3,25,58,83
03/05/2021,755,3,29,146,175
03/05/2021,183,3,16,38,54
03/05/2021,617,3,15,43,58
03/05/2021,917,3,1,12,13
03/05/2021,932,3,0,1,1
03/05/2021,106,3,42,123,165
03/05/2021,228,3,19,56,75
03/05/2021,519,3,17,68,85
03/05/2021,594,3,44,100,144
03/05/2021,865,3,6,30,36
03/05/2021,262,3,19,36,55
03/05/2021,848,3,18,80,98
03/05/2021,451,3,83,238,321
03/05/2021,475,3,63,111,174
03/05/2021,214,3,36,187,223
03/05/2021,725,3,26,76,102
03/05/2021,225,3,26,53,79
03/05/2021,21,3,14,84,98
03/05/2021,618,3,25,53,78
03/05/2021,31,3,25,75,100
03/05/2021,160,3,5,8,13
03/05/2021,845,3,19,50,69
03/05/2021,483,3,21,57,78
03/05/2021,208,3,6,37,43
03/05/2021,346,3,11,34,45
03/05/2021,363,3,84,135,219
03/05/2021,827,3,70,131,201
03/05/2021,880,3,0,18,18
03/05/2021,664,3,34,76,110
03/05/2021,327,3,45,136,181
03/05/2021,791,3,35,73,108
03/05/2021,53,3,45,68,113
03/05/2021,818,3,65,184,249
03/05/2021,203,3,9,57,66
03/05/2021,96,3,18,72,90
03/05/2021,386,3,49,156,205
03/05/2021,830,3,115,250,365
03/05/2021,256,3,18,39,57
03/05/2021,921,3,0,4,4
03/05/2021,158,3,17,58,75
03/05/2021,732,3,12,30,42
03/05/2021,2,3,17,92,109
03/05/2021,339,3,13,14,27
03/05/2021,490,3,6,18,24
03/05/2021,441,3,21,52,73
03/05/2021,820,3,17,59,76
03/05/2021,486,3,24,70,94
03/05/2021,757,3,37,92,129
03/05/2021,643,3,28,80,108
03/05/2021,531,3,25,65,90
03/05/2021,410,3,26,124,150
03/05/2021,477,3,9,38,47
03/05/2021,883,3,5,28,33
03/05/2021,537,3,27,71,98
03/05/2021,795,3,21,59,80
03/05/2021,175,3,13,43,56
03/05/2021,69,3,22,69,91
03/05/2021,586,3,44,202,246
03/05/2021,504,3,8,34,42
03/05/2021,406,3,33,82,115
03/05/2021,378,3,13,50,63
03/05/2021,858,3,65,139,204
03/05/2021,492,3,8,40,48
03/05/2021,93,3,36,121,157
03/05/2021,702,3,18,39,57
03/05/2021,903,3,0,1,1
03/05/2021,558,3,5,33,38
03/05/2021,398,3,4,5,9
03/05/2021,889,3,0,10,10
03/05/2021,613,3,9,32,41
03/05/2021,114,3,16,57,73
03/05/2021,712,3,13,37,50
03/05/2021,566,3,7,35,42
03/05/2021,311,3,25,70,95
03/05/2021,500,3,5,23,28
03/05/2021,356,3,36,99,135
03/05/2021,907,3,39,86,125
03/05/2021,43,3,16,82,98
03/05/2021,797,3,54,78,132
03/05/2021,637,3,36,142,178
03/05/2021,824,3,23,46,69
03/05/2021,217,3,33,175,208
03/05/2021,79,3,24,57,81
03/05/2021,293,3,31,137,168
03/05/2021,783,3,34,153,187
03/05/2021,846,3,1,22,23
03/05/2021,465,3,11,55,66
03/05/2021,333,3,31,239,270
03/05/2021,360,3,21,62,83
03/05/2021,280,3,11,57,68
03/05/2021,842,3,7,13,20
03/05/2021,30,3,49,70,119
03/05/2021,604,3,47,123,170
03/05/2021,185,3,25,46,71
03/05/2021,124,3,14,25,39
03/05/2021,144,3,35,97,132
03/05/2021,850,3,82,137,219
03/05/2021,289,3,20,64,84
03/05/2021,61,3,15,80,95
03/05/2021,680,3,20,49,69
03/05/2021,260,3,119,246,365
03/05/2021,694,3,17,49,66
03/05/2021,469,3,13,95,108
03/05/2021,425,3,16,90,106
03/05/2021,578,3,14,51,65
03/05/2021,421,3,82,136,218
03/05/2021,651,3,27,33,60
03/05/2021,661,3,11,17,28
03/05/2021,580,3,28,63,91
03/05/2021,517,3,11,17,28
03/05/2021,24,3,5,22,27
03/05/2021,461,3,5,23,28
03/05/2021,876,3,0,5,5
03/05/2021,532,3,115,254,369
03/05/2021,874,3,11,15,26
03/05/2021,719,3,13,29,42
03/05/2021,44,3,41,83,124
03/05/2021,595,3,15,41,56
03/05/2021,577,3,12,91,103
03/05/2021,800,3,13,41,54
03/05/2021,546,3,15,21,36
03/05/2021,268,3,35,80,115
03/05/2021,22,3,18,70,88
03/05/2021,682,3,10,33,43
03/05/2021,730,3,13,36,49
03/05/2021,471,3,11,39,50
03/05/2021,447,3,31,81,112
03/05/2021,8,3,25,81,106
03/05/2021,761,3,10,25,35
03/05/2021,303,3,33,188,221
03/05/2021,849,3,21,92,113
03/05/2021,896,3,123,282,405
03/05/2021,819,3,27,65,92
03/05/2021,50,3,8,36,44
03/05/2021,23,3,5,24,29
03/05/2021,553,3,34,71,105
03/05/2021,847,3,2,18,20
03/05/2021,470,3,23,63,86
03/05/2021,379,3,45,122,167
03/05/2021,573,3,21,46,67
03/05/2021,801,3,32,95,127
03/05/2021,275,3,19,60,79
03/05/2021,222,3,13,42,55
03/05/2021,426,3,27,53,80
03/05/2021,742,3,22,58,80
03/05/2021,227,3,21,62,83
03/05/2021,691,3,12,46,58
03/05/2021,326,3,7,35,42
03/05/2021,906,3,6,9,15
03/05/2021,310,3,55,157,212
03/05/2021,127,3,12,44,56
03/05/2021,452,3,31,67,98
03/05/2021,52,3,22,80,102
03/05/2021,772,3,24,81,105
03/05/2021,612,3,51,181,232
03/05/2021,861,3,63,91,154
03/05/2021,481,3,23,54,77
03/05/2021,404,3,58,128,186
03/05/2021,136,3,30,111,141
03/05/2021,686,3,18,59,77
03/05/2021,647,3,13,53,66
03/05/2021,439,3,24,48,72
03/05/2021,832,3,18,39,57
03/05/2021,110,3,10,43,53
03/05/2021,714,3,11,56,67
03/05/2021,598,3,93,247,340
03/05/2021,484,3,19,48,67
03/05/2021,431,3,30,57,87
03/05/2021,352,3,36,86,122
03/05/2021,838,3,13,30,43
03/05/2021,574,3,25,43,68
03/05/2021,362,3,79,131,210
03/05/2021,728,3,16,61,77
03/05/2021,382,3,0,1,1
03/05/2021,584,3,75,187,262
03/05/2021,506,3,12,39,51
03/05/2021,658,3,8,69,77
03/05/2021,418,3,16,28,44
03/05/2021,918,3,0,9,9
03/05/2021,675,3,11,46,57
03/05/2021,863,3,20,41,61
03/05/2021,681,3,11,47,58
03/05/2021,632,3,4,11,15
03/05/2021,534,3,11,44,55
03/05/2021,383,3,59,188,247
03/05/2021,60,3,4,26,30
03/05/2021,752,3,36,98,134
03/05/2021,194,3,2,2,4
03/05/2021,235,3,24,99,123
03/05/2021,405,3,6,33,39
03/05/2021,377,3,23,52,75
03/05/2021,36,3,24,75,99
03/05/2021,599,3,92,244,336
03/05/2021,13,3,18,34,52
03/05/2021,273,3,48,203,251
03/05/2021,605,3,56,139,195
03/05/2021,283,3,19,53,72
03/05/2021,468,3,15,74,89
03/05/2021,640,3,26,66,92
03/05/2021,336,3,107,213,320
03/05/2021,395,3,12,24,36
03/05/2021,503,3,5,28,33
03/05/2021,698,3,23,70,93
03/05/2021,724,3,111,246,357
03/05/2021,337,3,8,24,32
03/05/2021,891,3,15,56,71
03/05/2021,299,3,16,95,111
03/05/2021,459,3,27,61,88
03/05/2021,329,3,44,129,173
03/05/2021,716,3,11,41,52
03/05/2021,911,3,5,9,14
03/05/2021,814,3,15,43,58
03/05/2021,301,3,41,218,259
03/05/2021,550,3,33,64,97
03/05/2021,313,3,11,34,45
03/05/2021,844,3,2,8,10
03/05/2021,508,3,32,130,162
03/05/2021,181,3,17,33,50
03/05/2021,808,3,43,126,169
03/05/2021,856,3,25,33,58
03/05/2021,55,3,12,34,46
03/05/2021,319,3,10,23,33
03/05/2021,913,3,1,0,1
03/05/2021,98,3,37,112,149
03/05/2021,197,3,21,49,70
03/05/2021,639,3,22,49,71
03/05/2021,372,3,57,141,198
03/05/2021,307,3,18,71,89
03/05/2021,659,3,8,58,66
03/05/2021,85,3,71,71,142
03/05/2021,919,3,15,45,60
03/05/2021,35,3,32,76,108
03/05/2021,674,3,11,44,55
03/05/2021,554,3,19,69,88
03/05/2021,376,3,6,24,30
03/05/2021,627,3,18,39,57
03/05/2021,295,3,6,21,27
03/05/2021,665,3,15,70,85
03/05/2021,270,3,2,28,30
03/05/2021,196,3,5,9,14
03/05/2021,7,3,16,85,101
03/05/2021,774,3,17,49,66
03/05/2021,298,3,58,279,337
03/05/2021,497,3,38,146,184
03/05/2021,646,3,16,48,64
03/05/2021,798,3,36,101,137
03/05/2021,935,3,0,1,1
03/05/2021,123,3,17,44,61
03/05/2021,157,3,29,74,103
03/05/2021,105,3,28,65,93
03/05/2021,585,3,44,102,146
03/05/2021,166,3,7,44,51
03/05/2021,125,3,15,37,52
03/05/2021,812,3,17,52,69
03/05/2021,317,3,64,121,185
03/05/2021,63,3,11,25,36
03/05/2021,345,3,17,33,50
03/05/2021,26,3,20,42,62
03/05/2021,146,3,34,140,174
03/05/2021,240,3,58,234,292
03/05/2021,576,3,5,21,26
03/05/2021,513,3,25,70,95
03/05/2021,810,3,8,17,25
03/05/2021,148,3,21,57,78
03/05/2021,773,3,19,52,71
03/05/2021,552,3,37,77,114
03/05/2021,81,3,11,33,44
03/05/2021,331,3,12,51,63
03/05/2021,291,3,37,237,274
03/05/2021,116,3,9,39,48
03/05/2021,606,3,23,96,119
03/05/2021,351,3,63,101,164
03/05/2021,771,3,15,95,110
03/05/2021,388,3,35,90,125
03/05/2021,645,3,16,52,68
03/05/2021,778,3,32,73,105
03/05/2021,243,3,65,263,328
03/05/2021,342,3,11,59,70
03/05/2021,184,3,23,35,58
03/05/2021,255,3,4,8,12
03/05/2021,420,3,80,136,216
03/05/2021,131,3,23,84,107
03/05/2021,620,3,0,1,1
03/05/2021,190,3,23,71,94
03/05/2021,259,3,100,191,291
03/05/2021,365,3,24,65,89
03/05/2021,151,3,11,30,41
03/05/2021,526,3,12,31,43
03/05/2021,689,3,22,52,74
03/05/2021,593,3,77,192,269
03/05/2021,817,3,26,71,97
03/05/2021,271,3,11,37,48
03/05/2021,419,3,60,157,217
03/05/2021,867,3,10,57,67
03/05/2021,282,3,10,73,83
03/05/2021,20,3,9,20,29
03/05/2021,207,3,11,53,64
03/05/2021,781,3,36,127,163
03/05/2021,676,3,11,35,46
03/05/2021,789,3,22,65,87
03/05/2021,65,3,14,82,96
03/05/2021,130,3,37,122,159
03/05/2021,224,3,20,58,78
03/05/2021,396,3,9,14,23
03/05/2021,629,3,26,70,96
03/05/2021,590,3,0,1,1
03/05/2021,515,3,27,100,127
03/05/2021,869,3,81,134,215
03/05/2021,254,3,16,41,57
03/05/2021,779,3,9,19,28
03/05/2021,347,3,81,142,223
03/05/2021,335,3,31,98,129
03/05/2021,592,3,44,78,122
03/05/2021,244,3,36,94,130
03/05/2021,37,3,17,36,53
03/05/2021,443,3,17,84,101
03/05/2021,309,3,7,28,35
03/05/2021,195,3,11,24,35
03/05/2021,161,3,76,134,210
03/05/2021,59,3,18,68,86
03/05/2021,95,3,37,102,139
03/05/2021,802,3,40,104,144
03/05/2021,473,3,20,48,68
03/05/2021,115,3,13,44,57
03/05/2021,542,3,17,57,74
03/05/2021,884,3,3,22,25
03/05/2021,428,3,22,52,74
03/05/2021,135,3,31,115,146
03/05/2021,344,3,18,69,87
03/05/2021,662,3,31,81,112
03/05/2021,616,3,30,68,98
03/05/2021,9,3,24,67,91
03/05/2021,756,3,28,173,201
03/05/2021,129,3,25,96,121
03/05/2021,68,3,21,86,107
03/05/2021,933,3,0,1,1
03/05/2021,156,3,29,55,84
03/05/2021,905,3,0,3,3
03/05/2021,455,3,4,15,19
03/05/2021,494,3,19,46,65
03/05/2021,741,3,8,26,34
03/05/2021,358,3,46,144,190
03/05/2021,653,3,8,17,25
03/05/2021,828,3,40,53,93
03/05/2021,414,3,16,46,62
03/05/2021,621,3,22,82,104
03/05/2021,201,3,9,38,47
03/05/2021,343,3,13,43,56
03/05/2021,562,3,14,18,32
03/05/2021,179,3,10,35,45
03/05/2021,445,3,39,119,158
03/05/2021,641,3,8,21,29
03/05/2021,91,3,23,64,87
03/05/2021,205,3,8,68,76
03/05/2021,749,3,5,13,18
03/05/2021,737,3,8,26,34
03/05/2021,374,3,7,21,28
03/05/2021,631,3,3,13,16
03/05/2021,435,3,23,40,63
03/05/2021,87,3,39,94,133
03/05/2021,572,3,17,42,59
03/05/2021,625,3,16,39,55
03/05/2021,246,3,63,254,317
03/05/2021,533,3,8,14,22
03/05/2021,624,3,10,27,37
03/05/2021,583,3,12,76,88
03/05/2021,511,3,18,92,110
03/05/2021,233,3,13,46,59
03/05/2021,703,3,15,31,46
03/05/2021,634,3,31,80,111
03/05/2021,841,3,4,32,36
03/05/2021,369,3,46,100,146
03/05/2021,440,3,16,34,50
03/05/2021,685,3,20,42,62
03/05/2021,263,3,22,78,100
03/05/2021,487,3,20,45,65
03/05/2021,731,3,13,49,62
03/05/2021,748,3,11,43,54
03/05/2021,381,3,3,4,7
03/05/2021,216,3,14,54,68
03/05/2021,86,3,15,57,72
03/05/2021,212,3,40,193,233
03/05/2021,338,3,28,112,140
03/05/2021,304,3,19,71,90
03/05/2021,411,3,27,143,170
03/05/2021,117,3,84,115,199
03/05/2021,493,3,19,50,69
03/05/2021,78,3,95,238,333
03/05/2021,210,3,16,86,102
03/05/2021,330,3,29,112,141
03/05/2021,807,3,12,34,46
03/05/2021,902,3,15,38,53
03/05/2021,308,3,18,60,78
03/05/2021,472,3,27,59,86
03/05/2021,438,3,15,63,78
03/05/2021,58,3,27,141,168
03/05/2021,218,3,35,186,221
03/05/2021,403,3,31,66,97
03/05/2021,509,3,25,115,140
03/05/2021,579,3,7,19,26
03/05/2021,764,3,12,21,33
03/05/2021,322,3,25,48,73
03/05/2021,603,3,44,111,155
03/05/2021,715,3,37,81,118
03/05/2021,67,3,22,69,91
03/05/2021,657,3,40,85,125
03/05/2021,498,3,16,43,59
03/05/2021,368,3,15,61,76
03/05/2021,57,3,22,91,113
03/05/2021,152,3,20,78,98
03/05/2021,437,3,33,109,142
03/05/2021,669,3,13,47,60
03/05/2021,525,3,27,75,102
03/05/2021,4,3,24,56,80
03/05/2021,915,3,1,19,20
03/05/2021,226,3,16,54,70
03/05/2021,560,3,73,131,204
03/05/2021,806,3,38,129,167
03/05/2021,211,3,34,184,218
03/05/2021,422,3,19,82,101
03/05/2021,92,3,25,57,82
03/05/2021,139,3,22,84,106
03/05/2021,204,3,6,12,18
03/05/2021,72,3,43,175,218
03/05/2021,202,3,32,150,182
03/05/2021,622,3,69,137,206
03/05/2021,760,3,16,53,69
03/05/2021,464,3,55,158,213
03/05/2021,813,3,16,48,64
03/05/2021,3,3,17,84,101
03/05/2021,518,3,13,44,57
03/05/2021,754,3,21,99,120
03/05/2021,642,3,24,66,90
03/05/2021,292,3,53,279,332
03/05/2021,782,3,39,142,181
03/05/2021,142,3,14,29,43
03/05/2021,496,3,6,31,37
03/05/2021,394,3,11,19,30
03/05/2021,529,3,15,52,67
03/05/2021,209,3,6,62,68
03/05/2021,12,3,11,25,36
03/05/2021,739,3,9,27,36
03/05/2021,173,3,6,36,42
03/05/2021,881,3,0,15,15
03/05/2021,167,3,29,61,90
03/05/2021,433,3,67,214,281
03/05/2021,816,3,45,155,200
03/05/2021,862,3,25,71,96
03/05/2021,390,3,28,99,127
03/05/2021,527,3,13,36,49
03/05/2021,467,3,2,10,12
03/05/2021,507,3,46,163,209
03/05/2021,245,3,71,267,338
03/05/2021,904,3,43,176,219
03/05/2021,353,3,12,20,32
03/05/2021,145,3,9,56,65
03/05/2021,581,3,23,66,89
03/05/2021,25,3,23,62,85
03/05/2021,442,3,19,66,85
03/05/2021,677,3,11,39,50
03/05/2021,133,3,7,32,39
03/05/2021,444,3,25,55,80
03/05/2021,200,3,18,58,76
03/05/2021,46,3,12,32,44
03/05/2021,591,3,12,36,48
03/05/2021,792,3,37,50,87
03/05/2021,608,3,60,208,268
03/05/2021,448,3,75,241,316
03/05/2021,809,3,12,44,56
03/05/2021,922,3,0,4,4
03/05/2021,555,3,71,128,199
03/05/2021,119,3,22,85,107
03/05/2021,687,3,26,76,102
03/05/2021,652,3,13,19,32
03/05/2021,231,3,27,88,115
03/05/2021,551,3,37,79,116
03/05/2021,538,3,20,72,92
03/05/2021,872,3,17,33,50
03/05/2021,430,3,23,57,80
03/05/2021,137,3,23,85,108
03/05/2021,575,3,5,19,24
03/05/2021,569,3,25,57,82
03/05/2021,650,3,27,94,121
03/05/2021,373,3,9,51,60
03/05/2021,113,3,12,24,36
03/05/2021,758,3,17,89,106
03/05/2021,839,3,20,93,113
03/05/2021,563,3,14,50,64
03/05/2021,767,3,60,169,229
03/05/2021,429,3,32,107,139
03/05/2021,392,3,13,25,38
03/05/2021,854,3,50,144,194
03/05/2021,232,3,16,49,65
03/05/2021,120,3,14,44,58
03/05/2021,177,3,8,31,39
03/05/2021,366,3,18,26,44
03/05/2021,108,3,12,25,37
03/05/2021,274,3,0,28,28
03/05/2021,480,3,12,20,32
03/05/2021,250,3,73,125,198
03/05/2021,588,3,10,35,45
03/05/2021,860,3,30,51,81
03/05/2021,33,3,19,77,96
03/05/2021,885,3,3,22,25
03/05/2021,623,3,29,61,90
03/05/2021,875,3,14,46,60
03/05/2021,252,3,12,44,56
03/05/2021,138,3,22,85,107
03/05/2021,936,3,4,8,12
03/05/2021,321,3,9,25,34
03/05/2021,417,3,29,138,167
03/05/2021,51,3,50,145,195
03/05/2021,427,3,30,66,96
03/05/2021,128,3,13,49,62
03/05/2021,836,3,30,138,168
03/05/2021,600,3,56,240,296
03/05/2021,213,3,40,196,236
03/05/2021,354,3,1,4,5
03/05/2021,684,3,24,74,98
03/05/2021,163,3,18,41,59
03/05/2021,266,3,9,39,48
03/05/2021,909,3,0,5,5
03/05/2021,341,3,97,220,317
03/05/2021,45,3,21,57,78
03/05/2021,412,3,13,85,98
03/05/2021,743,3,11,35,46
03/05/2021,126,3,18,83,101
03/05/2021,510,3,5,27,32
03/05/2021,543,3,115,251,366
03/05/2021,930,3,0,8,8
03/05/2021,102,3,38,111,149
03/05/2021,582,3,99,240,339
03/05/2021,706,3,43,61,104
03/05/2021,39,3,16,81,97
03/05/2021,199,3,10,32,42
03/05/2021,134,3,30,109,139
03/05/2021,793,3,25,96,121
03/05/2021,775,3,16,49,65
03/05/2021,449,3,35,106,141
03/05/2021,41,3,11,66,77
03/05/2021,602,3,60,150,210
03/05/2021,722,3,6,29,35
03/05/2021,671,3,26,162,188
03/05/2021,753,3,22,78,100
03/05/2021,71,3,16,60,76
03/05/2021,710,3,11,36,47
03/05/2021,370,3,13,68,81
03/05/2021,89,3,31,72,103
03/05/2021,615,3,17,75,92
03/05/2021,278,3,8,54,62
03/05/2021,852,3,82,90,172
03/05/2021,100,3,19,28,47
03/05/2021,171,3,7,21,28
03/05/2021,745,3,17,57,74
03/05/2021,122,3,17,45,62
03/05/2021,700,3,22,61,83
03/05/2021,302,3,35,236,271
03/05/2021,367,3,14,71,85
03/05/2021,908,3,3,3,6
03/05/2021,693,3,12,38,50
03/05/2021,727,3,12,56,68
03/05/2021,387,3,23,61,84
03/05/2021,914,3,0,2,2
03/05/2021,536,3,16,46,62
03/05/2021,926,3,0,2,2
03/05/2021,614,3,19,35,54
03/05/2021,70,3,37,151,188
03/05/2021,638,3,24,52,76
03/05/2021,829,3,19,67,86
03/05/2021,705,3,3,25,28
03/05/2021,717,3,17,47,64
03/05/2021,11,3,14,51,65
03/05/2021,711,3,11,37,48
03/05/2021,780,3,68,170,238
03/05/2021,409,3,19,40,59
03/05/2021,866,3,37,97,134
03/05/2021,424,3,47,268,315
03/05/2021,170,3,14,68,82
03/05/2021,239,3,30,159,189
03/05/2021,522,3,26,73,99
03/05/2021,784,3,43,147,190
03/05/2021,882,3,0,15,15
03/05/2021,666,3,23,52,75
03/05/2021,491,3,40,145,185
03/05/2021,267,3,12,42,54
03/05/2021,450,3,26,54,80
03/05/2021,446,3,21,101,122
03/05/2021,790,3,30,114,144
03/05/2021,182,3,17,40,57
03/05/2021,416,3,11,32,43
03/05/2021,66,3,4,11,15
03/05/2021,401,3,6,42,48
03/05/2021,707,3,40,62,102
03/05/2021,281,3,25,89,114
03/05/2021,296,3,16,39,55
03/05/2021,520,3,14,34,48
03/05/2021,172,3,14,67,81
03/05/2021,334,3,58,131,189
03/05/2021,723,3,21,55,76
03/05/2021,466,3,19,55,74
03/05/2021,460,3,25,47,72
03/05/2021,738,3,22,50,72
03/05/2021,803,3,22,87,109
03/05/2021,99,3,50,141,191
03/05/2021,868,3,76,128,204
03/05/2021,890,3,5,26,31
03/05/2021,815,3,90,223,313
03/05/2021,88,3,14,56,70
03/05/2021,485,3,20,49,69
03/05/2021,64,3,3,7,10
03/05/2021,101,3,28,100,128
03/05/2021,19,3,15,92,107
03/05/2021,556,3,76,141,217
03/05/2021,887,3,0,9,9
03/05/2021,544,3,23,40,63
03/05/2021,564,3,25,61,86
03/05/2021,349,3,11,29,40
03/05/2021,323,3,15,31,46
03/05/2021,633,3,6,45,51
03/05/2021,75,3,37,154,191
03/05/2021,215,3,10,38,48
03/05/2021,619,3,24,24,48
03/05/2021,384,3,20,54,74
03/05/2021,77,3,41,153,194
03/05/2021,219,3,9,49,58
03/05/2021,261,3,119,245,364
03/05/2021,82,3,23,62,85
03/05/2021,495,3,16,43,59
03/05/2021,288,3,13,35,48
03/05/2021,454,3,3,12,15
03/05/2021,910,3,3,26,29
03/05/2021,359,3,12,41,53
03/05/2021,328,3,19,44,63
03/05/2021,892,3,5,12,17
03/05/2021,843,3,13,35,48
03/05/2021,249,3,67,276,343
03/05/2021,300,3,51,292,343
03/05/2021,312,3,14,32,46
03/05/2021,397,3,10,17,27
03/05/2021,851,3,11,22,33
03/05/2021,853,3,16,42,58
03/05/2021,348,3,12,40,52
03/05/2021,670,3,126,298,424
03/05/2021,48,3,6,35,41
03/05/2021,898,3,19,25,44
03/05/2021,833,3,22,31,53
03/05/2021,557,3,9,43,52
03/05/2021,540,3,38,78,116
03/05/2021,768,3,21,144,165
03/05/2021,734,3,11,48,59
03/05/2021,234,3,15,28,43
03/05/2021,873,3,23,73,96
03/05/2021,118,3,21,78,99
03/05/2021,258,3,102,218,320
03/05/2021,6,3,16,91,107
03/05/2021,799,3,13,14,27
03/05/2021,364,3,83,133,216
03/05/2021,49,3,7,34,41
03/05/2021,230,3,25,46,71
03/05/2021,325,3,8,47,55
03/05/2021,539,3,30,66,96
03/05/2021,284,3,7,18,25
03/05/2021,521,3,13,22,35
03/05/2021,787,3,66,218,284
03/05/2021,512,3,5,27,32
03/05/2021,253,3,11,27,38
03/05/2021,251,3,23,45,68
03/05/2021,186,3,15,36,51
03/05/2021,436,3,17,53,70
03/05/2021,654,3,22,110,132
03/05/2021,162,3,78,133,211
03/05/2021,825,3,30,75,105
03/05/2021,597,3,11,31,42
03/05/2021,269,3,11,28,39
03/05/2021,399,3,41,92,133
03/05/2021,15,3,33,84,117
03/05/2021,56,3,20,97,117
03/05/2021,350,3,9,40,49
03/05/2021,192,3,15,35,50
03/05/2021,462,3,4,9,13
03/05/2021,393,3,9,20,29
03/05/2021,474,3,13,25,38
03/05/2021,683,3,22,71,93
03/05/2021,247,3,49,203,252
03/05/2021,821,3,42,73,115
03/05/2021,407,3,24,114,138
03/05/2021,530,3,14,26,40
03/05/2021,5,3,15,81,96
03/05/2021,107,3,51,157,208
03/05/2021,316,3,29,102,131
03/05/2021,357,3,42,123,165
03/05/2021,476,3,11,47,58
03/05/2021,559,3,76,134,210
03/05/2021,174,3,8,31,39
03/05/2021,679,3,22,70,92
03/05/2021,38,3,17,77,94
03/05/2021,290,3,44,254,298
03/05/2021,668,3,3,13,16
03/05/2021,886,3,0,7,7
03/05/2021,432,3,3,14,17
03/05/2021,626,3,17,40,57
03/05/2021,750,3,25,97,122
03/05/2021,180,3,23,89,112
03/05/2021,385,3,18,42,60
03/05/2021,285,3,14,39,53
03/05/2021,76,3,40,149,189
03/05/2021,699,3,23,53,76
03/05/2021,294,3,31,81,112
03/05/2021,143,3,35,126,161
03/05/2021,34,3,19,42,61
03/05/2021,206,3,2,6,8
03/05/2021,857,3,21,75,96
03/05/2021,805,3,19,31,50
03/05/2021,84,3,81,135,216
03/05/2021,220,3,15,52,67
03/05/2021,169,3,13,63,76
03/05/2021,726,3,20,58,78
03/05/2021,720,3,9,27,36
03/05/2021,297,3,42,169,211
03/05/2021,747,3,8,48,56
03/05/2021,315,3,4,46,50
03/05/2021,649,3,20,44,64
03/05/2021,871,3,42,98,140
03/05/2021,548,3,13,23,36
03/05/2021,286,3,10,76,86
03/05/2021,28,3,9,43,52
03/05/2021,696,3,23,57,80
03/05/2021,276,3,25,94,119
03/05/2021,189,3,16,46,62
03/05/2021,380,3,22,59,81
03/05/2021,895,3,22,39,61
03/05/2021,400,3,1,28,29
03/05/2021,423,3,44,268,312
03/05/2021,187,3,12,42,54
03/05/2021,785,3,54,205,259
03/05/2021,777,3,9,27,36
03/05/2021,305,3,18,64,82
03/05/2021,570,3,22,50,72
03/05/2021,897,3,9,6,15
03/05/2021,238,3,57,234,291
04/05/2021,777,3,19,39,58
04/05/2021,380,3,32,64,96
04/05/2021,423,3,34,240,274
04/05/2021,305,3,32,84,116
04/05/2021,895,3,29,70,99
04/05/2021,696,3,24,88,112
04/05/2021,897,3,3,7,10
04/05/2021,400,3,17,30,47
04/05/2021,785,3,65,180,245
04/05/2021,189,3,23,57,80
04/05/2021,570,3,30,53,83
04/05/2021,238,3,59,234,293
04/05/2021,276,3,33,97,130
04/05/2021,286,3,13,69,82
04/05/2021,187,3,11,43,54
04/05/2021,28,3,18,57,75
04/05/2021,309,3,12,46,58
04/05/2021,59,3,22,81,103
04/05/2021,161,3,80,143,223
04/05/2021,802,3,34,103,137
04/05/2021,195,3,22,31,53
04/05/2021,95,3,50,109,159
04/05/2021,244,3,41,85,126
04/05/2021,473,3,30,62,92
04/05/2021,37,3,28,50,78
04/05/2021,443,3,33,97,130
04/05/2021,289,3,29,64,93
04/05/2021,604,3,66,149,215
04/05/2021,842,3,9,12,21
04/05/2021,144,3,46,89,135
04/05/2021,30,3,54,70,124
04/05/2021,124,3,32,56,88
04/05/2021,61,3,24,97,121
04/05/2021,185,3,40,64,104
04/05/2021,850,3,87,154,241
04/05/2021,735,3,6,28,34
04/05/2021,54,3,23,46,69
04/05/2021,786,3,31,84,115
04/05/2021,628,3,18,34,52
04/05/2021,155,3,55,94,149
04/05/2021,237,3,68,231,299
04/05/2021,478,3,11,15,26
04/05/2021,489,3,4,22,26
04/05/2021,458,3,35,76,111
04/05/2021,318,3,56,89,145
04/05/2021,279,3,41,91,132
04/05/2021,565,3,86,126,212
04/05/2021,528,3,13,51,64
04/05/2021,178,3,31,64,95
04/05/2021,788,3,39,85,124
04/05/2021,840,3,29,95,124
04/05/2021,692,3,9,12,21
04/05/2021,140,3,31,43,74
04/05/2021,457,3,33,47,80
04/05/2021,877,3,3,19,22
04/05/2021,635,3,27,83,110
04/05/2021,655,3,36,95,131
04/05/2021,453,3,37,78,115
04/05/2021,463,3,95,243,338
04/05/2021,663,3,31,69,100
04/05/2021,159,3,35,82,117
04/05/2021,561,3,11,42,53
04/05/2021,547,3,150,258,408
04/05/2021,746,3,25,60,85
04/05/2021,721,3,115,317,432
04/05/2021,673,3,32,91,123
04/05/2021,27,3,81,129,210
04/05/2021,770,3,74,155,229
04/05/2021,587,3,6,19,25
04/05/2021,229,3,47,104,151
04/05/2021,713,3,36,291,327
04/05/2021,164,3,19,67,86
04/05/2021,736,3,6,23,29
04/05/2021,90,3,28,71,99
04/05/2021,168,3,24,64,88
04/05/2021,456,3,8,14,22
04/05/2021,567,3,39,70,109
04/05/2021,149,3,39,61,100
04/05/2021,811,3,33,54,87
04/05/2021,931,3,0,2,2
04/05/2021,794,3,80,187,267
04/05/2021,524,3,28,95,123
04/05/2021,198,3,48,98,146
04/05/2021,361,3,76,107,183
04/05/2021,147,3,29,81,110
04/05/2021,17,3,23,46,69
04/05/2021,153,3,34,84,118
04/05/2021,648,3,27,61,88
04/05/2021,864,3,33,60,93
04/05/2021,571,3,1,6,7
04/05/2021,776,3,40,68,108
04/05/2021,413,3,40,138,178
04/05/2021,607,3,60,201,261
04/05/2021,42,3,18,51,69
04/05/2021,287,3,86,289,375
04/05/2021,589,3,20,51,71
04/05/2021,332,3,26,77,103
04/05/2021,888,3,1,13,14
04/05/2021,340,3,11,12,23
04/05/2021,697,3,22,71,93
04/05/2021,894,3,29,51,80
04/05/2021,601,3,23,78,101
04/05/2021,501,3,8,29,37
04/05/2021,859,3,7,5,12
04/05/2021,188,3,27,92,119
04/05/2021,733,3,27,55,82
04/05/2021,636,3,11,44,55
04/05/2021,355,3,17,44,61
04/05/2021,80,3,17,35,52
04/05/2021,610,3,46,177,223
04/05/2021,870,3,18,32,50
04/05/2021,656,3,17,31,48
04/05/2021,499,3,23,88,111
04/05/2021,97,3,60,112,172
04/05/2021,111,3,56,126,182
04/05/2021,878,3,2,10,12
04/05/2021,701,3,13,50,63
04/05/2021,660,3,18,52,70
04/05/2021,514,3,12,29,41
04/05/2021,265,3,22,40,62
04/05/2021,371,3,28,70,98
04/05/2021,1,3,24,88,112
04/05/2021,391,3,51,109,160
04/05/2021,823,3,23,36,59
04/05/2021,709,3,59,85,144
04/05/2021,314,3,8,36,44
04/05/2021,277,3,36,65,101
04/05/2021,176,3,29,65,94
04/05/2021,103,3,68,129,197
04/05/2021,32,3,18,63,81
04/05/2021,434,3,7,17,24
04/05/2021,837,3,72,220,292
04/05/2021,257,3,103,234,337
04/05/2021,121,3,133,233,366
04/05/2021,855,3,38,100,138
04/05/2021,505,3,21,75,96
04/05/2021,831,3,48,117,165
04/05/2021,835,3,42,98,140
04/05/2021,389,3,57,110,167
04/05/2021,712,3,24,35,59
04/05/2021,114,3,30,72,102
04/05/2021,360,3,31,85,116
04/05/2021,311,3,37,92,129
04/05/2021,797,3,57,83,140
04/05/2021,79,3,26,62,88
04/05/2021,907,3,64,112,176
04/05/2021,333,3,32,207,239
04/05/2021,637,3,43,128,171
04/05/2021,783,3,45,152,197
04/05/2021,500,3,7,27,34
04/05/2021,280,3,10,43,53
04/05/2021,293,3,46,151,197
04/05/2021,566,3,16,55,71
04/05/2021,356,3,55,108,163
04/05/2021,465,3,15,65,80
04/05/2021,846,3,1,23,24
04/05/2021,217,3,43,190,233
04/05/2021,824,3,25,46,71
04/05/2021,43,3,26,81,107
04/05/2021,617,3,31,59,90
04/05/2021,228,3,28,53,81
04/05/2021,106,3,55,133,188
04/05/2021,848,3,26,100,126
04/05/2021,865,3,14,25,39
04/05/2021,917,3,1,8,9
04/05/2021,755,3,42,143,185
04/05/2021,183,3,24,56,80
04/05/2021,519,3,17,72,89
04/05/2021,594,3,47,111,158
04/05/2021,193,3,37,61,98
04/05/2021,451,3,102,284,386
04/05/2021,262,3,23,32,55
04/05/2021,475,3,68,101,169
04/05/2021,932,3,0,4,4
04/05/2021,236,3,1,20,21
04/05/2021,765,3,31,82,113
04/05/2021,826,3,53,96,149
04/05/2021,47,3,22,64,86
04/05/2021,18,3,22,80,102
04/05/2021,221,3,17,62,79
04/05/2021,879,3,0,23,23
04/05/2021,242,3,66,253,319
04/05/2021,704,3,18,24,42
04/05/2021,488,3,21,38,59
04/05/2021,154,3,32,83,115
04/05/2021,759,3,10,41,51
04/05/2021,751,3,1,4,5
04/05/2021,104,3,52,91,143
04/05/2021,248,3,25,70,95
04/05/2021,535,3,26,58,84
04/05/2021,112,3,17,43,60
04/05/2021,804,3,69,235,304
04/05/2021,264,3,28,31,59
04/05/2021,899,3,40,118,158
04/05/2021,272,3,23,80,103
04/05/2021,688,3,26,65,91
04/05/2021,901,3,0,1,1
04/05/2021,83,3,115,247,362
04/05/2021,402,3,44,70,114
04/05/2021,479,3,12,29,41
04/05/2021,408,3,17,57,74
04/05/2021,934,3,0,19,19
04/05/2021,795,3,43,77,120
04/05/2021,378,3,22,58,80
04/05/2021,858,3,69,127,196
04/05/2021,903,3,1,1,2
04/05/2021,613,3,10,39,49
04/05/2021,702,3,17,65,82
04/05/2021,406,3,46,96,142
04/05/2021,504,3,9,36,45
04/05/2021,93,3,47,131,178
04/05/2021,492,3,10,46,56
04/05/2021,537,3,48,98,146
04/05/2021,558,3,14,49,63
04/05/2021,889,3,0,8,8
04/05/2021,69,3,27,87,114
04/05/2021,398,3,4,6,10
04/05/2021,175,3,24,66,90
04/05/2021,883,3,7,27,34
04/05/2021,586,3,58,210,268
04/05/2021,477,3,22,57,79
04/05/2021,483,3,46,67,113
04/05/2021,346,3,17,63,80
04/05/2021,725,3,28,78,106
04/05/2021,845,3,34,69,103
04/05/2021,214,3,45,201,246
04/05/2021,618,3,43,76,119
04/05/2021,664,3,44,110,154
04/05/2021,208,3,18,46,64
04/05/2021,827,3,66,129,195
04/05/2021,31,3,38,62,100
04/05/2021,21,3,23,104,127
04/05/2021,880,3,0,20,20
04/05/2021,363,3,80,113,193
04/05/2021,225,3,33,73,106
04/05/2021,160,3,7,5,12
04/05/2021,158,3,35,69,104
04/05/2021,339,3,11,10,21
04/05/2021,531,3,32,61,93
04/05/2021,2,3,26,90,116
04/05/2021,386,3,71,161,232
04/05/2021,791,3,44,88,132
04/05/2021,410,3,34,143,177
04/05/2021,53,3,45,77,122
04/05/2021,256,3,26,60,86
04/05/2021,490,3,4,20,24
04/05/2021,820,3,31,96,127
04/05/2021,486,3,42,111,153
04/05/2021,830,3,140,254,394
04/05/2021,818,3,60,202,262
04/05/2021,96,3,17,80,97
04/05/2021,732,3,23,45,68
04/05/2021,203,3,16,59,75
04/05/2021,327,3,51,134,185
04/05/2021,441,3,26,57,83
04/05/2021,757,3,34,101,135
04/05/2021,921,3,0,4,4
04/05/2021,643,3,44,70,114
04/05/2021,224,3,29,58,87
04/05/2021,867,3,24,46,70
04/05/2021,347,3,85,155,240
04/05/2021,254,3,27,50,77
04/05/2021,781,3,53,101,154
04/05/2021,629,3,40,60,100
04/05/2021,396,3,16,32,48
04/05/2021,789,3,34,85,119
04/05/2021,130,3,48,145,193
04/05/2021,592,3,44,81,125
04/05/2021,515,3,30,113,143
04/05/2021,419,3,75,186,261
04/05/2021,20,3,20,24,44
04/05/2021,207,3,27,67,94
04/05/2021,282,3,14,53,67
04/05/2021,335,3,43,127,170
04/05/2021,676,3,19,49,68
04/05/2021,869,3,78,112,190
04/05/2021,779,3,15,32,47
04/05/2021,590,3,1,2,3
04/05/2021,65,3,24,104,128
04/05/2021,194,3,1,3,4
04/05/2021,924,3,0,2,2
04/05/2021,900,3,0,1,1
04/05/2021,681,3,32,89,121
04/05/2021,383,3,46,213,259
04/05/2021,534,3,24,49,73
04/05/2021,235,3,33,96,129
04/05/2021,863,3,37,64,101
04/05/2021,418,3,21,26,47
04/05/2021,60,3,10,19,29
04/05/2021,752,3,49,100,149
04/05/2021,675,3,21,63,84
04/05/2021,658,3,11,61,72
04/05/2021,918,3,0,8,8
04/05/2021,632,3,15,15,30
04/05/2021,682,3,17,40,57
04/05/2021,8,3,22,77,99
04/05/2021,730,3,22,51,73
04/05/2021,800,3,30,77,107
04/05/2021,268,3,52,115,167
04/05/2021,471,3,24,46,70
04/05/2021,761,3,14,29,43
04/05/2021,447,3,33,99,132
04/05/2021,22,3,35,109,144
04/05/2021,303,3,46,204,250
04/05/2021,546,3,19,19,38
04/05/2021,680,3,29,45,74
04/05/2021,260,3,123,272,395
04/05/2021,469,3,31,119,150
04/05/2021,661,3,7,18,25
04/05/2021,578,3,12,56,68
04/05/2021,421,3,74,127,201
04/05/2021,425,3,34,103,137
04/05/2021,580,3,26,37,63
04/05/2021,24,3,13,23,36
04/05/2021,651,3,26,50,76
04/05/2021,461,3,3,17,20
04/05/2021,694,3,26,52,78
04/05/2021,517,3,19,35,54
04/05/2021,595,3,20,55,75
04/05/2021,874,3,7,11,18
04/05/2021,876,3,0,5,5
04/05/2021,532,3,115,292,407
04/05/2021,577,3,30,110,140
04/05/2021,719,3,22,29,51
04/05/2021,44,3,59,106,165
04/05/2021,484,3,37,65,102
04/05/2021,110,3,29,45,74
04/05/2021,382,3,0,5,5
04/05/2021,832,3,28,66,94
04/05/2021,404,3,69,138,207
04/05/2021,439,3,34,59,93
04/05/2021,598,3,110,248,358
04/05/2021,362,3,75,109,184
04/05/2021,352,3,40,97,137
04/05/2021,431,3,41,76,117
04/05/2021,574,3,35,54,89
04/05/2021,647,3,19,73,92
04/05/2021,506,3,11,39,50
04/05/2021,714,3,35,88,123
04/05/2021,728,3,40,83,123
04/05/2021,136,3,44,132,176
04/05/2021,838,3,14,44,58
04/05/2021,686,3,22,70,92
04/05/2021,584,3,75,222,297
04/05/2021,573,3,32,51,83
04/05/2021,470,3,23,44,67
04/05/2021,23,3,13,24,37
04/05/2021,896,3,153,276,429
04/05/2021,553,3,42,105,147
04/05/2021,801,3,38,112,150
04/05/2021,847,3,2,17,19
04/05/2021,819,3,30,66,96
04/05/2021,849,3,35,112,147
04/05/2021,50,3,16,30,46
04/05/2021,379,3,51,153,204
04/05/2021,426,3,31,47,78
04/05/2021,612,3,48,183,231
04/05/2021,691,3,21,75,96
04/05/2021,861,3,81,83,164
04/05/2021,52,3,43,106,149
04/05/2021,481,3,46,64,110
04/05/2021,772,3,42,112,154
04/05/2021,310,3,72,170,242
04/05/2021,222,3,15,55,70
04/05/2021,326,3,19,39,58
04/05/2021,906,3,6,6,12
04/05/2021,275,3,24,90,114
04/05/2021,452,3,42,90,132
04/05/2021,742,3,31,91,122
04/05/2021,127,3,37,62,99
04/05/2021,227,3,33,63,96
04/05/2021,342,3,23,71,94
04/05/2021,593,3,82,237,319
04/05/2021,151,3,17,36,53
04/05/2021,243,3,72,270,342
04/05/2021,190,3,25,90,115
04/05/2021,939,3,0,1,1
04/05/2021,620,3,0,1,1
04/05/2021,271,3,29,65,94
04/05/2021,817,3,24,85,109
04/05/2021,526,3,18,58,76
04/05/2021,365,3,30,72,102
04/05/2021,184,3,37,56,93
04/05/2021,259,3,100,215,315
04/05/2021,689,3,29,76,105
04/05/2021,778,3,46,114,160
04/05/2021,131,3,28,95,123
04/05/2021,420,3,73,134,207
04/05/2021,255,3,2,13,15
04/05/2021,639,3,39,51,90
04/05/2021,35,3,42,77,119
04/05/2021,376,3,13,26,39
04/05/2021,674,3,15,59,74
04/05/2021,627,3,29,46,75
04/05/2021,85,3,65,61,126
04/05/2021,197,3,28,56,84
04/05/2021,270,3,12,54,66
04/05/2021,554,3,27,69,96
04/05/2021,919,3,32,72,104
04/05/2021,295,3,7,21,28
04/05/2021,659,3,10,57,67
04/05/2021,307,3,36,92,128
04/05/2021,665,3,19,69,88
04/05/2021,372,3,49,157,206
04/05/2021,640,3,30,55,85
04/05/2021,13,3,18,55,73
04/05/2021,283,3,27,71,98
04/05/2021,468,3,31,80,111
04/05/2021,395,3,23,45,68
04/05/2021,605,3,79,182,261
04/05/2021,377,3,34,73,107
04/05/2021,599,3,109,244,353
04/05/2021,503,3,7,23,30
04/05/2021,36,3,39,65,104
04/05/2021,405,3,17,25,42
04/05/2021,336,3,126,211,337
04/05/2021,273,3,47,231,278
04/05/2021,329,3,49,130,179
04/05/2021,508,3,37,129,166
04/05/2021,98,3,53,119,172
04/05/2021,319,3,13,40,53
04/05/2021,856,3,22,27,49
04/05/2021,55,3,25,44,69
04/05/2021,337,3,10,33,43
04/05/2021,313,3,20,51,71
04/05/2021,724,3,137,241,378
04/05/2021,698,3,21,70,91
04/05/2021,844,3,3,7,10
04/05/2021,550,3,49,86,135
04/05/2021,181,3,25,46,71
04/05/2021,716,3,25,56,81
04/05/2021,808,3,64,133,197
04/05/2021,911,3,6,16,22
04/05/2021,459,3,41,75,116
04/05/2021,299,3,20,78,98
04/05/2021,301,3,64,214,278
04/05/2021,814,3,24,48,72
04/05/2021,891,3,24,77,101
04/05/2021,771,3,30,104,134
04/05/2021,331,3,23,55,78
04/05/2021,388,3,56,123,179
04/05/2021,291,3,56,229,285
04/05/2021,773,3,31,89,120
04/05/2021,116,3,13,43,56
04/05/2021,552,3,54,99,153
04/05/2021,81,3,12,34,46
04/05/2021,351,3,75,102,177
04/05/2021,606,3,32,109,141
04/05/2021,645,3,28,39,67
04/05/2021,166,3,15,56,71
04/05/2021,646,3,27,42,69
04/05/2021,497,3,40,149,189
04/05/2021,105,3,46,68,114
04/05/2021,798,3,41,114,155
04/05/2021,196,3,4,7,11
04/05/2021,935,3,0,1,1
04/05/2021,774,3,29,86,115
04/05/2021,123,3,32,82,114
04/05/2021,125,3,29,71,100
04/05/2021,585,3,40,116,156
04/05/2021,298,3,83,287,370
04/05/2021,157,3,36,89,125
04/05/2021,7,3,24,87,111
04/05/2021,513,3,22,71,93
04/05/2021,345,3,20,37,57
04/05/2021,810,3,7,16,23
04/05/2021,146,3,52,114,166
04/05/2021,26,3,28,63,91
04/05/2021,240,3,59,234,293
04/05/2021,576,3,7,23,30
04/05/2021,63,3,14,34,48
04/05/2021,317,3,69,105,174
04/05/2021,148,3,34,59,93
04/05/2021,812,3,26,56,82
04/05/2021,726,3,26,67,93
04/05/2021,720,3,18,26,44
04/05/2021,649,3,21,48,69
04/05/2021,747,3,19,68,87
04/05/2021,169,3,27,89,116
04/05/2021,297,3,60,184,244
04/05/2021,548,3,28,31,59
04/05/2021,871,3,58,122,180
04/05/2021,315,3,9,46,55
04/05/2021,793,3,42,130,172
04/05/2021,671,3,35,165,200
04/05/2021,722,3,15,57,72
04/05/2021,449,3,50,137,187
04/05/2021,41,3,17,66,83
04/05/2021,602,3,83,191,274
04/05/2021,775,3,39,71,110
04/05/2021,226,3,29,73,102
04/05/2021,806,3,62,148,210
04/05/2021,67,3,25,87,112
04/05/2021,4,3,26,53,79
04/05/2021,368,3,35,102,137
04/05/2021,152,3,29,80,109
04/05/2021,657,3,54,109,163
04/05/2021,211,3,45,195,240
04/05/2021,560,3,84,114,198
04/05/2021,57,3,29,109,138
04/05/2021,669,3,16,59,75
04/05/2021,437,3,43,113,156
04/05/2021,915,3,1,21,22
04/05/2021,498,3,17,61,78
04/05/2021,525,3,29,89,118
04/05/2021,572,3,32,53,85
04/05/2021,625,3,29,53,82
04/05/2021,533,3,11,13,24
04/05/2021,205,3,19,68,87
04/05/2021,87,3,56,125,181
04/05/2021,246,3,73,260,333
04/05/2021,91,3,45,96,141
04/05/2021,435,3,25,44,69
04/05/2021,374,3,13,31,44
04/05/2021,749,3,4,5,9
04/05/2021,631,3,8,15,23
04/05/2021,737,3,8,34,42
04/05/2021,933,3,0,1,1
04/05/2021,884,3,5,25,30
04/05/2021,344,3,20,74,94
04/05/2021,662,3,38,109,147
04/05/2021,9,3,42,97,139
04/05/2021,129,3,33,111,144
04/05/2021,756,3,42,164,206
04/05/2021,68,3,29,106,135
04/05/2021,115,3,12,39,51
04/05/2021,428,3,32,66,98
04/05/2021,542,3,35,81,116
04/05/2021,135,3,44,139,183
04/05/2021,616,3,55,108,163
04/05/2021,179,3,21,51,72
04/05/2021,562,3,17,25,42
04/05/2021,343,3,20,70,90
04/05/2021,156,3,30,86,116
04/05/2021,414,3,19,64,83
04/05/2021,358,3,65,142,207
04/05/2021,621,3,31,79,110
04/05/2021,653,3,9,27,36
04/05/2021,455,3,3,13,16
04/05/2021,494,3,30,52,82
04/05/2021,445,3,49,122,171
04/05/2021,741,3,9,38,47
04/05/2021,905,3,0,1,1
04/05/2021,201,3,22,46,68
04/05/2021,828,3,41,48,89
04/05/2021,641,3,6,9,15
04/05/2021,58,3,45,149,194
04/05/2021,715,3,62,93,155
04/05/2021,438,3,32,68,100
04/05/2021,764,3,11,25,36
04/05/2021,403,3,45,70,115
04/05/2021,472,3,24,57,81
04/05/2021,322,3,29,62,91
04/05/2021,218,3,45,198,243
04/05/2021,603,3,58,135,193
04/05/2021,308,3,29,81,110
04/05/2021,509,3,30,113,143
04/05/2021,579,3,17,21,38
04/05/2021,634,3,39,100,139
04/05/2021,487,3,42,51,93
04/05/2021,86,3,27,69,96
04/05/2021,685,3,27,60,87
04/05/2021,624,3,8,30,38
04/05/2021,369,3,69,131,200
04/05/2021,511,3,22,95,117
04/05/2021,841,3,8,37,45
04/05/2021,703,3,13,54,67
04/05/2021,233,3,32,88,120
04/05/2021,216,3,23,79,102
04/05/2021,731,3,30,64,94
04/05/2021,381,3,1,1,2
04/05/2021,748,3,18,53,71
04/05/2021,440,3,6,28,34
04/05/2021,583,3,27,77,104
04/05/2021,263,3,34,85,119
04/05/2021,78,3,110,249,359
04/05/2021,212,3,51,210,261
04/05/2021,338,3,47,123,170
04/05/2021,210,3,32,85,117
04/05/2021,117,3,70,120,190
04/05/2021,807,3,17,61,78
04/05/2021,411,3,44,160,204
04/05/2021,902,3,26,66,92
04/05/2021,304,3,41,93,134
04/05/2021,493,3,19,65,84
04/05/2021,330,3,36,109,145
04/05/2021,543,3,139,249,388
04/05/2021,45,3,30,74,104
04/05/2021,510,3,7,22,29
04/05/2021,743,3,17,44,61
04/05/2021,134,3,43,130,173
04/05/2021,199,3,22,38,60
04/05/2021,706,3,56,76,132
04/05/2021,126,3,27,95,122
04/05/2021,39,3,27,81,108
04/05/2021,930,3,0,13,13
04/05/2021,102,3,62,137,199
04/05/2021,582,3,101,278,379
04/05/2021,412,3,18,92,110
04/05/2021,341,3,120,220,340
04/05/2021,687,3,27,89,116
04/05/2021,119,3,30,97,127
04/05/2021,448,3,98,296,394
04/05/2021,133,3,15,29,44
04/05/2021,904,3,66,209,275
04/05/2021,507,3,47,169,216
04/05/2021,444,3,29,64,93
04/05/2021,231,3,41,77,118
04/05/2021,581,3,44,96,140
04/05/2021,792,3,43,41,84
04/05/2021,591,3,24,58,82
04/05/2021,245,3,78,276,354
04/05/2021,200,3,40,64,104
04/05/2021,46,3,22,60,82
04/05/2021,677,3,16,46,62
04/05/2021,145,3,32,79,111
04/05/2021,442,3,29,78,107
04/05/2021,652,3,10,27,37
04/05/2021,25,3,41,93,134
04/05/2021,353,3,12,36,48
04/05/2021,608,3,63,210,273
04/05/2021,555,3,80,113,193
04/05/2021,809,3,18,54,72
04/05/2021,922,3,0,3,3
04/05/2021,204,3,3,10,13
04/05/2021,92,3,39,66,105
04/05/2021,139,3,25,83,108
04/05/2021,464,3,64,197,261
04/05/2021,760,3,29,62,91
04/05/2021,622,3,67,128,195
04/05/2021,518,3,25,72,97
04/05/2021,642,3,34,56,90
04/05/2021,782,3,49,137,186
04/05/2021,754,3,39,126,165
04/05/2021,202,3,43,145,188
04/05/2021,3,3,24,87,111
04/05/2021,422,3,22,69,91
04/05/2021,813,3,18,72,90
04/05/2021,72,3,47,169,216
04/05/2021,292,3,76,281,357
04/05/2021,394,3,22,43,65
04/05/2021,167,3,39,71,110
04/05/2021,881,3,1,23,24
04/05/2021,12,3,14,33,47
04/05/2021,433,3,93,250,343
04/05/2021,142,3,9,37,46
04/05/2021,390,3,56,118,174
04/05/2021,209,3,15,60,75
04/05/2021,739,3,8,42,50
04/05/2021,467,3,3,9,12
04/05/2021,173,3,18,48,66
04/05/2021,862,3,44,73,117
04/05/2021,527,3,22,61,83
04/05/2021,496,3,10,32,42
04/05/2021,529,3,24,76,100
04/05/2021,816,3,62,149,211
04/05/2021,163,3,17,61,78
04/05/2021,128,3,38,64,102
04/05/2021,684,3,26,90,116
04/05/2021,909,3,2,2,4
04/05/2021,252,3,31,56,87
04/05/2021,427,3,28,69,97
04/05/2021,936,3,3,11,14
04/05/2021,354,3,1,0,1
04/05/2021,875,3,26,57,83
04/05/2021,836,3,44,150,194
04/05/2021,266,3,26,68,94
04/05/2021,600,3,74,242,316
04/05/2021,138,3,27,86,113
04/05/2021,417,3,46,156,202
04/05/2021,51,3,73,151,224
04/05/2021,213,3,47,206,253
04/05/2021,321,3,14,35,49
04/05/2021,872,3,15,30,45
04/05/2021,137,3,26,87,113
04/05/2021,569,3,36,66,102
04/05/2021,430,3,37,73,110
04/05/2021,551,3,47,114,161
04/05/2021,650,3,43,114,157
04/05/2021,758,3,27,103,130
04/05/2021,563,3,18,71,89
04/05/2021,538,3,25,88,113
04/05/2021,113,3,22,36,58
04/05/2021,373,3,21,69,90
04/05/2021,575,3,11,25,36
04/05/2021,839,3,32,110,142
04/05/2021,623,3,37,65,102
04/05/2021,250,3,67,110,177
04/05/2021,429,3,39,113,152
04/05/2021,480,3,17,32,49
04/05/2021,885,3,6,26,32
04/05/2021,860,3,35,69,104
04/05/2021,120,3,29,78,107
04/05/2021,767,3,74,155,229
04/05/2021,366,3,23,28,51
04/05/2021,274,3,1,33,34
04/05/2021,588,3,22,61,83
04/05/2021,177,3,20,48,68
04/05/2021,108,3,12,33,45
04/05/2021,232,3,33,73,106
04/05/2021,33,3,21,72,93
04/05/2021,854,3,69,201,270
04/05/2021,392,3,22,47,69
04/05/2021,84,3,82,149,231
04/05/2021,143,3,56,121,177
04/05/2021,220,3,20,78,98
04/05/2021,206,3,2,4,6
04/05/2021,76,3,33,140,173
04/05/2021,857,3,22,77,99
04/05/2021,385,3,21,60,81
04/05/2021,294,3,40,93,133
04/05/2021,432,3,2,10,12
04/05/2021,699,3,37,76,113
04/05/2021,626,3,24,45,69
04/05/2021,180,3,31,86,117
04/05/2021,805,3,29,43,72
04/05/2021,750,3,29,94,123
04/05/2021,34,3,25,53,78
04/05/2021,886,3,0,8,8
04/05/2021,285,3,26,47,73
04/05/2021,910,3,5,30,35
04/05/2021,288,3,20,40,60
04/05/2021,495,3,17,56,73
04/05/2021,261,3,125,274,399
04/05/2021,359,3,30,80,110
04/05/2021,843,3,20,38,58
04/05/2021,454,3,3,9,12
04/05/2021,82,3,38,73,111
04/05/2021,328,3,16,29,45
04/05/2021,892,3,2,6,8
04/05/2021,409,3,32,27,59
04/05/2021,170,3,30,101,131
04/05/2021,711,3,23,37,60
04/05/2021,424,3,39,243,282
04/05/2021,638,3,51,75,126
04/05/2021,829,3,15,65,80
04/05/2021,705,3,11,22,33
04/05/2021,717,3,29,68,97
04/05/2021,614,3,32,49,81
04/05/2021,866,3,49,101,150
04/05/2021,780,3,81,153,234
04/05/2021,11,3,29,85,114
04/05/2021,70,3,37,142,179
04/05/2021,615,3,20,84,104
04/05/2021,745,3,27,62,89
04/05/2021,278,3,10,41,51
04/05/2021,852,3,65,96,161
04/05/2021,71,3,21,59,80
04/05/2021,122,3,34,75,109
04/05/2021,171,3,9,24,33
04/05/2021,370,3,33,109,142
04/05/2021,700,3,19,64,83
04/05/2021,89,3,48,108,156
04/05/2021,100,3,17,34,51
04/05/2021,753,3,28,82,110
04/05/2021,710,3,23,39,62
04/05/2021,387,3,29,50,79
04/05/2021,926,3,4,1,5
04/05/2021,727,3,21,76,97
04/05/2021,536,3,20,55,75
04/05/2021,367,3,35,114,149
04/05/2021,908,3,3,4,7
04/05/2021,693,3,16,60,76
04/05/2021,302,3,54,222,276
04/05/2021,914,3,0,2,2
04/05/2021,77,3,41,153,194
04/05/2021,384,3,29,74,103
04/05/2021,219,3,16,60,76
04/05/2021,633,3,18,56,74
04/05/2021,75,3,39,154,193
04/05/2021,619,3,23,33,56
04/05/2021,544,3,40,57,97
04/05/2021,887,3,0,16,16
04/05/2021,323,3,17,43,60
04/05/2021,215,3,16,61,77
04/05/2021,564,3,43,88,131
04/05/2021,349,3,21,42,63
04/05/2021,556,3,88,128,216
04/05/2021,66,3,3,14,17
04/05/2021,666,3,34,83,117
04/05/2021,450,3,37,77,114
04/05/2021,882,3,0,13,13
04/05/2021,182,3,23,43,66
04/05/2021,281,3,36,92,128
04/05/2021,522,3,25,73,98
04/05/2021,296,3,20,33,53
04/05/2021,784,3,49,132,181
04/05/2021,446,3,29,97,126
04/05/2021,491,3,40,142,182
04/05/2021,707,3,53,78,131
04/05/2021,401,3,22,42,64
04/05/2021,239,3,34,148,182
04/05/2021,267,3,28,73,101
04/05/2021,416,3,14,40,54
04/05/2021,790,3,54,147,201
04/05/2021,19,3,25,104,129
04/05/2021,815,3,106,233,339
04/05/2021,88,3,35,86,121
04/05/2021,64,3,1,6,7
04/05/2021,803,3,27,102,129
04/05/2021,172,3,29,95,124
04/05/2021,460,3,38,71,109
04/05/2021,334,3,74,155,229
04/05/2021,723,3,26,71,97
04/05/2021,466,3,35,69,104
04/05/2021,101,3,24,93,117
04/05/2021,868,3,84,118,202
04/05/2021,99,3,71,164,235
04/05/2021,520,3,21,39,60
04/05/2021,890,3,1,26,27
04/05/2021,738,3,30,73,103
04/05/2021,485,3,38,63,101
04/05/2021,38,3,24,73,97
04/05/2021,107,3,75,178,253
04/05/2021,530,3,13,25,38
04/05/2021,679,3,35,77,112
04/05/2021,821,3,28,99,127
04/05/2021,668,3,7,8,15
04/05/2021,407,3,30,134,164
04/05/2021,316,3,39,98,137
04/05/2021,357,3,65,132,197
04/05/2021,476,3,20,62,82
04/05/2021,174,3,19,43,62
04/05/2021,559,3,87,121,208
04/05/2021,5,3,24,82,106
04/05/2021,290,3,60,249,309
04/05/2021,6,3,25,87,112
04/05/2021,873,3,45,98,143
04/05/2021,521,3,21,29,50
04/05/2021,787,3,77,204,281
04/05/2021,284,3,14,33,47
04/05/2021,118,3,32,91,123
04/05/2021,230,3,34,56,90
04/05/2021,49,3,18,25,43
04/05/2021,234,3,16,24,40
04/05/2021,799,3,8,10,18
04/05/2021,258,3,105,252,357
04/05/2021,325,3,18,70,88
04/05/2021,539,3,48,80,128
04/05/2021,734,3,26,58,84
04/05/2021,364,3,78,113,191
04/05/2021,925,3,0,1,1
04/05/2021,249,3,79,287,366
04/05/2021,312,3,27,44,71
04/05/2021,348,3,21,70,91
04/05/2021,670,3,159,307,466
04/05/2021,397,3,17,34,51
04/05/2021,853,3,30,64,94
04/05/2021,851,3,8,12,20
04/05/2021,833,3,27,29,56
04/05/2021,898,3,23,30,53
04/05/2021,557,3,16,63,79
04/05/2021,540,3,56,107,163
04/05/2021,300,3,70,279,349
04/05/2021,768,3,45,137,182
04/05/2021,48,3,16,26,42
04/05/2021,825,3,40,102,142
04/05/2021,269,3,26,60,86
04/05/2021,462,3,4,7,11
04/05/2021,192,3,26,44,70
04/05/2021,186,3,23,30,53
04/05/2021,253,3,15,30,45
04/05/2021,251,3,27,50,77
04/05/2021,683,3,25,91,116
04/05/2021,399,3,56,126,182
04/05/2021,393,3,19,40,59
04/05/2021,597,3,31,37,68
04/05/2021,162,3,80,142,222
04/05/2021,436,3,22,67,89
04/05/2021,474,3,24,47,71
04/05/2021,247,3,64,210,274
04/05/2021,350,3,24,61,85
04/05/2021,56,3,34,121,155
04/05/2021,512,3,9,34,43
04/05/2021,15,3,43,97,140
04/05/2021,654,3,44,134,178
05/05/2021,597,3,20,51,71
05/05/2021,15,3,38,91,129
05/05/2021,269,3,26,61,87
05/05/2021,512,3,9,38,47
05/05/2021,462,3,2,10,12
05/05/2021,474,3,20,64,84
05/05/2021,393,3,13,51,64
05/05/2021,251,3,22,53,75
05/05/2021,436,3,30,77,107
05/05/2021,186,3,16,32,48
05/05/2021,253,3,10,40,50
05/05/2021,825,3,41,113,154
05/05/2021,192,3,30,51,81
05/05/2021,56,3,36,126,162
05/05/2021,162,3,92,156,248
05/05/2021,350,3,26,78,104
05/05/2021,683,3,21,93,114
05/05/2021,399,3,44,115,159
05/05/2021,247,3,62,204,266
05/05/2021,654,3,47,131,178
05/05/2021,774,3,36,80,116
05/05/2021,125,3,31,75,106
05/05/2021,7,3,24,77,101
05/05/2021,798,3,52,114,166
05/05/2021,585,3,49,113,162
05/05/2021,298,3,81,298,379
05/05/2021,196,3,4,3,7
05/05/2021,497,3,40,132,172
05/05/2021,105,3,49,89,138
05/05/2021,646,3,20,45,65
05/05/2021,157,3,31,88,119
05/05/2021,166,3,16,60,76
05/05/2021,123,3,38,76,114
05/05/2021,935,3,0,1,1
05/05/2021,378,3,27,66,93
05/05/2021,613,3,8,45,53
05/05/2021,858,3,65,139,204
05/05/2021,903,3,0,1,1
05/05/2021,492,3,10,49,59
05/05/2021,175,3,26,73,99
05/05/2021,702,3,19,74,93
05/05/2021,883,3,7,41,48
05/05/2021,795,3,49,83,132
05/05/2021,504,3,7,35,42
05/05/2021,586,3,64,206,270
05/05/2021,398,3,4,5,9
05/05/2021,69,3,34,85,119
05/05/2021,406,3,41,92,133
05/05/2021,93,3,52,144,196
05/05/2021,477,3,30,74,104
05/05/2021,889,3,0,10,10
05/05/2021,558,3,19,48,67
05/05/2021,537,3,37,87,124
05/05/2021,332,3,23,97,120
05/05/2021,864,3,27,61,88
05/05/2021,153,3,30,78,108
05/05/2021,147,3,21,94,115
05/05/2021,287,3,83,298,381
05/05/2021,607,3,63,218,281
05/05/2021,589,3,21,52,73
05/05/2021,198,3,53,99,152
05/05/2021,648,3,27,64,91
05/05/2021,42,3,16,51,67
05/05/2021,413,3,35,145,180
05/05/2021,17,3,15,61,76
05/05/2021,361,3,59,104,163
05/05/2021,888,3,0,8,8
05/05/2021,571,3,6,4,10
05/05/2021,776,3,29,70,99
05/05/2021,61,3,25,110,135
05/05/2021,185,3,41,59,100
05/05/2021,124,3,36,55,91
05/05/2021,30,3,45,67,112
05/05/2021,842,3,16,14,30
05/05/2021,289,3,20,74,94
05/05/2021,144,3,39,103,142
05/05/2021,604,3,55,158,213
05/05/2021,850,3,97,170,267
05/05/2021,696,3,24,76,100
05/05/2021,423,3,36,264,300
05/05/2021,785,3,73,211,284
05/05/2021,276,3,34,115,149
05/05/2021,570,3,35,52,87
05/05/2021,400,3,15,37,52
05/05/2021,28,3,18,44,62
05/05/2021,286,3,16,55,71
05/05/2021,897,3,3,7,10
05/05/2021,777,3,26,61,87
05/05/2021,187,3,12,50,62
05/05/2021,305,3,24,88,112
05/05/2021,189,3,27,54,81
05/05/2021,238,3,75,239,314
05/05/2021,895,3,24,72,96
05/05/2021,380,3,33,76,109
05/05/2021,161,3,90,154,244
05/05/2021,443,3,34,97,131
05/05/2021,95,3,40,114,154
05/05/2021,309,3,18,47,65
05/05/2021,802,3,35,120,155
05/05/2021,473,3,29,61,90
05/05/2021,195,3,23,39,62
05/05/2021,59,3,24,94,118
05/05/2021,244,3,43,90,133
05/05/2021,37,3,28,58,86
05/05/2021,547,3,133,259,392
05/05/2021,937,3,1,0,1
05/05/2021,27,3,86,142,228
05/05/2021,770,3,77,192,269
05/05/2021,721,3,109,301,410
05/05/2021,746,3,26,66,92
05/05/2021,456,3,4,13,17
05/05/2021,168,3,26,66,92
05/05/2021,229,3,38,90,128
05/05/2021,149,3,27,68,95
05/05/2021,561,3,18,43,61
05/05/2021,713,3,37,299,336
05/05/2021,164,3,21,75,96
05/05/2021,587,3,11,18,29
05/05/2021,811,3,29,55,84
05/05/2021,159,3,34,87,121
05/05/2021,736,3,7,27,34
05/05/2021,90,3,26,76,102
05/05/2021,524,3,38,107,145
05/05/2021,931,3,0,1,1
05/05/2021,673,3,30,112,142
05/05/2021,567,3,42,76,118
05/05/2021,794,3,88,192,280
05/05/2021,178,3,32,73,105
05/05/2021,237,3,76,243,319
05/05/2021,478,3,15,12,27
05/05/2021,628,3,20,41,61
05/05/2021,318,3,40,93,133
05/05/2021,786,3,36,91,127
05/05/2021,458,3,38,88,126
05/05/2021,565,3,78,137,215
05/05/2021,788,3,33,69,102
05/05/2021,489,3,1,28,29
05/05/2021,528,3,19,48,67
05/05/2021,155,3,50,119,169
05/05/2021,306,3,0,1,1
05/05/2021,54,3,17,46,63
05/05/2021,279,3,44,106,150
05/05/2021,735,3,8,27,35
05/05/2021,140,3,20,60,80
05/05/2021,692,3,9,10,19
05/05/2021,655,3,34,102,136
05/05/2021,663,3,28,87,115
05/05/2021,635,3,27,97,124
05/05/2021,453,3,37,84,121
05/05/2021,877,3,2,20,22
05/05/2021,840,3,30,91,121
05/05/2021,463,3,103,236,339
05/05/2021,457,3,31,45,76
05/05/2021,408,3,14,41,55
05/05/2021,899,3,42,122,164
05/05/2021,272,3,23,84,107
05/05/2021,248,3,27,72,99
05/05/2021,688,3,32,64,96
05/05/2021,264,3,22,33,55
05/05/2021,112,3,10,44,54
05/05/2021,402,3,34,89,123
05/05/2021,535,3,32,56,88
05/05/2021,479,3,16,27,43
05/05/2021,83,3,129,265,394
05/05/2021,804,3,77,245,322
05/05/2021,901,3,0,1,1
05/05/2021,104,3,58,98,156
05/05/2021,934,3,0,17,17
05/05/2021,176,3,29,74,103
05/05/2021,855,3,46,106,152
05/05/2021,831,3,56,120,176
05/05/2021,314,3,11,27,38
05/05/2021,389,3,54,114,168
05/05/2021,434,3,4,18,22
05/05/2021,277,3,31,62,93
05/05/2021,835,3,31,102,133
05/05/2021,103,3,56,125,181
05/05/2021,121,3,114,230,344
05/05/2021,257,3,99,225,324
05/05/2021,505,3,25,77,102
05/05/2021,32,3,23,48,71
05/05/2021,837,3,83,222,305
05/05/2021,709,3,46,86,132
05/05/2021,870,3,11,35,46
05/05/2021,733,3,25,54,79
05/05/2021,501,3,5,21,26
05/05/2021,697,3,23,81,104
05/05/2021,859,3,6,4,10
05/05/2021,499,3,26,93,119
05/05/2021,610,3,49,185,234
05/05/2021,188,3,34,92,126
05/05/2021,97,3,60,135,195
05/05/2021,656,3,17,37,54
05/05/2021,894,3,31,54,85
05/05/2021,340,3,8,17,25
05/05/2021,601,3,28,79,107
05/05/2021,636,3,10,35,45
05/05/2021,80,3,19,46,65
05/05/2021,355,3,17,53,70
05/05/2021,111,3,47,120,167
05/05/2021,1,3,24,81,105
05/05/2021,660,3,15,61,76
05/05/2021,878,3,2,13,15
05/05/2021,514,3,11,37,48
05/05/2021,823,3,24,51,75
05/05/2021,265,3,19,37,56
05/05/2021,371,3,21,70,91
05/05/2021,391,3,47,107,154
05/05/2021,701,3,17,59,76
05/05/2021,879,3,1,22,23
05/05/2021,242,3,77,263,340
05/05/2021,704,3,17,32,49
05/05/2021,759,3,9,41,50
05/05/2021,154,3,30,76,106
05/05/2021,221,3,22,56,78
05/05/2021,488,3,24,56,80
05/05/2021,236,3,0,21,21
05/05/2021,47,3,25,75,100
05/05/2021,826,3,49,99,148
05/05/2021,18,3,24,77,101
05/05/2021,751,3,0,5,5
05/05/2021,765,3,27,94,121
05/05/2021,280,3,17,50,67
05/05/2021,846,3,0,17,17
05/05/2021,293,3,48,171,219
05/05/2021,465,3,21,65,86
05/05/2021,311,3,31,98,129
05/05/2021,783,3,45,150,195
05/05/2021,217,3,48,180,228
05/05/2021,712,3,14,36,50
05/05/2021,566,3,21,54,75
05/05/2021,907,3,50,108,158
05/05/2021,824,3,24,53,77
05/05/2021,797,3,61,83,144
05/05/2021,356,3,43,118,161
05/05/2021,333,3,32,222,254
05/05/2021,114,3,29,73,102
05/05/2021,360,3,36,86,122
05/05/2021,79,3,24,59,83
05/05/2021,43,3,20,92,112
05/05/2021,637,3,46,134,180
05/05/2021,500,3,6,27,33
05/05/2021,262,3,17,31,48
05/05/2021,193,3,45,65,110
05/05/2021,106,3,48,133,181
05/05/2021,228,3,26,59,85
05/05/2021,183,3,29,57,86
05/05/2021,475,3,65,117,182
05/05/2021,451,3,110,283,393
05/05/2021,917,3,0,4,4
05/05/2021,932,3,0,1,1
05/05/2021,594,3,44,104,148
05/05/2021,617,3,36,58,94
05/05/2021,848,3,38,90,128
05/05/2021,755,3,44,141,185
05/05/2021,865,3,20,27,47
05/05/2021,519,3,17,73,90
05/05/2021,645,3,22,41,63
05/05/2021,552,3,47,94,141
05/05/2021,331,3,17,42,59
05/05/2021,81,3,13,47,60
05/05/2021,606,3,28,106,134
05/05/2021,116,3,18,48,66
05/05/2021,773,3,37,88,125
05/05/2021,771,3,26,128,154
05/05/2021,351,3,68,123,191
05/05/2021,388,3,50,128,178
05/05/2021,291,3,57,233,290
05/05/2021,44,3,53,121,174
05/05/2021,532,3,109,283,392
05/05/2021,719,3,17,29,46
05/05/2021,874,3,5,13,18
05/05/2021,577,3,24,118,142
05/05/2021,595,3,21,54,75
05/05/2021,876,3,0,6,6
05/05/2021,282,3,19,63,82
05/05/2021,396,3,17,41,58
05/05/2021,335,3,47,140,187
05/05/2021,867,3,25,53,78
05/05/2021,20,3,22,23,45
05/05/2021,676,3,18,54,72
05/05/2021,592,3,38,79,117
05/05/2021,224,3,26,61,87
05/05/2021,779,3,21,48,69
05/05/2021,869,3,58,107,165
05/05/2021,781,3,52,133,185
05/05/2021,347,3,98,173,271
05/05/2021,515,3,29,111,140
05/05/2021,65,3,22,114,136
05/05/2021,254,3,21,58,79
05/05/2021,629,3,25,76,101
05/05/2021,590,3,0,1,1
05/05/2021,789,3,44,77,121
05/05/2021,130,3,54,148,202
05/05/2021,207,3,22,73,95
05/05/2021,419,3,80,191,271
05/05/2021,214,3,48,186,234
05/05/2021,725,3,37,93,130
05/05/2021,208,3,12,48,60
05/05/2021,880,3,0,18,18
05/05/2021,664,3,41,119,160
05/05/2021,21,3,24,97,121
05/05/2021,845,3,40,61,101
05/05/2021,225,3,30,92,122
05/05/2021,618,3,47,73,120
05/05/2021,827,3,66,148,214
05/05/2021,346,3,19,56,75
05/05/2021,160,3,7,6,13
05/05/2021,31,3,24,77,101
05/05/2021,363,3,59,107,166
05/05/2021,483,3,45,70,115
05/05/2021,791,3,39,95,134
05/05/2021,203,3,14,67,81
05/05/2021,486,3,50,99,149
05/05/2021,757,3,42,105,147
05/05/2021,732,3,20,45,65
05/05/2021,327,3,54,139,193
05/05/2021,96,3,24,80,104
05/05/2021,2,3,25,83,108
05/05/2021,386,3,76,174,250
05/05/2021,921,3,0,4,4
05/05/2021,818,3,49,210,259
05/05/2021,490,3,2,30,32
05/05/2021,158,3,27,71,98
05/05/2021,441,3,29,54,83
05/05/2021,820,3,38,85,123
05/05/2021,830,3,127,249,376
05/05/2021,339,3,9,13,22
05/05/2021,643,3,29,86,115
05/05/2021,410,3,28,147,175
05/05/2021,531,3,42,69,111
05/05/2021,53,3,44,70,114
05/05/2021,256,3,29,67,96
05/05/2021,680,3,26,45,71
05/05/2021,661,3,7,15,22
05/05/2021,651,3,30,59,89
05/05/2021,425,3,37,105,142
05/05/2021,461,3,1,22,23
05/05/2021,517,3,19,42,61
05/05/2021,580,3,25,40,65
05/05/2021,469,3,31,114,145
05/05/2021,260,3,118,271,389
05/05/2021,578,3,15,53,68
05/05/2021,24,3,14,21,35
05/05/2021,694,3,34,47,81
05/05/2021,421,3,69,130,199
05/05/2021,681,3,36,89,125
05/05/2021,60,3,9,20,29
05/05/2021,658,3,7,67,74
05/05/2021,383,3,54,198,252
05/05/2021,418,3,18,21,39
05/05/2021,235,3,27,97,124
05/05/2021,752,3,38,105,143
05/05/2021,863,3,41,62,103
05/05/2021,534,3,19,44,63
05/05/2021,924,3,0,1,1
05/05/2021,194,3,1,2,3
05/05/2021,632,3,17,11,28
05/05/2021,918,3,0,9,9
05/05/2021,675,3,23,72,95
05/05/2021,730,3,17,60,77
05/05/2021,447,3,35,96,131
05/05/2021,800,3,34,91,125
05/05/2021,268,3,44,136,180
05/05/2021,8,3,25,79,104
05/05/2021,761,3,17,40,57
05/05/2021,471,3,25,52,77
05/05/2021,22,3,30,94,124
05/05/2021,303,3,49,191,240
05/05/2021,546,3,14,23,37
05/05/2021,682,3,12,36,48
05/05/2021,724,3,121,245,366
05/05/2021,911,3,3,9,12
05/05/2021,716,3,25,51,76
05/05/2021,459,3,44,93,137
05/05/2021,698,3,23,84,107
05/05/2021,550,3,43,78,121
05/05/2021,313,3,24,43,67
05/05/2021,98,3,57,141,198
05/05/2021,856,3,19,27,46
05/05/2021,299,3,22,64,86
05/05/2021,55,3,24,56,80
05/05/2021,319,3,17,40,57
05/05/2021,301,3,59,226,285
05/05/2021,337,3,10,35,45
05/05/2021,508,3,34,115,149
05/05/2021,808,3,67,140,207
05/05/2021,329,3,52,136,188
05/05/2021,814,3,25,40,65
05/05/2021,844,3,1,7,8
05/05/2021,891,3,26,69,95
05/05/2021,181,3,32,48,80
05/05/2021,452,3,46,96,142
05/05/2021,612,3,50,185,235
05/05/2021,127,3,27,57,84
05/05/2021,772,3,51,108,159
05/05/2021,52,3,45,88,133
05/05/2021,222,3,18,54,72
05/05/2021,310,3,70,168,238
05/05/2021,426,3,28,49,77
05/05/2021,906,3,4,7,11
05/05/2021,742,3,28,79,107
05/05/2021,326,3,13,41,54
05/05/2021,275,3,22,81,103
05/05/2021,227,3,26,66,92
05/05/2021,481,3,44,62,106
05/05/2021,861,3,63,84,147
05/05/2021,691,3,18,73,91
05/05/2021,647,3,21,59,80
05/05/2021,832,3,30,71,101
05/05/2021,382,3,0,7,7
05/05/2021,110,3,30,54,84
05/05/2021,484,3,41,63,104
05/05/2021,686,3,20,68,88
05/05/2021,506,3,6,31,37
05/05/2021,598,3,120,264,384
05/05/2021,714,3,36,91,127
05/05/2021,136,3,48,141,189
05/05/2021,431,3,47,72,119
05/05/2021,352,3,38,118,156
05/05/2021,439,3,29,65,94
05/05/2021,574,3,34,57,91
05/05/2021,404,3,64,140,204
05/05/2021,584,3,67,204,271
05/05/2021,838,3,12,43,55
05/05/2021,728,3,37,80,117
05/05/2021,362,3,58,106,164
05/05/2021,896,3,140,279,419
05/05/2021,50,3,22,30,52
05/05/2021,849,3,30,122,152
05/05/2021,573,3,32,56,88
05/05/2021,847,3,1,12,13
05/05/2021,470,3,25,47,72
05/05/2021,553,3,33,89,122
05/05/2021,819,3,28,83,111
05/05/2021,801,3,45,128,173
05/05/2021,23,3,14,23,37
05/05/2021,379,3,59,144,203
05/05/2021,13,3,16,46,62
05/05/2021,503,3,4,13,17
05/05/2021,377,3,32,78,110
05/05/2021,273,3,42,236,278
05/05/2021,36,3,22,81,103
05/05/2021,599,3,119,263,382
05/05/2021,283,3,34,69,103
05/05/2021,468,3,32,75,107
05/05/2021,640,3,21,65,86
05/05/2021,605,3,69,189,258
05/05/2021,405,3,23,26,49
05/05/2021,336,3,99,210,309
05/05/2021,395,3,14,57,71
05/05/2021,689,3,33,69,102
05/05/2021,190,3,32,96,128
05/05/2021,420,3,77,149,226
05/05/2021,778,3,44,108,152
05/05/2021,271,3,33,71,104
05/05/2021,243,3,83,293,376
05/05/2021,151,3,13,43,56
05/05/2021,255,3,2,8,10
05/05/2021,365,3,30,71,101
05/05/2021,342,3,25,77,102
05/05/2021,259,3,97,215,312
05/05/2021,184,3,44,57,101
05/05/2021,131,3,33,84,117
05/05/2021,526,3,23,57,80
05/05/2021,593,3,77,212,289
05/05/2021,817,3,33,94,127
05/05/2021,620,3,0,1,1
05/05/2021,639,3,31,49,80
05/05/2021,627,3,33,53,86
05/05/2021,659,3,6,61,67
05/05/2021,372,3,58,138,196
05/05/2021,376,3,14,26,40
05/05/2021,270,3,7,53,60
05/05/2021,35,3,31,101,132
05/05/2021,919,3,34,61,95
05/05/2021,665,3,14,72,86
05/05/2021,307,3,26,92,118
05/05/2021,674,3,19,58,77
05/05/2021,554,3,31,82,113
05/05/2021,197,3,31,56,87
05/05/2021,85,3,70,65,135
05/05/2021,295,3,6,21,27
05/05/2021,48,3,22,26,48
05/05/2021,768,3,41,182,223
05/05/2021,853,3,38,54,92
05/05/2021,312,3,26,48,74
05/05/2021,300,3,70,288,358
05/05/2021,540,3,49,98,147
05/05/2021,249,3,89,294,383
05/05/2021,557,3,21,64,85
05/05/2021,348,3,25,74,99
05/05/2021,851,3,10,18,28
05/05/2021,898,3,23,30,53
05/05/2021,670,3,140,294,434
05/05/2021,833,3,22,30,52
05/05/2021,397,3,14,46,60
05/05/2021,266,3,31,72,103
05/05/2021,321,3,12,44,56
05/05/2021,427,3,28,78,106
05/05/2021,600,3,87,257,344
05/05/2021,252,3,26,53,79
05/05/2021,51,3,59,164,223
05/05/2021,213,3,50,196,246
05/05/2021,163,3,19,77,96
05/05/2021,354,3,2,0,2
05/05/2021,909,3,2,2,4
05/05/2021,138,3,34,78,112
05/05/2021,875,3,30,52,82
05/05/2021,417,3,40,163,203
05/05/2021,128,3,31,62,93
05/05/2021,684,3,36,95,131
05/05/2021,936,3,2,5,7
05/05/2021,836,3,37,163,200
05/05/2021,455,3,3,11,14
05/05/2021,741,3,8,40,48
05/05/2021,179,3,21,56,77
05/05/2021,343,3,21,65,86
05/05/2021,828,3,34,50,84
05/05/2021,358,3,55,154,209
05/05/2021,414,3,16,44,60
05/05/2021,201,3,16,60,76
05/05/2021,562,3,21,29,50
05/05/2021,641,3,8,19,27
05/05/2021,494,3,29,48,77
05/05/2021,653,3,13,29,42
05/05/2021,156,3,25,98,123
05/05/2021,621,3,34,92,126
05/05/2021,445,3,46,115,161
05/05/2021,905,3,0,2,2
05/05/2021,793,3,46,123,169
05/05/2021,671,3,36,161,197
05/05/2021,722,3,13,52,65
05/05/2021,775,3,27,59,86
05/05/2021,41,3,13,74,87
05/05/2021,602,3,71,194,265
05/05/2021,449,3,54,125,179
05/05/2021,26,3,26,77,103
05/05/2021,810,3,10,11,21
05/05/2021,317,3,65,119,184
05/05/2021,63,3,13,46,59
05/05/2021,576,3,10,24,34
05/05/2021,240,3,74,243,317
05/05/2021,148,3,25,55,80
05/05/2021,345,3,22,46,68
05/05/2021,146,3,50,151,201
05/05/2021,812,3,22,63,85
05/05/2021,513,3,27,83,110
05/05/2021,871,3,53,126,179
05/05/2021,726,3,29,83,112
05/05/2021,720,3,11,29,40
05/05/2021,649,3,17,48,65
05/05/2021,747,3,28,66,94
05/05/2021,297,3,51,205,256
05/05/2021,315,3,4,40,44
05/05/2021,169,3,24,97,121
05/05/2021,548,3,22,35,57
05/05/2021,68,3,27,114,141
05/05/2021,662,3,39,114,153
05/05/2021,115,3,14,51,65
05/05/2021,884,3,4,39,43
05/05/2021,9,3,44,90,134
05/05/2021,542,3,34,91,125
05/05/2021,756,3,46,162,208
05/05/2021,428,3,33,72,105
05/05/2021,933,3,0,1,1
05/05/2021,616,3,61,89,150
05/05/2021,344,3,20,77,97
05/05/2021,129,3,47,93,140
05/05/2021,135,3,49,143,192
05/05/2021,437,3,46,111,157
05/05/2021,226,3,23,61,84
05/05/2021,915,3,0,21,21
05/05/2021,152,3,22,93,115
05/05/2021,498,3,16,60,76
05/05/2021,57,3,27,117,144
05/05/2021,806,3,66,150,216
05/05/2021,368,3,27,103,130
05/05/2021,669,3,21,58,79
05/05/2021,211,3,49,183,232
05/05/2021,4,3,21,63,84
05/05/2021,525,3,38,106,144
05/05/2021,560,3,76,125,201
05/05/2021,657,3,46,116,162
05/05/2021,67,3,25,99,124
05/05/2021,572,3,29,54,83
05/05/2021,205,3,16,73,89
05/05/2021,374,3,12,40,52
05/05/2021,91,3,53,89,142
05/05/2021,625,3,32,51,83
05/05/2021,631,3,10,14,24
05/05/2021,435,3,31,55,86
05/05/2021,749,3,5,3,8
05/05/2021,533,3,10,16,26
05/05/2021,737,3,8,39,47
05/05/2021,87,3,54,125,179
05/05/2021,246,3,80,271,351
05/05/2021,209,3,10,51,61
05/05/2021,739,3,9,42,51
05/05/2021,433,3,93,253,346
05/05/2021,529,3,29,88,117
05/05/2021,816,3,60,144,204
05/05/2021,496,3,11,39,50
05/05/2021,394,3,14,62,76
05/05/2021,467,3,1,10,11
05/05/2021,881,3,1,17,18
05/05/2021,173,3,22,44,66
05/05/2021,167,3,27,87,114
05/05/2021,862,3,32,65,97
05/05/2021,142,3,7,40,47
05/05/2021,12,3,15,34,49
05/05/2021,390,3,59,131,190
05/05/2021,527,3,22,67,89
05/05/2021,212,3,54,207,261
05/05/2021,210,3,26,96,122
05/05/2021,78,3,104,243,347
05/05/2021,330,3,33,105,138
05/05/2021,493,3,20,68,88
05/05/2021,902,3,28,72,100
05/05/2021,338,3,55,120,175
05/05/2021,411,3,36,174,210
05/05/2021,304,3,33,97,130
05/05/2021,807,3,22,73,95
05/05/2021,117,3,79,134,213
05/05/2021,603,3,51,143,194
05/05/2021,472,3,23,65,88
05/05/2021,322,3,22,74,96
05/05/2021,308,3,24,77,101
05/05/2021,579,3,18,23,41
05/05/2021,438,3,26,63,89
05/05/2021,58,3,36,158,194
05/05/2021,764,3,13,28,41
05/05/2021,218,3,48,185,233
05/05/2021,509,3,26,100,126
05/05/2021,715,3,50,95,145
05/05/2021,403,3,40,86,126
05/05/2021,381,3,1,4,5
05/05/2021,703,3,12,65,77
05/05/2021,685,3,33,59,92
05/05/2021,841,3,14,66,80
05/05/2021,511,3,23,92,115
05/05/2021,487,3,32,47,79
05/05/2021,233,3,39,89,128
05/05/2021,731,3,24,53,77
05/05/2021,263,3,32,77,109
05/05/2021,583,3,28,75,103
05/05/2021,440,3,11,31,42
05/05/2021,216,3,30,92,122
05/05/2021,369,3,63,145,208
05/05/2021,86,3,24,77,101
05/05/2021,748,3,15,68,83
05/05/2021,634,3,36,98,134
05/05/2021,624,3,10,40,50
05/05/2021,813,3,27,70,97
05/05/2021,760,3,35,63,98
05/05/2021,3,3,24,76,100
05/05/2021,422,3,30,61,91
05/05/2021,642,3,25,70,95
05/05/2021,204,3,6,14,20
05/05/2021,139,3,34,61,95
05/05/2021,622,3,65,148,213
05/05/2021,754,3,34,132,166
05/05/2021,92,3,34,81,115
05/05/2021,202,3,47,141,188
05/05/2021,464,3,74,182,256
05/05/2021,518,3,31,64,95
05/05/2021,292,3,73,286,359
05/05/2021,72,3,46,182,228
05/05/2021,782,3,46,132,178
05/05/2021,199,3,16,49,65
05/05/2021,582,3,102,278,380
05/05/2021,743,3,16,42,58
05/05/2021,543,3,126,242,368
05/05/2021,930,3,1,11,12
05/05/2021,412,3,15,109,124
05/05/2021,45,3,39,84,123
05/05/2021,134,3,47,137,184
05/05/2021,126,3,27,100,127
05/05/2021,510,3,3,15,18
05/05/2021,341,3,102,217,319
05/05/2021,39,3,21,93,114
05/05/2021,102,3,69,157,226
05/05/2021,706,3,41,82,123
05/05/2021,46,3,25,78,103
05/05/2021,245,3,88,294,382
05/05/2021,581,3,47,80,127
05/05/2021,25,3,50,81,131
05/05/2021,608,3,65,225,290
05/05/2021,904,3,70,212,282
05/05/2021,922,3,0,3,3
05/05/2021,507,3,42,160,202
05/05/2021,792,3,33,51,84
05/05/2021,442,3,26,92,118
05/05/2021,677,3,10,47,57
05/05/2021,200,3,26,73,99
05/05/2021,145,3,29,81,110
05/05/2021,353,3,10,40,50
05/05/2021,652,3,16,33,49
05/05/2021,555,3,68,122,190
05/05/2021,687,3,36,95,131
05/05/2021,119,3,41,86,127
05/05/2021,444,3,33,72,105
05/05/2021,809,3,25,51,76
05/05/2021,133,3,20,32,52
05/05/2021,591,3,27,65,92
05/05/2021,231,3,41,93,134
05/05/2021,448,3,108,295,403
05/05/2021,230,3,39,70,109
05/05/2021,799,3,6,15,21
05/05/2021,6,3,25,77,102
05/05/2021,539,3,42,70,112
05/05/2021,521,3,19,35,54
05/05/2021,787,3,83,223,306
05/05/2021,734,3,15,54,69
05/05/2021,234,3,15,25,40
05/05/2021,364,3,60,109,169
05/05/2021,325,3,18,70,88
05/05/2021,49,3,22,26,48
05/05/2021,118,3,45,73,118
05/05/2021,258,3,102,244,346
05/05/2021,873,3,52,85,137
05/05/2021,284,3,22,32,54
05/05/2021,925,3,0,2,2
05/05/2021,387,3,30,38,68
05/05/2021,536,3,20,60,80
05/05/2021,926,3,4,2,6
05/05/2021,302,3,56,229,285
05/05/2021,367,3,29,115,144
05/05/2021,693,3,17,54,71
05/05/2021,727,3,21,73,94
05/05/2021,908,3,2,5,7
05/05/2021,914,3,0,3,3
05/05/2021,886,3,0,5,5
05/05/2021,285,3,29,49,78
05/05/2021,750,3,28,101,129
05/05/2021,206,3,3,5,8
05/05/2021,76,3,32,151,183
05/05/2021,805,3,31,40,71
05/05/2021,385,3,29,61,90
05/05/2021,180,3,35,98,133
05/05/2021,699,3,38,70,108
05/05/2021,294,3,31,93,124
05/05/2021,626,3,30,54,84
05/05/2021,34,3,31,65,96
05/05/2021,432,3,0,16,16
05/05/2021,84,3,92,169,261
05/05/2021,857,3,32,58,90
05/05/2021,143,3,51,149,200
05/05/2021,220,3,21,64,85
05/05/2021,569,3,42,64,106
05/05/2021,551,3,38,98,136
05/05/2021,575,3,11,33,44
05/05/2021,373,3,27,65,92
05/05/2021,538,3,33,90,123
05/05/2021,650,3,48,121,169
05/05/2021,113,3,25,46,71
05/05/2021,430,3,40,67,107
05/05/2021,758,3,27,101,128
05/05/2021,563,3,26,65,91
05/05/2021,839,3,40,101,141
05/05/2021,137,3,33,79,112
05/05/2021,872,3,18,32,50
05/05/2021,767,3,74,202,276
05/05/2021,429,3,46,128,174
05/05/2021,860,3,33,80,113
05/05/2021,250,3,55,101,156
05/05/2021,33,3,32,50,82
05/05/2021,120,3,33,83,116
05/05/2021,108,3,14,45,59
05/05/2021,480,3,26,33,59
05/05/2021,854,3,77,193,270
05/05/2021,392,3,16,60,76
05/05/2021,232,3,28,62,90
05/05/2021,274,3,1,26,27
05/05/2021,366,3,22,29,51
05/05/2021,885,3,6,40,46
05/05/2021,623,3,43,60,103
05/05/2021,588,3,26,60,86
05/05/2021,177,3,20,51,71
05/05/2021,89,3,44,104,148
05/05/2021,370,3,28,111,139
05/05/2021,615,3,20,86,106
05/05/2021,852,3,69,107,176
05/05/2021,710,3,14,38,52
05/05/2021,171,3,11,24,35
05/05/2021,100,3,18,35,53
05/05/2021,745,3,28,63,91
05/05/2021,122,3,37,82,119
05/05/2021,71,3,23,68,91
05/05/2021,753,3,28,92,120
05/05/2021,278,3,16,45,61
05/05/2021,700,3,23,74,97
05/05/2021,892,3,3,9,12
05/05/2021,843,3,15,54,69
05/05/2021,495,3,16,61,77
05/05/2021,359,3,33,88,121
05/05/2021,82,3,34,86,120
05/05/2021,288,3,14,44,58
05/05/2021,328,3,25,40,65
05/05/2021,910,3,4,50,54
05/05/2021,261,3,121,271,392
05/05/2021,454,3,1,15,16
05/05/2021,11,3,35,86,121
05/05/2021,70,3,33,155,188
05/05/2021,409,3,23,27,50
05/05/2021,614,3,38,50,88
05/05/2021,424,3,41,271,312
05/05/2021,780,3,79,187,266
05/05/2021,711,3,13,38,51
05/05/2021,638,3,32,78,110
05/05/2021,705,3,9,22,31
05/05/2021,170,3,26,106,132
05/05/2021,829,3,20,76,96
05/05/2021,866,3,37,110,147
05/05/2021,717,3,31,65,96
05/05/2021,679,3,33,72,105
05/05/2021,559,3,77,136,213
05/05/2021,407,3,23,136,159
05/05/2021,357,3,52,147,199
05/05/2021,107,3,78,200,278
05/05/2021,668,3,2,8,10
05/05/2021,5,3,24,75,99
05/05/2021,821,3,34,77,111
05/05/2021,316,3,36,78,114
05/05/2021,174,3,17,48,65
05/05/2021,530,3,14,33,47
05/05/2021,290,3,62,252,314
05/05/2021,476,3,24,79,103
05/05/2021,38,3,18,89,107
05/05/2021,522,3,23,79,102
05/05/2021,446,3,28,91,119
05/05/2021,666,3,34,72,106
05/05/2021,790,3,52,151,203
05/05/2021,491,3,35,134,169
05/05/2021,401,3,19,37,56
05/05/2021,707,3,41,78,119
05/05/2021,784,3,55,155,210
05/05/2021,239,3,44,153,197
05/05/2021,66,3,3,13,16
05/05/2021,267,3,30,76,106
05/05/2021,416,3,11,36,47
05/05/2021,450,3,40,82,122
05/05/2021,182,3,32,50,82
05/05/2021,281,3,39,110,149
05/05/2021,296,3,18,40,58
05/05/2021,882,3,0,10,10
05/05/2021,75,3,37,163,200
05/05/2021,323,3,16,55,71
05/05/2021,384,3,28,83,111
05/05/2021,544,3,35,56,91
05/05/2021,215,3,26,77,103
05/05/2021,619,3,25,32,57
05/05/2021,564,3,37,74,111
05/05/2021,77,3,39,166,205
05/05/2021,349,3,20,54,74
05/05/2021,219,3,21,74,95
05/05/2021,633,3,21,52,73
05/05/2021,556,3,77,140,217
05/05/2021,887,3,1,14,15
05/05/2021,101,3,27,87,114
05/05/2021,88,3,45,73,118
05/05/2021,890,3,2,20,22
05/05/2021,334,3,64,158,222
05/05/2021,520,3,19,41,60
05/05/2021,19,3,25,102,127
05/05/2021,460,3,34,72,106
05/05/2021,815,3,118,245,363
05/05/2021,172,3,26,103,129
05/05/2021,466,3,33,73,106
05/05/2021,99,3,72,181,253
05/05/2021,803,3,23,98,121
05/05/2021,738,3,27,82,109
05/05/2021,868,3,74,140,214
05/05/2021,485,3,40,63,103
05/05/2021,723,3,21,73,94
05/05/2021,64,3,2,8,10
06/05/2021,88,3,36,85,121
06/05/2021,520,3,15,46,61
06/05/2021,99,3,72,200,272
06/05/2021,334,3,63,159,222
06/05/2021,19,3,65,102,167
06/05/2021,101,3,22,114,136
06/05/2021,460,3,31,76,107
06/05/2021,64,3,1,8,9
06/05/2021,466,3,28,102,130
06/05/2021,738,3,30,75,105
06/05/2021,815,3,117,236,353
06/05/2021,868,3,69,139,208
06/05/2021,723,3,17,79,96
06/05/2021,485,3,29,78,107
06/05/2021,890,3,2,24,26
06/05/2021,172,3,24,94,118
06/05/2021,803,3,27,104,131
06/05/2021,420,3,62,153,215
06/05/2021,131,3,30,110,140
06/05/2021,593,3,56,214,270
06/05/2021,342,3,21,94,115
06/05/2021,259,3,84,230,314
06/05/2021,778,3,49,116,165
06/05/2021,271,3,36,61,97
06/05/2021,255,3,4,11,15
06/05/2021,184,3,34,67,101
06/05/2021,151,3,14,48,62
06/05/2021,817,3,32,96,128
06/05/2021,365,3,30,65,95
06/05/2021,526,3,17,53,70
06/05/2021,689,3,34,68,102
06/05/2021,190,3,32,94,126
06/05/2021,243,3,79,317,396
06/05/2021,704,3,7,34,41
06/05/2021,826,3,43,115,158
06/05/2021,879,3,1,23,24
06/05/2021,765,3,39,111,150
06/05/2021,751,3,0,8,8
06/05/2021,236,3,2,17,19
06/05/2021,47,3,25,65,90
06/05/2021,221,3,26,69,95
06/05/2021,242,3,72,295,367
06/05/2021,154,3,27,90,117
06/05/2021,759,3,16,36,52
06/05/2021,488,3,20,64,84
06/05/2021,18,3,19,72,91
06/05/2021,802,3,36,124,160
06/05/2021,161,3,94,155,249
06/05/2021,37,3,35,71,106
06/05/2021,95,3,41,99,140
06/05/2021,443,3,25,111,136
06/05/2021,473,3,22,52,74
06/05/2021,59,3,22,94,116
06/05/2021,309,3,22,46,68
06/05/2021,244,3,42,101,143
06/05/2021,195,3,16,51,67
06/05/2021,378,3,20,88,108
06/05/2021,175,3,22,66,88
06/05/2021,477,3,23,72,95
06/05/2021,702,3,22,62,84
06/05/2021,558,3,17,55,72
06/05/2021,613,3,9,56,65
06/05/2021,93,3,43,140,183
06/05/2021,858,3,66,144,210
06/05/2021,69,3,31,92,123
06/05/2021,795,3,44,114,158
06/05/2021,398,3,6,4,10
06/05/2021,504,3,5,47,52
06/05/2021,492,3,15,45,60
06/05/2021,883,3,7,81,88
06/05/2021,903,3,0,1,1
06/05/2021,537,3,43,101,144
06/05/2021,406,3,42,100,142
06/05/2021,889,3,0,9,9
06/05/2021,586,3,58,208,266
06/05/2021,15,3,38,103,141
06/05/2021,251,3,15,71,86
06/05/2021,654,3,42,140,182
06/05/2021,269,3,36,53,89
06/05/2021,162,3,93,159,252
06/05/2021,253,3,10,48,58
06/05/2021,56,3,42,125,167
06/05/2021,597,3,21,48,69
06/05/2021,350,3,23,70,93
06/05/2021,192,3,18,58,76
06/05/2021,825,3,40,134,174
06/05/2021,462,3,4,12,16
06/05/2021,399,3,44,131,175
06/05/2021,186,3,16,54,70
06/05/2021,512,3,11,37,48
06/05/2021,474,3,24,57,81
06/05/2021,393,3,16,37,53
06/05/2021,247,3,70,213,283
06/05/2021,683,3,23,95,118
06/05/2021,436,3,31,93,124
06/05/2021,7,3,22,65,87
06/05/2021,646,3,14,60,74
06/05/2021,125,3,32,75,107
06/05/2021,497,3,46,135,181
06/05/2021,798,3,61,137,198
06/05/2021,166,3,18,52,70
06/05/2021,196,3,3,2,5
06/05/2021,123,3,45,74,119
06/05/2021,105,3,58,106,164
06/05/2021,157,3,36,97,133
06/05/2021,585,3,57,138,195
06/05/2021,774,3,38,81,119
06/05/2021,935,3,0,1,1
06/05/2021,298,3,82,362,444
06/05/2021,400,3,7,42,49
06/05/2021,423,3,31,284,315
06/05/2021,570,3,35,57,92
06/05/2021,777,3,19,71,90
06/05/2021,187,3,10,54,64
06/05/2021,28,3,15,57,72
06/05/2021,238,3,66,268,334
06/05/2021,696,3,21,91,112
06/05/2021,276,3,47,115,162
06/05/2021,189,3,26,65,91
06/05/2021,380,3,34,83,117
06/05/2021,305,3,29,98,127
06/05/2021,286,3,14,66,80
06/05/2021,895,3,30,72,102
06/05/2021,897,3,3,8,11
06/05/2021,785,3,67,207,274
06/05/2021,17,3,16,57,73
06/05/2021,413,3,34,142,176
06/05/2021,864,3,21,68,89
06/05/2021,198,3,54,88,142
06/05/2021,361,3,73,108,181
06/05/2021,42,3,21,59,80
06/05/2021,589,3,12,58,70
06/05/2021,648,3,20,63,83
06/05/2021,147,3,21,95,116
06/05/2021,607,3,48,204,252
06/05/2021,888,3,1,8,9
06/05/2021,332,3,28,101,129
06/05/2021,287,3,89,364,453
06/05/2021,571,3,15,3,18
06/05/2021,776,3,21,74,95
06/05/2021,153,3,29,96,125
06/05/2021,30,3,37,82,119
06/05/2021,842,3,14,19,33
06/05/2021,850,3,94,173,267
06/05/2021,604,3,56,155,211
06/05/2021,61,3,24,106,130
06/05/2021,144,3,37,106,143
06/05/2021,289,3,27,98,125
06/05/2021,185,3,27,85,112
06/05/2021,124,3,41,49,90
06/05/2021,701,3,20,44,64
06/05/2021,514,3,13,33,46
06/05/2021,391,3,45,119,164
06/05/2021,660,3,15,74,89
06/05/2021,111,3,45,128,173
06/05/2021,371,3,21,61,82
06/05/2021,878,3,1,11,12
06/05/2021,1,3,21,65,86
06/05/2021,265,3,19,55,74
06/05/2021,823,3,19,57,76
06/05/2021,453,3,34,114,148
06/05/2021,463,3,92,252,344
06/05/2021,457,3,25,53,78
06/05/2021,692,3,12,10,22
06/05/2021,655,3,43,121,164
06/05/2021,840,3,30,105,135
06/05/2021,140,3,21,55,76
06/05/2021,663,3,33,103,136
06/05/2021,877,3,0,17,17
06/05/2021,635,3,31,105,136
06/05/2021,746,3,21,88,109
06/05/2021,159,3,26,87,113
06/05/2021,456,3,5,13,18
06/05/2021,721,3,82,294,376
06/05/2021,713,3,33,300,333
06/05/2021,736,3,7,25,32
06/05/2021,770,3,71,219,290
06/05/2021,937,3,1,0,1
06/05/2021,229,3,42,107,149
06/05/2021,524,3,37,98,135
06/05/2021,90,3,23,87,110
06/05/2021,168,3,28,72,100
06/05/2021,811,3,20,55,75
06/05/2021,673,3,33,120,153
06/05/2021,587,3,12,23,35
06/05/2021,567,3,46,87,133
06/05/2021,547,3,111,267,378
06/05/2021,149,3,21,70,91
06/05/2021,794,3,81,216,297
06/05/2021,27,3,69,150,219
06/05/2021,561,3,15,43,58
06/05/2021,164,3,21,72,93
06/05/2021,458,3,33,116,149
06/05/2021,628,3,24,45,69
06/05/2021,178,3,29,69,98
06/05/2021,565,3,81,149,230
06/05/2021,306,3,0,3,3
06/05/2021,478,3,18,10,28
06/05/2021,54,3,20,41,61
06/05/2021,788,3,35,71,106
06/05/2021,279,3,55,113,168
06/05/2021,528,3,15,49,64
06/05/2021,786,3,39,87,126
06/05/2021,318,3,42,87,129
06/05/2021,735,3,8,29,37
06/05/2021,489,3,5,23,28
06/05/2021,237,3,74,273,347
06/05/2021,155,3,43,159,202
06/05/2021,499,3,32,97,129
06/05/2021,870,3,11,32,43
06/05/2021,80,3,15,39,54
06/05/2021,355,3,14,43,57
06/05/2021,97,3,58,160,218
06/05/2021,733,3,19,48,67
06/05/2021,501,3,6,19,25
06/05/2021,859,3,4,3,7
06/05/2021,601,3,21,84,105
06/05/2021,636,3,15,35,50
06/05/2021,610,3,33,170,203
06/05/2021,697,3,18,87,105
06/05/2021,656,3,10,32,42
06/05/2021,340,3,8,19,27
06/05/2021,894,3,27,63,90
06/05/2021,188,3,35,96,131
06/05/2021,264,3,22,53,75
06/05/2021,934,3,1,14,15
06/05/2021,83,3,131,248,379
06/05/2021,104,3,53,115,168
06/05/2021,248,3,25,74,99
06/05/2021,899,3,45,123,168
06/05/2021,112,3,13,43,56
06/05/2021,402,3,47,89,136
06/05/2021,901,3,0,2,2
06/05/2021,408,3,15,53,68
06/05/2021,479,3,11,36,47
06/05/2021,688,3,17,64,81
06/05/2021,804,3,76,282,358
06/05/2021,272,3,62,82,144
06/05/2021,535,3,17,60,77
06/05/2021,505,3,29,83,112
06/05/2021,434,3,3,16,19
06/05/2021,257,3,82,230,312
06/05/2021,855,3,38,138,176
06/05/2021,176,3,27,69,96
06/05/2021,709,3,54,85,139
06/05/2021,32,3,33,55,88
06/05/2021,837,3,72,237,309
06/05/2021,314,3,3,16,19
06/05/2021,835,3,37,121,158
06/05/2021,121,3,99,229,328
06/05/2021,103,3,66,143,209
06/05/2021,277,3,28,71,99
06/05/2021,389,3,50,126,176
06/05/2021,831,3,41,126,167
06/05/2021,503,3,5,12,17
06/05/2021,377,3,32,80,112
06/05/2021,36,3,20,78,98
06/05/2021,640,3,19,67,86
06/05/2021,468,3,23,86,109
06/05/2021,405,3,19,24,43
06/05/2021,336,3,88,211,299
06/05/2021,273,3,36,203,239
06/05/2021,13,3,17,55,72
06/05/2021,395,3,19,44,63
06/05/2021,283,3,26,74,100
06/05/2021,605,3,65,198,263
06/05/2021,599,3,120,246,366
06/05/2021,2,3,21,65,86
06/05/2021,490,3,5,25,30
06/05/2021,53,3,34,84,118
06/05/2021,256,3,24,83,107
06/05/2021,818,3,48,192,240
06/05/2021,531,3,27,95,122
06/05/2021,643,3,27,87,114
06/05/2021,921,3,0,6,6
06/05/2021,830,3,104,257,361
06/05/2021,203,3,55,64,119
06/05/2021,757,3,49,126,175
06/05/2021,96,3,17,88,105
06/05/2021,410,3,35,143,178
06/05/2021,386,3,77,180,257
06/05/2021,820,3,30,91,121
06/05/2021,486,3,40,108,148
06/05/2021,732,3,16,45,61
06/05/2021,327,3,55,132,187
06/05/2021,339,3,7,14,21
06/05/2021,441,3,32,69,101
06/05/2021,158,3,24,75,99
06/05/2021,791,3,42,98,140
06/05/2021,606,3,31,105,136
06/05/2021,351,3,68,135,203
06/05/2021,645,3,16,60,76
06/05/2021,116,3,13,47,60
06/05/2021,291,3,61,288,349
06/05/2021,773,3,40,81,121
06/05/2021,81,3,16,37,53
06/05/2021,771,3,28,112,140
06/05/2021,331,3,15,63,78
06/05/2021,552,3,39,103,142
06/05/2021,388,3,52,136,188
06/05/2021,217,3,43,191,234
06/05/2021,333,3,32,238,270
06/05/2021,907,3,50,133,183
06/05/2021,43,3,22,98,120
06/05/2021,824,3,24,72,96
06/05/2021,566,3,15,61,76
06/05/2021,280,3,35,44,79
06/05/2021,712,3,11,40,51
06/05/2021,637,3,42,135,177
06/05/2021,846,3,2,20,22
06/05/2021,311,3,29,96,125
06/05/2021,783,3,49,133,182
06/05/2021,79,3,25,64,89
06/05/2021,465,3,18,77,95
06/05/2021,293,3,43,202,245
06/05/2021,500,3,9,18,27
06/05/2021,114,3,34,73,107
06/05/2021,797,3,43,96,139
06/05/2021,356,3,45,109,154
06/05/2021,360,3,34,79,113
06/05/2021,228,3,33,69,102
06/05/2021,519,3,55,65,120
06/05/2021,594,3,34,112,146
06/05/2021,617,3,29,68,97
06/05/2021,183,3,25,73,98
06/05/2021,865,3,18,26,44
06/05/2021,755,3,48,125,173
06/05/2021,475,3,67,120,187
06/05/2021,848,3,33,113,146
06/05/2021,193,3,42,75,117
06/05/2021,106,3,51,144,195
06/05/2021,262,3,17,48,65
06/05/2021,932,3,1,1,2
06/05/2021,451,3,105,336,441
06/05/2021,917,3,1,5,6
06/05/2021,208,3,14,48,62
06/05/2021,664,3,45,139,184
06/05/2021,483,3,33,93,126
06/05/2021,346,3,17,56,73
06/05/2021,618,3,40,85,125
06/05/2021,31,3,24,76,100
06/05/2021,160,3,2,8,10
06/05/2021,845,3,33,77,110
06/05/2021,21,3,20,93,113
06/05/2021,725,3,29,91,120
06/05/2021,214,3,44,192,236
06/05/2021,363,3,81,115,196
06/05/2021,225,3,34,109,143
06/05/2021,880,3,1,14,15
06/05/2021,827,3,56,154,210
06/05/2021,874,3,5,11,16
06/05/2021,44,3,53,156,209
06/05/2021,719,3,12,44,56
06/05/2021,595,3,16,69,85
06/05/2021,532,3,87,284,371
06/05/2021,577,3,27,106,133
06/05/2021,876,3,0,8,8
06/05/2021,65,3,25,115,140
06/05/2021,629,3,23,77,100
06/05/2021,779,3,18,61,79
06/05/2021,347,3,101,175,276
06/05/2021,590,3,0,2,2
06/05/2021,224,3,33,74,107
06/05/2021,282,3,43,52,95
06/05/2021,789,3,43,80,123
06/05/2021,515,3,37,112,149
06/05/2021,335,3,34,146,180
06/05/2021,396,3,19,29,48
06/05/2021,781,3,48,178,226
06/05/2021,130,3,65,158,223
06/05/2021,20,3,16,19,35
06/05/2021,592,3,29,88,117
06/05/2021,869,3,72,109,181
06/05/2021,254,3,21,76,97
06/05/2021,867,3,33,49,82
06/05/2021,676,3,16,58,74
06/05/2021,207,3,25,73,98
06/05/2021,419,3,67,219,286
06/05/2021,50,3,20,27,47
06/05/2021,470,3,23,85,108
06/05/2021,573,3,40,65,105
06/05/2021,801,3,38,143,181
06/05/2021,379,3,50,159,209
06/05/2021,819,3,33,67,100
06/05/2021,896,3,118,287,405
06/05/2021,847,3,1,13,14
06/05/2021,849,3,30,113,143
06/05/2021,23,3,14,29,43
06/05/2021,553,3,35,102,137
06/05/2021,800,3,36,86,122
06/05/2021,761,3,15,39,54
06/05/2021,22,3,26,80,106
06/05/2021,682,3,11,37,48
06/05/2021,447,3,28,124,152
06/05/2021,303,3,47,198,245
06/05/2021,268,3,46,142,188
06/05/2021,730,3,18,47,65
06/05/2021,546,3,22,31,53
06/05/2021,471,3,24,79,103
06/05/2021,8,3,16,88,104
06/05/2021,651,3,25,55,80
06/05/2021,578,3,15,59,74
06/05/2021,680,3,23,58,81
06/05/2021,661,3,12,24,36
06/05/2021,580,3,19,63,82
06/05/2021,421,3,60,141,201
06/05/2021,425,3,37,120,157
06/05/2021,461,3,3,29,32
06/05/2021,469,3,33,133,166
06/05/2021,260,3,98,271,369
06/05/2021,694,3,26,52,78
06/05/2021,517,3,20,32,52
06/05/2021,24,3,14,31,45
06/05/2021,675,3,22,87,109
06/05/2021,658,3,11,73,84
06/05/2021,918,3,0,8,8
06/05/2021,632,3,11,22,33
06/05/2021,235,3,23,113,136
06/05/2021,534,3,12,50,62
06/05/2021,752,3,41,91,132
06/05/2021,194,3,0,1,1
06/05/2021,900,3,0,2,2
06/05/2021,60,3,6,19,25
06/05/2021,681,3,31,95,126
06/05/2021,924,3,0,1,1
06/05/2021,418,3,20,30,50
06/05/2021,863,3,37,69,106
06/05/2021,383,3,54,183,237
06/05/2021,484,3,29,76,105
06/05/2021,404,3,51,150,201
06/05/2021,832,3,32,69,101
06/05/2021,352,3,42,127,169
06/05/2021,686,3,19,70,89
06/05/2021,728,3,38,91,129
06/05/2021,110,3,17,61,78
06/05/2021,136,3,55,151,206
06/05/2021,506,3,7,31,38
06/05/2021,382,3,0,4,4
06/05/2021,362,3,75,110,185
06/05/2021,431,3,35,82,117
06/05/2021,584,3,48,206,254
06/05/2021,439,3,25,73,98
06/05/2021,598,3,118,253,371
06/05/2021,838,3,17,39,56
06/05/2021,714,3,33,119,152
06/05/2021,647,3,21,75,96
06/05/2021,574,3,41,67,108
06/05/2021,301,3,57,300,357
06/05/2021,98,3,56,153,209
06/05/2021,329,3,56,126,182
06/05/2021,911,3,3,4,7
06/05/2021,313,3,18,48,66
06/05/2021,337,3,11,34,45
06/05/2021,724,3,103,236,339
06/05/2021,716,3,25,58,83
06/05/2021,55,3,22,60,82
06/05/2021,550,3,34,91,125
06/05/2021,181,3,18,51,69
06/05/2021,913,3,0,1,1
06/05/2021,891,3,20,74,94
06/05/2021,698,3,18,91,109
06/05/2021,299,3,23,76,99
06/05/2021,814,3,11,40,51
06/05/2021,844,3,1,9,10
06/05/2021,459,3,37,108,145
06/05/2021,319,3,20,38,58
06/05/2021,856,3,20,30,50
06/05/2021,508,3,39,129,168
06/05/2021,808,3,64,174,238
06/05/2021,861,3,62,96,158
06/05/2021,326,3,11,41,52
06/05/2021,227,3,32,84,116
06/05/2021,426,3,24,82,106
06/05/2021,742,3,29,101,130
06/05/2021,222,3,18,64,82
06/05/2021,691,3,24,86,110
06/05/2021,310,3,73,164,237
06/05/2021,52,3,44,95,139
06/05/2021,906,3,7,9,16
06/05/2021,127,3,18,52,70
06/05/2021,612,3,44,172,216
06/05/2021,481,3,34,89,123
06/05/2021,772,3,47,90,137
06/05/2021,452,3,38,112,150
06/05/2021,275,3,19,89,108
06/05/2021,633,3,12,45,57
06/05/2021,75,3,25,148,173
06/05/2021,77,3,30,151,181
06/05/2021,619,3,21,28,49
06/05/2021,384,3,28,78,106
06/05/2021,349,3,21,47,68
06/05/2021,323,3,16,38,54
06/05/2021,219,3,20,87,107
06/05/2021,564,3,28,79,107
06/05/2021,556,3,84,155,239
06/05/2021,215,3,17,71,88
06/05/2021,887,3,0,18,18
06/05/2021,544,3,30,64,94
06/05/2021,754,3,35,122,157
06/05/2021,422,3,25,95,120
06/05/2021,813,3,22,73,95
06/05/2021,518,3,24,61,85
06/05/2021,292,3,80,347,427
06/05/2021,622,3,54,150,204
06/05/2021,3,3,22,64,86
06/05/2021,760,3,23,70,93
06/05/2021,642,3,21,69,90
06/05/2021,464,3,63,210,273
06/05/2021,782,3,46,110,156
06/05/2021,204,3,46,12,58
06/05/2021,202,3,54,127,181
06/05/2021,72,3,31,161,192
06/05/2021,92,3,33,84,117
06/05/2021,139,3,35,89,124
06/05/2021,315,3,10,45,55
06/05/2021,726,3,24,71,95
06/05/2021,747,3,22,75,97
06/05/2021,720,3,8,47,55
06/05/2021,871,3,65,148,213
06/05/2021,548,3,28,39,67
06/05/2021,649,3,23,54,77
06/05/2021,169,3,20,85,105
06/05/2021,297,3,57,249,306
06/05/2021,684,3,36,100,136
06/05/2021,909,3,4,25,29
06/05/2021,875,3,24,73,97
06/05/2021,600,3,80,248,328
06/05/2021,427,3,29,130,159
06/05/2021,163,3,18,61,79
06/05/2021,417,3,40,159,199
06/05/2021,138,3,31,113,144
06/05/2021,266,3,36,69,105
06/05/2021,836,3,41,151,192
06/05/2021,936,3,1,9,10
06/05/2021,213,3,50,202,252
06/05/2021,321,3,10,52,62
06/05/2021,252,3,19,48,67
06/05/2021,354,3,2,1,3
06/05/2021,51,3,57,162,219
06/05/2021,128,3,22,51,73
06/05/2021,85,3,77,62,139
06/05/2021,665,3,18,77,95
06/05/2021,372,3,68,162,230
06/05/2021,919,3,32,58,90
06/05/2021,295,3,11,21,32
06/05/2021,659,3,10,65,75
06/05/2021,376,3,14,31,45
06/05/2021,270,3,8,48,56
06/05/2021,35,3,29,90,119
06/05/2021,674,3,15,53,68
06/05/2021,554,3,22,107,129
06/05/2021,197,3,23,63,86
06/05/2021,627,3,30,45,75
06/05/2021,639,3,29,71,100
06/05/2021,307,3,32,107,139
06/05/2021,768,3,44,196,240
06/05/2021,853,3,28,60,88
06/05/2021,557,3,19,70,89
06/05/2021,670,3,115,314,429
06/05/2021,48,3,19,24,43
06/05/2021,397,3,17,32,49
06/05/2021,833,3,18,36,54
06/05/2021,540,3,43,114,157
06/05/2021,312,3,31,49,80
06/05/2021,348,3,21,63,84
06/05/2021,898,3,21,29,50
06/05/2021,249,3,86,326,412
06/05/2021,851,3,5,6,11
06/05/2021,300,3,71,359,430
06/05/2021,240,3,66,276,342
06/05/2021,812,3,23,86,109
06/05/2021,345,3,22,53,75
06/05/2021,148,3,23,70,93
06/05/2021,513,3,31,85,116
06/05/2021,26,3,29,65,94
06/05/2021,810,3,12,12,24
06/05/2021,146,3,49,183,232
06/05/2021,63,3,13,54,67
06/05/2021,317,3,69,126,195
06/05/2021,576,3,7,24,31
06/05/2021,741,3,9,38,47
06/05/2021,494,3,23,57,80
06/05/2021,455,3,1,15,16
06/05/2021,201,3,20,62,82
06/05/2021,179,3,18,53,71
06/05/2021,562,3,11,38,49
06/05/2021,621,3,48,98,146
06/05/2021,156,3,21,98,119
06/05/2021,653,3,10,33,43
06/05/2021,445,3,42,131,173
06/05/2021,828,3,35,59,94
06/05/2021,358,3,53,152,205
06/05/2021,905,3,0,2,2
06/05/2021,343,3,15,75,90
06/05/2021,414,3,15,56,71
06/05/2021,641,3,3,10,13
06/05/2021,671,3,38,155,193
06/05/2021,775,3,22,61,83
06/05/2021,449,3,47,144,191
06/05/2021,928,3,0,2,2
06/05/2021,793,3,39,136,175
06/05/2021,602,3,72,212,284
06/05/2021,41,3,17,86,103
06/05/2021,722,3,8,48,56
06/05/2021,841,3,18,123,141
06/05/2021,748,3,18,70,88
06/05/2021,216,3,22,93,115
06/05/2021,731,3,21,51,72
06/05/2021,86,3,22,86,108
06/05/2021,624,3,9,32,41
06/05/2021,583,3,34,83,117
06/05/2021,369,3,72,150,222
06/05/2021,263,3,29,102,131
06/05/2021,233,3,32,97,129
06/05/2021,381,3,1,3,4
06/05/2021,487,3,25,68,93
06/05/2021,440,3,13,64,77
06/05/2021,703,3,12,54,66
06/05/2021,685,3,17,62,79
06/05/2021,634,3,31,100,131
06/05/2021,511,3,20,93,113
06/05/2021,631,3,5,23,28
06/05/2021,91,3,43,106,149
06/05/2021,374,3,9,47,56
06/05/2021,246,3,80,305,385
06/05/2021,87,3,52,130,182
06/05/2021,737,3,9,42,51
06/05/2021,625,3,25,63,88
06/05/2021,533,3,16,25,41
06/05/2021,435,3,34,64,98
06/05/2021,205,3,60,69,129
06/05/2021,572,3,37,64,101
06/05/2021,749,3,9,5,14
06/05/2021,428,3,35,82,117
06/05/2021,542,3,34,94,128
06/05/2021,756,3,52,143,195
06/05/2021,129,3,43,127,170
06/05/2021,344,3,56,74,130
06/05/2021,68,3,30,116,146
06/05/2021,9,3,44,70,114
06/05/2021,662,3,47,139,186
06/05/2021,115,3,14,53,67
06/05/2021,884,3,6,78,84
06/05/2021,135,3,58,154,212
06/05/2021,616,3,60,99,159
06/05/2021,226,3,26,78,104
06/05/2021,498,3,22,53,75
06/05/2021,657,3,46,115,161
06/05/2021,152,3,22,95,117
06/05/2021,368,3,31,99,130
06/05/2021,57,3,28,119,147
06/05/2021,560,3,80,141,221
06/05/2021,437,3,39,120,159
06/05/2021,806,3,62,165,227
06/05/2021,915,3,1,16,17
06/05/2021,525,3,38,106,144
06/05/2021,67,3,23,97,120
06/05/2021,4,3,18,64,82
06/05/2021,669,3,18,52,70
06/05/2021,211,3,44,191,235
06/05/2021,715,3,50,101,151
06/05/2021,218,3,45,192,237
06/05/2021,764,3,11,28,39
06/05/2021,603,3,50,149,199
06/05/2021,472,3,25,93,118
06/05/2021,438,3,23,60,83
06/05/2021,58,3,38,154,192
06/05/2021,403,3,53,86,139
06/05/2021,509,3,29,107,136
06/05/2021,322,3,25,59,84
06/05/2021,579,3,13,23,36
06/05/2021,308,3,26,91,117
06/05/2021,527,3,19,50,69
06/05/2021,394,3,17,48,65
06/05/2021,881,3,1,17,18
06/05/2021,173,3,16,52,68
06/05/2021,209,3,20,62,82
06/05/2021,816,3,57,144,201
06/05/2021,142,3,10,33,43
06/05/2021,529,3,23,83,106
06/05/2021,739,3,9,38,47
06/05/2021,496,3,14,40,54
06/05/2021,167,3,31,78,109
06/05/2021,433,3,93,283,376
06/05/2021,12,3,18,25,43
06/05/2021,390,3,53,137,190
06/05/2021,862,3,32,93,125
06/05/2021,467,3,3,13,16
06/05/2021,212,3,53,213,266
06/05/2021,411,3,41,173,214
06/05/2021,807,3,20,61,81
06/05/2021,902,3,21,73,94
06/05/2021,210,3,35,107,142
06/05/2021,117,3,65,134,199
06/05/2021,78,3,86,255,341
06/05/2021,304,3,38,119,157
06/05/2021,330,3,35,126,161
06/05/2021,338,3,39,140,179
06/05/2021,493,3,22,66,88
06/05/2021,790,3,48,160,208
06/05/2021,666,3,22,87,109
06/05/2021,182,3,17,59,76
06/05/2021,450,3,34,106,140
06/05/2021,296,3,20,60,80
06/05/2021,416,3,15,43,58
06/05/2021,281,3,49,116,165
06/05/2021,267,3,35,67,102
06/05/2021,522,3,18,89,107
06/05/2021,707,3,47,76,123
06/05/2021,446,3,26,112,138
06/05/2021,491,3,41,142,183
06/05/2021,401,3,12,41,53
06/05/2021,66,3,5,13,18
06/05/2021,239,3,38,176,214
06/05/2021,784,3,58,148,206
06/05/2021,882,3,0,11,11
06/05/2021,120,3,35,85,120
06/05/2021,588,3,23,62,85
06/05/2021,232,3,30,82,112
06/05/2021,108,3,12,50,62
06/05/2021,366,3,23,28,51
06/05/2021,860,3,30,88,118
06/05/2021,429,3,37,124,161
06/05/2021,177,3,16,49,65
06/05/2021,854,3,71,209,280
06/05/2021,250,3,65,90,155
06/05/2021,392,3,20,45,65
06/05/2021,767,3,69,216,285
06/05/2021,623,3,40,66,106
06/05/2021,885,3,10,80,90
06/05/2021,33,3,36,74,110
06/05/2021,480,3,13,43,56
06/05/2021,274,3,1,23,24
06/05/2021,258,3,86,249,335
06/05/2021,364,3,79,110,189
06/05/2021,6,3,22,70,92
06/05/2021,925,3,0,4,4
06/05/2021,521,3,17,32,49
06/05/2021,234,3,10,32,42
06/05/2021,799,3,7,18,25
06/05/2021,284,3,14,37,51
06/05/2021,49,3,19,24,43
06/05/2021,539,3,36,78,114
06/05/2021,734,3,17,56,73
06/05/2021,873,3,46,83,129
06/05/2021,787,3,79,217,296
06/05/2021,118,3,37,98,135
06/05/2021,230,3,38,76,114
06/05/2021,325,3,19,66,85
06/05/2021,923,3,1,0,1
06/05/2021,341,3,89,219,308
06/05/2021,582,3,71,275,346
06/05/2021,510,3,5,14,19
06/05/2021,45,3,35,96,131
06/05/2021,412,3,23,105,128
06/05/2021,134,3,54,152,206
06/05/2021,126,3,66,95,161
06/05/2021,199,3,16,52,68
06/05/2021,930,3,0,14,14
06/05/2021,543,3,102,251,353
06/05/2021,706,3,49,83,132
06/05/2021,39,3,23,102,125
06/05/2021,102,3,61,172,233
06/05/2021,743,3,15,60,75
06/05/2021,608,3,50,207,257
06/05/2021,904,3,66,223,289
06/05/2021,555,3,72,137,209
06/05/2021,652,3,14,33,47
06/05/2021,448,3,98,341,439
06/05/2021,687,3,35,102,137
06/05/2021,581,3,46,73,119
06/05/2021,231,3,54,105,159
06/05/2021,809,3,21,57,78
06/05/2021,444,3,26,83,109
06/05/2021,200,3,26,87,113
06/05/2021,245,3,81,323,404
06/05/2021,677,3,10,48,58
06/05/2021,507,3,51,162,213
06/05/2021,133,3,18,27,45
06/05/2021,922,3,0,6,6
06/05/2021,353,3,11,33,44
06/05/2021,46,3,21,59,80
06/05/2021,442,3,29,99,128
06/05/2021,591,3,21,66,87
06/05/2021,792,3,31,49,80
06/05/2021,145,3,29,95,124
06/05/2021,25,3,50,100,150
06/05/2021,119,3,34,105,139
06/05/2021,373,3,21,75,96
06/05/2021,113,3,16,53,69
06/05/2021,551,3,42,124,166
06/05/2021,872,3,18,41,59
06/05/2021,575,3,12,28,40
06/05/2021,569,3,45,78,123
06/05/2021,758,3,62,96,158
06/05/2021,538,3,31,95,126
06/05/2021,430,3,34,84,118
06/05/2021,650,3,39,137,176
06/05/2021,137,3,31,107,138
06/05/2021,563,3,22,75,97
06/05/2021,839,3,32,117,149
06/05/2021,387,3,30,43,73
06/05/2021,302,3,58,285,343
06/05/2021,914,3,1,3,4
06/05/2021,367,3,32,114,146
06/05/2021,908,3,3,3,6
06/05/2021,693,3,18,71,89
06/05/2021,727,3,18,69,87
06/05/2021,536,3,16,66,82
06/05/2021,926,3,3,2,5
06/05/2021,180,3,48,98,146
06/05/2021,432,3,4,22,26
06/05/2021,285,3,23,62,85
06/05/2021,294,3,37,82,119
06/05/2021,857,3,31,82,113
06/05/2021,220,3,25,79,104
06/05/2021,84,3,92,171,263
06/05/2021,750,3,28,96,124
06/05/2021,143,3,48,189,237
06/05/2021,699,3,34,79,113
06/05/2021,385,3,19,64,83
06/05/2021,805,3,29,44,73
06/05/2021,76,3,24,131,155
06/05/2021,206,3,2,5,7
06/05/2021,886,3,1,2,3
06/05/2021,34,3,32,67,99
06/05/2021,626,3,31,51,82
06/05/2021,916,3,1,1,2
06/05/2021,668,3,1,14,15
06/05/2021,679,3,29,78,107
06/05/2021,357,3,52,143,195
06/05/2021,476,3,22,82,104
06/05/2021,5,3,21,61,82
06/05/2021,107,3,71,223,294
06/05/2021,38,3,22,95,117
06/05/2021,530,3,15,31,46
06/05/2021,407,3,32,134,166
06/05/2021,316,3,30,89,119
06/05/2021,174,3,17,46,63
06/05/2021,559,3,81,154,235
06/05/2021,821,3,46,81,127
06/05/2021,290,3,65,301,366
06/05/2021,454,3,4,19,23
06/05/2021,82,3,35,77,112
06/05/2021,843,3,14,57,71
06/05/2021,359,3,30,91,121
06/05/2021,892,3,3,25,28
06/05/2021,328,3,23,53,76
06/05/2021,495,3,21,52,73
06/05/2021,261,3,100,280,380
06/05/2021,288,3,20,48,68
06/05/2021,910,3,6,93,99
06/05/2021,122,3,38,88,126
06/05/2021,370,3,31,113,144
06/05/2021,171,3,9,20,29
06/05/2021,700,3,17,80,97
06/05/2021,71,3,16,68,84
06/05/2021,852,3,58,108,166
06/05/2021,89,3,41,108,149
06/05/2021,753,3,24,86,110
06/05/2021,278,3,33,41,74
06/05/2021,745,3,25,89,114
06/05/2021,615,3,58,78,136
06/05/2021,100,3,24,42,66
06/05/2021,710,3,9,40,49
06/05/2021,11,3,42,78,120
06/05/2021,866,3,40,91,131
06/05/2021,638,3,34,76,110
06/05/2021,717,3,27,74,101
06/05/2021,409,3,25,35,60
06/05/2021,70,3,26,138,164
06/05/2021,780,3,73,222,295
06/05/2021,705,3,6,20,26
06/05/2021,829,3,24,85,109
06/05/2021,424,3,36,296,332
06/05/2021,711,3,10,45,55
06/05/2021,170,3,25,99,124
06/05/2021,614,3,34,51,85
07/05/2021,705,3,5,26,31
07/05/2021,170,3,22,126,148
07/05/2021,717,3,11,72,83
07/05/2021,11,3,29,88,117
07/05/2021,866,3,61,186,247
07/05/2021,711,3,17,88,105
07/05/2021,638,3,25,86,111
07/05/2021,409,3,21,59,80
07/05/2021,424,3,56,726,782
07/05/2021,614,3,13,50,63
07/05/2021,780,3,92,350,442
07/05/2021,70,3,42,304,346
07/05/2021,829,3,36,124,160
07/05/2021,313,3,18,55,73
07/05/2021,55,3,15,62,77
07/05/2021,329,3,72,239,311
07/05/2021,459,3,22,116,138
07/05/2021,856,3,34,48,82
07/05/2021,724,3,116,349,465
07/05/2021,508,3,42,221,263
07/05/2021,337,3,6,42,48
07/05/2021,299,3,37,128,165
07/05/2021,808,3,106,274,380
07/05/2021,716,3,12,56,68
07/05/2021,301,3,72,498,570
07/05/2021,98,3,74,270,344
07/05/2021,698,3,20,188,208
07/05/2021,844,3,1,11,12
07/05/2021,911,3,22,130,152
07/05/2021,319,3,14,41,55
07/05/2021,181,3,18,69,87
07/05/2021,891,3,22,77,99
07/05/2021,550,3,34,172,206
07/05/2021,814,3,8,59,67
07/05/2021,97,3,87,243,330
07/05/2021,656,3,9,65,74
07/05/2021,870,3,2,36,38
07/05/2021,340,3,11,17,28
07/05/2021,697,3,20,186,206
07/05/2021,610,3,50,342,392
07/05/2021,499,3,33,162,195
07/05/2021,188,3,32,93,125
07/05/2021,636,3,26,77,103
07/05/2021,355,3,13,37,50
07/05/2021,501,3,12,51,63
07/05/2021,894,3,41,97,138
07/05/2021,601,3,20,171,191
07/05/2021,733,3,8,66,74
07/05/2021,80,3,8,39,47
07/05/2021,859,3,5,11,16
07/05/2021,497,3,47,241,288
07/05/2021,157,3,37,136,173
07/05/2021,123,3,27,63,90
07/05/2021,125,3,18,75,93
07/05/2021,585,3,62,210,272
07/05/2021,196,3,9,13,22
07/05/2021,166,3,13,75,88
07/05/2021,298,3,90,592,682
07/05/2021,774,3,28,75,103
07/05/2021,105,3,65,166,231
07/05/2021,7,3,22,97,119
07/05/2021,646,3,34,172,206
07/05/2021,798,3,62,203,265
07/05/2021,759,3,12,54,66
07/05/2021,221,3,15,73,88
07/05/2021,765,3,47,125,172
07/05/2021,18,3,24,93,117
07/05/2021,47,3,24,55,79
07/05/2021,242,3,95,496,591
07/05/2021,704,3,8,37,45
07/05/2021,236,3,6,24,30
07/05/2021,751,3,4,19,23
07/05/2021,488,3,27,81,108
07/05/2021,826,3,33,170,203
07/05/2021,154,3,33,142,175
07/05/2021,879,3,0,19,19
07/05/2021,88,3,27,74,101
07/05/2021,19,3,76,152,228
07/05/2021,868,3,102,254,356
07/05/2021,101,3,28,239,267
07/05/2021,485,3,29,86,115
07/05/2021,460,3,28,108,136
07/05/2021,99,3,115,360,475
07/05/2021,738,3,43,114,157
07/05/2021,815,3,82,334,416
07/05/2021,520,3,18,67,85
07/05/2021,466,3,26,112,138
07/05/2021,172,3,21,119,140
07/05/2021,803,3,43,132,175
07/05/2021,890,3,9,76,85
07/05/2021,64,3,1,11,12
07/05/2021,334,3,75,241,316
07/05/2021,723,3,42,122,164
07/05/2021,271,3,23,61,84
07/05/2021,131,3,47,223,270
07/05/2021,365,3,33,108,141
07/05/2021,689,3,40,117,157
07/05/2021,342,3,19,69,88
07/05/2021,817,3,33,99,132
07/05/2021,151,3,15,52,67
07/05/2021,526,3,11,48,59
07/05/2021,255,3,3,14,17
07/05/2021,778,3,58,181,239
07/05/2021,593,3,61,323,384
07/05/2021,184,3,30,80,110
07/05/2021,259,3,99,420,519
07/05/2021,190,3,26,77,103
07/05/2021,420,3,99,278,377
07/05/2021,243,3,101,509,610
07/05/2021,15,3,52,176,228
07/05/2021,597,3,6,42,48
07/05/2021,247,3,84,337,421
07/05/2021,683,3,24,128,152
07/05/2021,512,3,11,62,73
07/05/2021,462,3,5,21,26
07/05/2021,393,3,16,38,54
07/05/2021,350,3,13,66,79
07/05/2021,654,3,27,193,220
07/05/2021,436,3,25,87,112
07/05/2021,251,3,10,65,75
07/05/2021,253,3,12,56,68
07/05/2021,825,3,47,136,183
07/05/2021,162,3,66,217,283
07/05/2021,192,3,14,76,90
07/05/2021,269,3,23,55,78
07/05/2021,399,3,62,215,277
07/05/2021,186,3,26,71,97
07/05/2021,56,3,34,164,198
07/05/2021,474,3,20,65,85
07/05/2021,161,3,68,218,286
07/05/2021,95,3,61,196,257
07/05/2021,195,3,13,56,69
07/05/2021,443,3,30,136,166
07/05/2021,59,3,23,126,149
07/05/2021,802,3,57,237,294
07/05/2021,309,3,10,36,46
07/05/2021,473,3,16,62,78
07/05/2021,244,3,49,189,238
07/05/2021,37,3,37,85,122
07/05/2021,69,3,23,103,126
07/05/2021,492,3,12,57,69
07/05/2021,883,3,11,171,182
07/05/2021,175,3,29,88,117
07/05/2021,558,3,9,58,67
07/05/2021,795,3,23,126,149
07/05/2021,378,3,14,62,76
07/05/2021,537,3,62,172,234
07/05/2021,504,3,10,56,66
07/05/2021,702,3,18,69,87
07/05/2021,477,3,13,79,92
07/05/2021,613,3,10,47,57
07/05/2021,93,3,21,152,173
07/05/2021,586,3,85,372,457
07/05/2021,889,3,0,8,8
07/05/2021,858,3,79,220,299
07/05/2021,398,3,8,10,18
07/05/2021,903,3,1,1,2
07/05/2021,406,3,54,170,224
07/05/2021,628,3,30,73,103
07/05/2021,318,3,30,152,182
07/05/2021,178,3,34,105,139
07/05/2021,788,3,51,137,188
07/05/2021,54,3,15,47,62
07/05/2021,528,3,12,51,63
07/05/2021,155,3,51,235,286
07/05/2021,489,3,4,28,32
07/05/2021,458,3,18,125,143
07/05/2021,306,3,0,2,2
07/05/2021,237,3,82,414,496
07/05/2021,565,3,96,223,319
07/05/2021,279,3,40,103,143
07/05/2021,786,3,57,173,230
07/05/2021,735,3,10,42,52
07/05/2021,478,3,18,20,38
07/05/2021,144,3,28,158,186
07/05/2021,185,3,24,98,122
07/05/2021,850,3,66,232,298
07/05/2021,604,3,66,238,304
07/05/2021,289,3,35,121,156
07/05/2021,30,3,80,99,179
07/05/2021,842,3,11,19,30
07/05/2021,61,3,28,141,169
07/05/2021,124,3,25,50,75
07/05/2021,400,3,5,43,48
07/05/2021,187,3,24,84,108
07/05/2021,189,3,11,65,76
07/05/2021,28,3,15,52,67
07/05/2021,423,3,50,696,746
07/05/2021,380,3,31,95,126
07/05/2021,570,3,17,88,105
07/05/2021,777,3,30,87,117
07/05/2021,895,3,34,90,124
07/05/2021,276,3,35,92,127
07/05/2021,238,3,89,448,537
07/05/2021,305,3,28,139,167
07/05/2021,696,3,18,114,132
07/05/2021,785,3,93,392,485
07/05/2021,897,3,2,7,9
07/05/2021,286,3,22,103,125
07/05/2021,648,3,18,74,92
07/05/2021,864,3,20,60,80
07/05/2021,287,3,94,592,686
07/05/2021,589,3,9,65,74
07/05/2021,198,3,35,91,126
07/05/2021,147,3,20,134,154
07/05/2021,413,3,41,270,311
07/05/2021,17,3,14,58,72
07/05/2021,361,3,95,249,344
07/05/2021,332,3,15,105,120
07/05/2021,571,3,7,10,17
07/05/2021,153,3,32,149,181
07/05/2021,776,3,25,168,193
07/05/2021,607,3,60,386,446
07/05/2021,888,3,6,14,20
07/05/2021,42,3,32,87,119
07/05/2021,794,3,62,284,346
07/05/2021,149,3,22,114,136
07/05/2021,168,3,23,75,98
07/05/2021,746,3,17,67,84
07/05/2021,90,3,13,107,120
07/05/2021,567,3,28,114,142
07/05/2021,159,3,21,135,156
07/05/2021,164,3,15,84,99
07/05/2021,721,3,98,524,622
07/05/2021,736,3,6,30,36
07/05/2021,27,3,106,277,383
07/05/2021,229,3,56,183,239
07/05/2021,713,3,45,654,699
07/05/2021,587,3,6,26,32
07/05/2021,547,3,123,386,509
07/05/2021,770,3,82,372,454
07/05/2021,456,3,5,15,20
07/05/2021,811,3,20,53,73
07/05/2021,524,3,38,109,147
07/05/2021,673,3,18,107,125
07/05/2021,561,3,7,53,60
07/05/2021,111,3,59,194,253
07/05/2021,660,3,15,68,83
07/05/2021,701,3,15,51,66
07/05/2021,265,3,31,85,116
07/05/2021,391,3,36,167,203
07/05/2021,878,3,1,11,12
07/05/2021,371,3,17,72,89
07/05/2021,514,3,10,54,64
07/05/2021,1,3,21,97,118
07/05/2021,823,3,30,109,139
07/05/2021,655,3,58,148,206
07/05/2021,457,3,21,79,100
07/05/2021,840,3,14,116,130
07/05/2021,692,3,15,26,41
07/05/2021,663,3,34,96,130
07/05/2021,635,3,30,142,172
07/05/2021,453,3,28,128,156
07/05/2021,463,3,75,316,391
07/05/2021,877,3,1,15,16
07/05/2021,140,3,5,58,63
07/05/2021,439,3,24,110,134
07/05/2021,728,3,21,127,148
07/05/2021,404,3,72,210,282
07/05/2021,647,3,14,78,92
07/05/2021,584,3,55,340,395
07/05/2021,686,3,19,92,111
07/05/2021,598,3,91,384,475
07/05/2021,714,3,40,136,176
07/05/2021,574,3,22,101,123
07/05/2021,838,3,27,92,119
07/05/2021,136,3,59,230,289
07/05/2021,110,3,11,70,81
07/05/2021,832,3,31,98,129
07/05/2021,362,3,97,251,348
07/05/2021,506,3,12,69,81
07/05/2021,352,3,42,129,171
07/05/2021,382,3,0,4,4
07/05/2021,431,3,33,105,138
07/05/2021,484,3,27,82,109
07/05/2021,755,3,44,199,243
07/05/2021,865,3,20,63,83
07/05/2021,475,3,78,177,255
07/05/2021,519,3,66,97,163
07/05/2021,932,3,2,5,7
07/05/2021,451,3,91,455,546
07/05/2021,617,3,21,57,78
07/05/2021,262,3,28,70,98
07/05/2021,594,3,34,177,211
07/05/2021,228,3,26,94,120
07/05/2021,106,3,59,251,310
07/05/2021,917,3,6,9,15
07/05/2021,193,3,23,107,130
07/05/2021,183,3,21,84,105
07/05/2021,848,3,48,214,262
07/05/2021,503,3,11,44,55
07/05/2021,599,3,90,372,462
07/05/2021,283,3,22,94,116
07/05/2021,605,3,71,265,336
07/05/2021,640,3,21,105,126
07/05/2021,273,3,39,297,336
07/05/2021,405,3,22,64,86
07/05/2021,377,3,24,94,118
07/05/2021,395,3,17,51,68
07/05/2021,36,3,20,113,133
07/05/2021,336,3,101,311,412
07/05/2021,468,3,25,99,124
07/05/2021,13,3,20,67,87
07/05/2021,248,3,33,138,171
07/05/2021,688,3,22,98,120
07/05/2021,408,3,23,101,124
07/05/2021,804,3,86,425,511
07/05/2021,112,3,9,42,51
07/05/2021,104,3,64,201,265
07/05/2021,899,3,54,231,285
07/05/2021,264,3,30,81,111
07/05/2021,479,3,13,52,65
07/05/2021,402,3,27,137,164
07/05/2021,83,3,92,367,459
07/05/2021,535,3,21,89,110
07/05/2021,901,3,1,2,3
07/05/2021,934,3,0,13,13
07/05/2021,272,3,67,121,188
07/05/2021,176,3,36,100,136
07/05/2021,835,3,39,173,212
07/05/2021,32,3,26,74,100
07/05/2021,855,3,33,144,177
07/05/2021,257,3,94,377,471
07/05/2021,103,3,84,221,305
07/05/2021,709,3,74,125,199
07/05/2021,389,3,33,179,212
07/05/2021,121,3,111,341,452
07/05/2021,831,3,30,103,133
07/05/2021,837,3,63,321,384
07/05/2021,314,3,12,46,58
07/05/2021,277,3,32,141,173
07/05/2021,434,3,9,30,39
07/05/2021,505,3,24,133,157
07/05/2021,43,3,24,146,170
07/05/2021,637,3,52,234,286
07/05/2021,824,3,27,110,137
07/05/2021,280,3,22,42,64
07/05/2021,311,3,34,141,175
07/05/2021,217,3,63,325,388
07/05/2021,797,3,78,131,209
07/05/2021,566,3,9,62,71
07/05/2021,712,3,21,83,104
07/05/2021,907,3,60,195,255
07/05/2021,114,3,35,99,134
07/05/2021,293,3,39,370,409
07/05/2021,465,3,21,91,112
07/05/2021,356,3,39,170,209
07/05/2021,333,3,48,591,639
07/05/2021,783,3,48,206,254
07/05/2021,846,3,7,30,37
07/05/2021,500,3,5,45,50
07/05/2021,79,3,28,110,138
07/05/2021,360,3,24,95,119
07/05/2021,410,3,38,252,290
07/05/2021,490,3,5,28,33
07/05/2021,820,3,24,92,116
07/05/2021,531,3,27,130,157
07/05/2021,256,3,38,105,143
07/05/2021,757,3,49,175,224
07/05/2021,643,3,24,119,143
07/05/2021,203,3,62,92,154
07/05/2021,2,3,21,96,117
07/05/2021,339,3,10,8,18
07/05/2021,53,3,72,96,168
07/05/2021,486,3,32,107,139
07/05/2021,818,3,55,279,334
07/05/2021,732,3,8,72,80
07/05/2021,921,3,0,9,9
07/05/2021,327,3,73,239,312
07/05/2021,830,3,116,367,483
07/05/2021,96,3,16,166,182
07/05/2021,441,3,31,115,146
07/05/2021,791,3,36,134,170
07/05/2021,158,3,16,113,129
07/05/2021,386,3,77,307,384
07/05/2021,606,3,33,170,203
07/05/2021,81,3,7,40,47
07/05/2021,351,3,77,252,329
07/05/2021,388,3,36,164,200
07/05/2021,331,3,20,104,124
07/05/2021,771,3,25,226,251
07/05/2021,116,3,23,80,103
07/05/2021,291,3,67,518,585
07/05/2021,552,3,36,194,230
07/05/2021,645,3,30,159,189
07/05/2021,773,3,26,76,102
07/05/2021,918,3,0,6,6
07/05/2021,632,3,5,30,35
07/05/2021,675,3,9,85,94
07/05/2021,235,3,12,114,126
07/05/2021,681,3,20,84,104
07/05/2021,863,3,24,56,80
07/05/2021,658,3,17,110,127
07/05/2021,900,3,0,3,3
07/05/2021,534,3,27,139,166
07/05/2021,752,3,61,190,251
07/05/2021,383,3,71,372,443
07/05/2021,60,3,2,24,26
07/05/2021,924,3,0,1,1
07/05/2021,418,3,18,59,77
07/05/2021,194,3,0,2,2
07/05/2021,130,3,69,249,318
07/05/2021,65,3,29,143,172
07/05/2021,254,3,22,78,100
07/05/2021,224,3,32,101,133
07/05/2021,590,3,1,5,6
07/05/2021,592,3,25,131,156
07/05/2021,515,3,28,179,207
07/05/2021,207,3,18,133,151
07/05/2021,20,3,4,22,26
07/05/2021,419,3,50,311,361
07/05/2021,869,3,96,249,345
07/05/2021,396,3,14,38,52
07/05/2021,347,3,79,227,306
07/05/2021,629,3,18,108,126
07/05/2021,781,3,56,297,353
07/05/2021,789,3,35,85,120
07/05/2021,867,3,17,75,92
07/05/2021,335,3,17,111,128
07/05/2021,779,3,24,69,93
07/05/2021,282,3,24,57,81
07/05/2021,676,3,9,72,81
07/05/2021,346,3,17,56,73
07/05/2021,725,3,24,96,120
07/05/2021,160,3,1,18,19
07/05/2021,363,3,104,278,382
07/05/2021,664,3,54,146,200
07/05/2021,845,3,24,69,93
07/05/2021,483,3,32,121,153
07/05/2021,225,3,41,113,154
07/05/2021,880,3,0,13,13
07/05/2021,208,3,22,113,135
07/05/2021,31,3,18,107,125
07/05/2021,214,3,68,330,398
07/05/2021,618,3,23,71,94
07/05/2021,827,3,92,274,366
07/05/2021,21,3,25,121,146
07/05/2021,874,3,4,11,15
07/05/2021,532,3,94,500,594
07/05/2021,876,3,0,5,5
07/05/2021,44,3,83,244,327
07/05/2021,719,3,15,45,60
07/05/2021,595,3,28,104,132
07/05/2021,577,3,20,132,152
07/05/2021,461,3,12,72,84
07/05/2021,680,3,42,105,147
07/05/2021,260,3,137,489,626
07/05/2021,421,3,82,213,295
07/05/2021,661,3,21,22,43
07/05/2021,578,3,13,57,70
07/05/2021,24,3,10,48,58
07/05/2021,469,3,25,167,192
07/05/2021,694,3,18,64,82
07/05/2021,517,3,13,47,60
07/05/2021,580,3,29,104,133
07/05/2021,425,3,25,146,171
07/05/2021,651,3,32,80,112
07/05/2021,801,3,17,158,175
07/05/2021,847,3,7,21,28
07/05/2021,23,3,9,48,57
07/05/2021,379,3,47,173,220
07/05/2021,849,3,28,147,175
07/05/2021,553,3,19,115,134
07/05/2021,50,3,25,67,92
07/05/2021,573,3,23,89,112
07/05/2021,470,3,30,102,132
07/05/2021,896,3,131,413,544
07/05/2021,819,3,27,143,170
07/05/2021,22,3,35,89,124
07/05/2021,730,3,8,54,62
07/05/2021,471,3,11,72,83
07/05/2021,268,3,50,192,242
07/05/2021,682,3,12,60,72
07/05/2021,546,3,17,90,107
07/05/2021,8,3,23,179,202
07/05/2021,303,3,72,341,413
07/05/2021,761,3,7,41,48
07/05/2021,447,3,35,113,148
07/05/2021,800,3,23,81,104
07/05/2021,615,3,68,110,178
07/05/2021,753,3,39,172,211
07/05/2021,745,3,14,72,86
07/05/2021,700,3,20,182,202
07/05/2021,710,3,11,78,89
07/05/2021,122,3,22,90,112
07/05/2021,89,3,31,118,149
07/05/2021,100,3,66,82,148
07/05/2021,852,3,91,170,261
07/05/2021,278,3,20,42,62
07/05/2021,370,3,23,133,156
07/05/2021,71,3,13,67,80
07/05/2021,171,3,15,39,54
07/05/2021,715,3,55,102,157
07/05/2021,764,3,5,30,35
07/05/2021,509,3,35,211,246
07/05/2021,579,3,11,43,54
07/05/2021,308,3,27,132,159
07/05/2021,58,3,45,337,382
07/05/2021,603,3,58,216,274
07/05/2021,403,3,27,143,170
07/05/2021,218,3,66,330,396
07/05/2021,472,3,36,184,220
07/05/2021,438,3,18,66,84
07/05/2021,322,3,21,62,83
07/05/2021,397,3,15,34,49
07/05/2021,833,3,20,36,56
07/05/2021,312,3,14,58,72
07/05/2021,48,3,22,67,89
07/05/2021,768,3,51,338,389
07/05/2021,249,3,116,553,669
07/05/2021,851,3,8,19,27
07/05/2021,670,3,122,441,563
07/05/2021,853,3,15,51,66
07/05/2021,348,3,15,50,65
07/05/2021,898,3,21,31,52
07/05/2021,557,3,11,78,89
07/05/2021,540,3,41,191,232
07/05/2021,300,3,76,610,686
07/05/2021,782,3,48,200,248
07/05/2021,642,3,22,98,120
07/05/2021,3,3,24,97,121
07/05/2021,518,3,14,49,63
07/05/2021,292,3,87,595,682
07/05/2021,72,3,44,299,343
07/05/2021,139,3,45,203,248
07/05/2021,204,3,50,18,68
07/05/2021,422,3,37,160,197
07/05/2021,202,3,48,194,242
07/05/2021,754,3,28,158,186
07/05/2021,813,3,16,82,98
07/05/2021,622,3,88,280,368
07/05/2021,760,3,16,97,113
07/05/2021,92,3,26,110,136
07/05/2021,464,3,61,279,340
07/05/2021,742,3,28,122,150
07/05/2021,426,3,29,88,117
07/05/2021,772,3,39,99,138
07/05/2021,861,3,63,120,183
07/05/2021,52,3,39,96,135
07/05/2021,222,3,14,73,87
07/05/2021,691,3,30,109,139
07/05/2021,612,3,63,364,427
07/05/2021,310,3,80,286,366
07/05/2021,275,3,46,132,178
07/05/2021,906,3,8,11,19
07/05/2021,227,3,31,110,141
07/05/2021,452,3,33,142,175
07/05/2021,326,3,4,44,48
07/05/2021,127,3,23,133,156
07/05/2021,481,3,32,96,128
07/05/2021,75,3,47,323,370
07/05/2021,564,3,24,114,138
07/05/2021,323,3,16,42,58
07/05/2021,556,3,99,226,325
07/05/2021,384,3,39,113,152
07/05/2021,887,3,1,15,16
07/05/2021,77,3,51,325,376
07/05/2021,215,3,14,63,77
07/05/2021,349,3,18,58,76
07/05/2021,619,3,25,69,94
07/05/2021,633,3,16,68,84
07/05/2021,219,3,17,73,90
07/05/2021,544,3,32,147,179
07/05/2021,674,3,21,100,121
07/05/2021,665,3,22,101,123
07/05/2021,919,3,25,55,80
07/05/2021,35,3,24,131,155
07/05/2021,85,3,53,106,159
07/05/2021,554,3,22,74,96
07/05/2021,372,3,68,218,286
07/05/2021,307,3,37,164,201
07/05/2021,639,3,27,75,102
07/05/2021,627,3,14,47,61
07/05/2021,376,3,8,49,57
07/05/2021,659,3,17,97,114
07/05/2021,197,3,27,100,127
07/05/2021,270,3,9,64,73
07/05/2021,295,3,19,42,61
07/05/2021,548,3,13,50,63
07/05/2021,315,3,16,86,102
07/05/2021,297,3,57,412,469
07/05/2021,649,3,19,75,94
07/05/2021,720,3,14,48,62
07/05/2021,169,3,20,119,139
07/05/2021,747,3,10,70,80
07/05/2021,726,3,15,71,86
07/05/2021,871,3,56,158,214
07/05/2021,600,3,81,361,442
07/05/2021,836,3,42,293,335
07/05/2021,163,3,20,73,93
07/05/2021,252,3,9,55,64
07/05/2021,684,3,32,96,128
07/05/2021,138,3,47,218,265
07/05/2021,266,3,22,81,103
07/05/2021,321,3,14,68,82
07/05/2021,909,3,3,13,16
07/05/2021,417,3,42,285,327
07/05/2021,128,3,25,143,168
07/05/2021,427,3,39,205,244
07/05/2021,936,3,3,7,10
07/05/2021,354,3,6,0,6
07/05/2021,213,3,77,345,422
07/05/2021,875,3,9,47,56
07/05/2021,51,3,55,262,317
07/05/2021,211,3,66,328,394
07/05/2021,226,3,30,126,156
07/05/2021,57,3,28,149,177
07/05/2021,525,3,36,105,141
07/05/2021,657,3,52,188,240
07/05/2021,669,3,32,131,163
07/05/2021,152,3,20,139,159
07/05/2021,4,3,25,113,138
07/05/2021,368,3,25,140,165
07/05/2021,560,3,92,213,305
07/05/2021,67,3,26,111,137
07/05/2021,498,3,18,69,87
07/05/2021,437,3,14,138,152
07/05/2021,806,3,52,292,344
07/05/2021,915,3,0,19,19
07/05/2021,449,3,38,149,187
07/05/2021,722,3,14,47,61
07/05/2021,41,3,21,113,134
07/05/2021,775,3,23,142,165
07/05/2021,793,3,31,125,156
07/05/2021,671,3,44,207,251
07/05/2021,602,3,80,273,353
07/05/2021,26,3,39,104,143
07/05/2021,810,3,12,32,44
07/05/2021,146,3,65,343,408
07/05/2021,148,3,22,116,138
07/05/2021,240,3,93,459,552
07/05/2021,63,3,12,70,82
07/05/2021,345,3,33,84,117
07/05/2021,513,3,24,127,151
07/05/2021,317,3,81,193,274
07/05/2021,576,3,7,33,40
07/05/2021,812,3,18,88,106
07/05/2021,179,3,20,67,87
07/05/2021,358,3,52,252,304
07/05/2021,905,3,2,3,5
07/05/2021,343,3,18,62,80
07/05/2021,641,3,6,19,25
07/05/2021,445,3,15,133,148
07/05/2021,562,3,11,35,46
07/05/2021,494,3,13,81,94
07/05/2021,653,3,8,34,42
07/05/2021,621,3,32,80,112
07/05/2021,156,3,45,140,185
07/05/2021,828,3,46,118,164
07/05/2021,414,3,23,112,135
07/05/2021,741,3,7,43,50
07/05/2021,455,3,5,30,35
07/05/2021,201,3,11,66,77
07/05/2021,135,3,59,239,298
07/05/2021,884,3,12,178,190
07/05/2021,9,3,34,91,125
07/05/2021,129,3,61,240,301
07/05/2021,68,3,30,146,176
07/05/2021,542,3,32,103,135
07/05/2021,933,3,0,5,5
07/05/2021,115,3,11,51,62
07/05/2021,616,3,38,89,127
07/05/2021,756,3,46,239,285
07/05/2021,428,3,20,94,114
07/05/2021,662,3,59,172,231
07/05/2021,344,3,64,101,165
07/05/2021,731,3,9,58,67
07/05/2021,685,3,22,112,134
07/05/2021,369,3,70,203,273
07/05/2021,487,3,23,84,107
07/05/2021,511,3,11,117,128
07/05/2021,634,3,22,73,95
07/05/2021,440,3,19,108,127
07/05/2021,748,3,11,78,89
07/05/2021,263,3,50,190,240
07/05/2021,624,3,7,35,42
07/05/2021,233,3,20,88,108
07/05/2021,381,3,1,8,9
07/05/2021,703,3,13,51,64
07/05/2021,841,3,24,225,249
07/05/2021,216,3,22,84,106
07/05/2021,86,3,12,96,108
07/05/2021,583,3,32,138,170
07/05/2021,533,3,15,75,90
07/05/2021,737,3,5,53,58
07/05/2021,572,3,15,86,101
07/05/2021,631,3,1,23,24
07/05/2021,246,3,101,503,604
07/05/2021,374,3,13,62,75
07/05/2021,91,3,31,100,131
07/05/2021,205,3,64,96,160
07/05/2021,87,3,41,171,212
07/05/2021,625,3,26,81,107
07/05/2021,435,3,15,50,65
07/05/2021,749,3,7,17,24
07/05/2021,328,3,24,73,97
07/05/2021,910,3,11,178,189
07/05/2021,359,3,20,77,97
07/05/2021,288,3,21,50,71
07/05/2021,495,3,17,67,84
07/05/2021,454,3,10,39,49
07/05/2021,82,3,28,144,172
07/05/2021,261,3,142,486,628
07/05/2021,892,3,6,46,52
07/05/2021,843,3,16,62,78
07/05/2021,442,3,24,128,152
07/05/2021,145,3,34,134,168
07/05/2021,608,3,67,413,480
07/05/2021,448,3,85,459,544
07/05/2021,200,3,15,110,125
07/05/2021,591,3,14,61,75
07/05/2021,904,3,54,320,374
07/05/2021,677,3,9,59,68
07/05/2021,231,3,36,104,140
07/05/2021,792,3,63,63,126
07/05/2021,922,3,0,8,8
07/05/2021,507,3,50,276,326
07/05/2021,809,3,17,52,69
07/05/2021,133,3,24,69,93
07/05/2021,687,3,34,101,135
07/05/2021,581,3,31,85,116
07/05/2021,46,3,15,48,63
07/05/2021,652,3,10,27,37
07/05/2021,25,3,37,100,137
07/05/2021,119,3,48,206,254
07/05/2021,555,3,89,202,291
07/05/2021,444,3,16,107,123
07/05/2021,353,3,13,29,42
07/05/2021,245,3,105,519,624
07/05/2021,491,3,43,250,293
07/05/2021,296,3,26,76,102
07/05/2021,790,3,31,215,246
07/05/2021,401,3,9,51,60
07/05/2021,920,3,1,0,1
07/05/2021,450,3,14,112,126
07/05/2021,522,3,29,184,213
07/05/2021,281,3,38,100,138
07/05/2021,446,3,21,108,129
07/05/2021,239,3,57,306,363
07/05/2021,666,3,26,139,165
07/05/2021,882,3,0,16,16
07/05/2021,66,3,13,34,47
07/05/2021,267,3,24,77,101
07/05/2021,784,3,83,268,351
07/05/2021,707,3,68,112,180
07/05/2021,182,3,19,71,90
07/05/2021,416,3,10,48,58
07/05/2021,142,3,13,39,52
07/05/2021,209,3,25,115,140
07/05/2021,167,3,24,132,156
07/05/2021,173,3,10,47,57
07/05/2021,496,3,10,57,67
07/05/2021,527,3,18,54,72
07/05/2021,467,3,6,25,31
07/05/2021,739,3,7,41,48
07/05/2021,394,3,15,52,67
07/05/2021,529,3,17,71,88
07/05/2021,433,3,81,419,500
07/05/2021,12,3,11,44,55
07/05/2021,390,3,37,203,240
07/05/2021,862,3,35,136,171
07/05/2021,816,3,64,265,329
07/05/2021,881,3,2,13,15
07/05/2021,330,3,13,125,138
07/05/2021,807,3,14,49,63
07/05/2021,78,3,79,365,444
07/05/2021,210,3,35,170,205
07/05/2021,304,3,45,173,218
07/05/2021,338,3,32,128,160
07/05/2021,411,3,48,332,380
07/05/2021,902,3,13,71,84
07/05/2021,493,3,22,88,110
07/05/2021,117,3,99,213,312
07/05/2021,212,3,75,353,428
07/05/2021,743,3,5,47,52
07/05/2021,102,3,95,283,378
07/05/2021,412,3,23,169,192
07/05/2021,39,3,25,141,166
07/05/2021,341,3,100,308,408
07/05/2021,706,3,71,116,187
07/05/2021,510,3,10,49,59
07/05/2021,199,3,9,50,59
07/05/2021,126,3,71,126,197
07/05/2021,543,3,114,365,479
07/05/2021,134,3,58,225,283
07/05/2021,582,3,74,464,538
07/05/2021,45,3,23,87,110
07/05/2021,930,3,0,10,10
07/05/2021,860,3,32,95,127
07/05/2021,33,3,43,188,231
07/05/2021,623,3,23,106,129
07/05/2021,177,3,18,60,78
07/05/2021,480,3,13,53,66
07/05/2021,366,3,24,32,56
07/05/2021,854,3,60,279,339
07/05/2021,429,3,19,138,157
07/05/2021,274,3,1,20,21
07/05/2021,232,3,30,123,153
07/05/2021,392,3,18,55,73
07/05/2021,588,3,13,65,78
07/05/2021,120,3,19,81,100
07/05/2021,250,3,83,211,294
07/05/2021,885,3,17,163,180
07/05/2021,108,3,14,65,79
07/05/2021,767,3,81,384,465
07/05/2021,938,3,0,1,1
07/05/2021,539,3,32,160,192
07/05/2021,284,3,12,40,52
07/05/2021,49,3,23,62,85
07/05/2021,6,3,21,102,123
07/05/2021,118,3,47,194,241
07/05/2021,734,3,4,68,72
07/05/2021,787,3,105,403,508
07/05/2021,521,3,11,41,52
07/05/2021,234,3,16,62,78
07/05/2021,923,3,1,1,2
07/05/2021,258,3,108,449,557
07/05/2021,873,3,35,90,125
07/05/2021,799,3,11,15,26
07/05/2021,925,3,0,1,1
07/05/2021,230,3,22,94,116
07/05/2021,364,3,100,252,352
07/05/2021,325,3,15,82,97
07/05/2021,107,3,116,369,485
07/05/2021,407,3,36,238,274
07/05/2021,290,3,74,535,609
07/05/2021,476,3,16,92,108
07/05/2021,821,3,44,118,162
07/05/2021,38,3,24,140,164
07/05/2021,679,3,46,140,186
07/05/2021,174,3,17,52,69
07/05/2021,559,3,96,221,317
07/05/2021,357,3,46,230,276
07/05/2021,916,3,0,1,1
07/05/2021,668,3,2,17,19
07/05/2021,530,3,23,71,94
07/05/2021,316,3,8,94,102
07/05/2021,5,3,20,97,117
07/05/2021,693,3,12,84,96
07/05/2021,302,3,65,510,575
07/05/2021,387,3,40,91,131
07/05/2021,727,3,25,110,135
07/05/2021,536,3,29,110,139
07/05/2021,914,3,1,2,3
07/05/2021,367,3,25,143,168
07/05/2021,908,3,1,6,7
07/05/2021,926,3,2,5,7
07/05/2021,872,3,34,80,114
07/05/2021,430,3,24,111,135
07/05/2021,538,3,24,104,128
07/05/2021,563,3,14,87,101
07/05/2021,373,3,13,78,91
07/05/2021,758,3,69,125,194
07/05/2021,839,3,26,112,138
07/05/2021,113,3,10,57,67
07/05/2021,569,3,22,107,129
07/05/2021,551,3,44,213,257
07/05/2021,575,3,13,27,40
07/05/2021,137,3,48,225,273
07/05/2021,650,3,32,118,150
07/05/2021,857,3,45,195,240
07/05/2021,432,3,11,41,52
07/05/2021,76,3,42,303,345
07/05/2021,143,3,56,276,332
07/05/2021,805,3,29,75,104
07/05/2021,385,3,28,107,135
07/05/2021,206,3,2,7,9
07/05/2021,699,3,24,85,109
07/05/2021,220,3,13,81,94
07/05/2021,294,3,60,121,181
07/05/2021,285,3,20,77,97
07/05/2021,626,3,19,73,92
07/05/2021,750,3,40,199,239
07/05/2021,84,3,65,221,286
07/05/2021,180,3,34,84,118
07/05/2021,886,3,2,11,13
07/05/2021,34,3,17,62,79
08/05/2021,180,3,26,84,110
08/05/2021,626,3,23,98,121
08/05/2021,294,3,45,141,186
08/05/2021,857,3,56,249,305
08/05/2021,886,3,2,14,16
08/05/2021,699,3,27,120,147
08/05/2021,206,3,3,6,9
08/05/2021,84,3,85,328,413
08/05/2021,34,3,22,88,110
08/05/2021,143,3,54,346,400
08/05/2021,76,3,64,385,449
08/05/2021,285,3,24,113,137
08/05/2021,385,3,26,133,159
08/05/2021,432,3,12,62,74
08/05/2021,805,3,30,96,126
08/05/2021,220,3,16,104,120
08/05/2021,750,3,24,264,288
08/05/2021,801,3,29,192,221
08/05/2021,819,3,46,213,259
08/05/2021,50,3,24,97,121
08/05/2021,470,3,27,116,143
08/05/2021,379,3,46,222,268
08/05/2021,847,3,7,31,38
08/05/2021,573,3,27,151,178
08/05/2021,553,3,36,173,209
08/05/2021,23,3,18,60,78
08/05/2021,849,3,21,207,228
08/05/2021,896,3,128,420,548
08/05/2021,794,3,86,362,448
08/05/2021,164,3,17,165,182
08/05/2021,561,3,8,58,66
08/05/2021,168,3,22,88,110
08/05/2021,673,3,16,122,138
08/05/2021,713,3,56,872,928
08/05/2021,27,3,123,367,490
08/05/2021,770,3,91,454,545
08/05/2021,229,3,69,221,290
08/05/2021,721,3,115,645,760
08/05/2021,149,3,26,168,194
08/05/2021,456,3,10,19,29
08/05/2021,811,3,20,96,116
08/05/2021,90,3,15,125,140
08/05/2021,547,3,117,393,510
08/05/2021,736,3,6,36,42
08/05/2021,746,3,17,90,107
08/05/2021,524,3,36,118,154
08/05/2021,587,3,8,35,43
08/05/2021,567,3,31,182,213
08/05/2021,159,3,35,213,248
08/05/2021,255,3,5,15,20
08/05/2021,420,3,114,361,475
08/05/2021,131,3,56,259,315
08/05/2021,243,3,109,681,790
08/05/2021,526,3,22,40,62
08/05/2021,151,3,13,75,88
08/05/2021,689,3,46,151,197
08/05/2021,778,3,69,262,331
08/05/2021,190,3,24,84,108
08/05/2021,365,3,29,139,168
08/05/2021,817,3,30,104,134
08/05/2021,271,3,20,60,80
08/05/2021,184,3,30,94,124
08/05/2021,593,3,67,404,471
08/05/2021,342,3,14,77,91
08/05/2021,259,3,91,507,598
08/05/2021,97,3,86,267,353
08/05/2021,188,3,29,93,122
08/05/2021,340,3,11,23,34
08/05/2021,656,3,15,82,97
08/05/2021,733,3,5,99,104
08/05/2021,636,3,28,92,120
08/05/2021,601,3,22,249,271
08/05/2021,697,3,25,253,278
08/05/2021,859,3,9,24,33
08/05/2021,894,3,51,130,181
08/05/2021,80,3,15,38,53
08/05/2021,355,3,12,54,66
08/05/2021,501,3,17,70,87
08/05/2021,870,3,4,38,42
08/05/2021,499,3,32,247,279
08/05/2021,610,3,73,440,513
08/05/2021,829,3,35,152,187
08/05/2021,711,3,16,110,126
08/05/2021,614,3,18,82,100
08/05/2021,409,3,24,62,86
08/05/2021,638,3,29,125,154
08/05/2021,717,3,23,106,129
08/05/2021,11,3,28,84,112
08/05/2021,424,3,73,979,1052
08/05/2021,70,3,59,391,450
08/05/2021,705,3,3,26,29
08/05/2021,866,3,39,231,270
08/05/2021,170,3,25,207,232
08/05/2021,780,3,97,446,543
08/05/2021,319,3,14,37,51
08/05/2021,891,3,28,79,107
08/05/2021,459,3,34,123,157
08/05/2021,299,3,32,137,169
08/05/2021,550,3,59,256,315
08/05/2021,814,3,21,72,93
08/05/2021,808,3,103,340,443
08/05/2021,844,3,2,18,20
08/05/2021,329,3,62,346,408
08/05/2021,724,3,108,344,452
08/05/2021,698,3,26,257,283
08/05/2021,301,3,89,648,737
08/05/2021,913,3,1,0,1
08/05/2021,337,3,11,44,55
08/05/2021,181,3,11,84,95
08/05/2021,508,3,54,331,385
08/05/2021,911,3,31,246,277
08/05/2021,55,3,10,64,74
08/05/2021,98,3,65,322,387
08/05/2021,716,3,20,95,115
08/05/2021,313,3,18,62,80
08/05/2021,856,3,27,48,75
08/05/2021,172,3,23,203,226
08/05/2021,466,3,28,124,152
08/05/2021,520,3,17,99,116
08/05/2021,460,3,27,131,158
08/05/2021,64,3,2,19,21
08/05/2021,99,3,108,435,543
08/05/2021,890,3,12,85,97
08/05/2021,738,3,38,153,191
08/05/2021,485,3,30,116,146
08/05/2021,815,3,105,464,569
08/05/2021,868,3,74,292,366
08/05/2021,334,3,77,286,363
08/05/2021,101,3,42,345,387
08/05/2021,19,3,78,204,282
08/05/2021,723,3,44,141,185
08/05/2021,88,3,24,80,104
08/05/2021,803,3,44,166,210
08/05/2021,157,3,46,174,220
08/05/2021,166,3,12,142,154
08/05/2021,646,3,32,202,234
08/05/2021,298,3,107,733,840
08/05/2021,123,3,25,60,85
08/05/2021,497,3,54,383,437
08/05/2021,798,3,78,212,290
08/05/2021,125,3,30,105,135
08/05/2021,774,3,30,72,102
08/05/2021,585,3,74,220,294
08/05/2021,7,3,20,127,147
08/05/2021,196,3,6,19,25
08/05/2021,105,3,64,176,240
08/05/2021,236,3,7,38,45
08/05/2021,759,3,10,80,90
08/05/2021,488,3,26,101,127
08/05/2021,221,3,18,92,110
08/05/2021,879,3,0,16,16
08/05/2021,765,3,47,161,208
08/05/2021,18,3,22,135,157
08/05/2021,704,3,9,43,52
08/05/2021,242,3,107,657,764
08/05/2021,154,3,32,160,192
08/05/2021,826,3,40,251,291
08/05/2021,751,3,4,14,18
08/05/2021,47,3,28,81,109
08/05/2021,571,3,10,13,23
08/05/2021,287,3,109,741,850
08/05/2021,361,3,105,252,357
08/05/2021,17,3,14,69,83
08/05/2021,153,3,30,167,197
08/05/2021,888,3,6,22,28
08/05/2021,413,3,52,410,462
08/05/2021,589,3,12,77,89
08/05/2021,198,3,27,134,161
08/05/2021,332,3,16,104,120
08/05/2021,648,3,21,121,142
08/05/2021,776,3,25,203,228
08/05/2021,864,3,21,109,130
08/05/2021,607,3,86,496,582
08/05/2021,42,3,28,109,137
08/05/2021,147,3,14,168,182
08/05/2021,883,3,10,172,182
08/05/2021,702,3,19,78,97
08/05/2021,69,3,24,115,139
08/05/2021,613,3,10,53,63
08/05/2021,477,3,12,71,83
08/05/2021,537,3,68,204,272
08/05/2021,175,3,28,107,135
08/05/2021,903,3,2,1,3
08/05/2021,93,3,33,201,234
08/05/2021,492,3,10,55,65
08/05/2021,504,3,14,66,80
08/05/2021,558,3,8,60,68
08/05/2021,858,3,82,263,345
08/05/2021,378,3,13,81,94
08/05/2021,406,3,65,239,304
08/05/2021,398,3,11,20,31
08/05/2021,795,3,33,149,182
08/05/2021,586,3,75,486,561
08/05/2021,889,3,1,6,7
08/05/2021,399,3,75,274,349
08/05/2021,350,3,14,72,86
08/05/2021,597,3,5,57,62
08/05/2021,654,3,32,251,283
08/05/2021,247,3,80,456,536
08/05/2021,474,3,23,97,120
08/05/2021,393,3,17,57,74
08/05/2021,251,3,12,97,109
08/05/2021,512,3,14,69,83
08/05/2021,825,3,46,158,204
08/05/2021,253,3,10,64,74
08/05/2021,56,3,28,241,269
08/05/2021,436,3,20,128,148
08/05/2021,683,3,24,165,189
08/05/2021,15,3,64,246,310
08/05/2021,269,3,24,47,71
08/05/2021,186,3,29,82,111
08/05/2021,462,3,4,35,39
08/05/2021,162,3,88,290,378
08/05/2021,192,3,11,116,127
08/05/2021,59,3,20,202,222
08/05/2021,161,3,90,295,385
08/05/2021,802,3,57,315,372
08/05/2021,37,3,35,97,132
08/05/2021,195,3,13,80,93
08/05/2021,443,3,36,205,241
08/05/2021,95,3,46,249,295
08/05/2021,473,3,25,115,140
08/05/2021,309,3,18,35,53
08/05/2021,244,3,43,251,294
08/05/2021,400,3,5,50,55
08/05/2021,570,3,20,159,179
08/05/2021,785,3,95,550,645
08/05/2021,276,3,28,95,123
08/05/2021,286,3,22,107,129
08/05/2021,189,3,19,97,116
08/05/2021,187,3,27,105,132
08/05/2021,777,3,29,117,146
08/05/2021,380,3,30,100,130
08/05/2021,28,3,18,57,75
08/05/2021,423,3,70,941,1011
08/05/2021,895,3,33,111,144
08/05/2021,305,3,22,167,189
08/05/2021,238,3,100,596,696
08/05/2021,897,3,7,9,16
08/05/2021,696,3,31,138,169
08/05/2021,489,3,1,34,35
08/05/2021,628,3,32,91,123
08/05/2021,528,3,20,39,59
08/05/2021,786,3,47,262,309
08/05/2021,306,3,0,1,1
08/05/2021,279,3,35,110,145
08/05/2021,178,3,33,133,166
08/05/2021,478,3,20,20,40
08/05/2021,788,3,55,157,212
08/05/2021,565,3,95,285,380
08/05/2021,458,3,25,140,165
08/05/2021,155,3,42,299,341
08/05/2021,735,3,8,43,51
08/05/2021,54,3,16,58,74
08/05/2021,237,3,89,529,618
08/05/2021,318,3,46,221,267
08/05/2021,61,3,18,190,208
08/05/2021,850,3,91,318,409
08/05/2021,144,3,16,177,193
08/05/2021,842,3,15,11,26
08/05/2021,185,3,28,111,139
08/05/2021,124,3,23,42,65
08/05/2021,30,3,43,107,150
08/05/2021,289,3,34,170,204
08/05/2021,604,3,71,285,356
08/05/2021,260,3,111,584,695
08/05/2021,421,3,83,187,270
08/05/2021,694,3,17,80,97
08/05/2021,24,3,19,57,76
08/05/2021,517,3,15,56,71
08/05/2021,661,3,15,24,39
08/05/2021,651,3,28,122,150
08/05/2021,469,3,25,221,246
08/05/2021,680,3,41,123,164
08/05/2021,580,3,24,150,174
08/05/2021,425,3,28,224,252
08/05/2021,461,3,22,98,120
08/05/2021,578,3,14,87,101
08/05/2021,103,3,99,285,384
08/05/2021,121,3,106,336,442
08/05/2021,176,3,35,131,166
08/05/2021,314,3,15,54,69
08/05/2021,434,3,11,38,49
08/05/2021,277,3,46,214,260
08/05/2021,505,3,20,218,238
08/05/2021,835,3,31,207,238
08/05/2021,831,3,27,107,134
08/05/2021,837,3,84,451,535
08/05/2021,709,3,44,147,191
08/05/2021,257,3,87,468,555
08/05/2021,855,3,41,168,209
08/05/2021,389,3,42,260,302
08/05/2021,32,3,31,104,135
08/05/2021,728,3,33,195,228
08/05/2021,404,3,50,245,295
08/05/2021,110,3,8,87,95
08/05/2021,647,3,14,83,97
08/05/2021,382,3,0,6,6
08/05/2021,506,3,18,69,87
08/05/2021,136,3,57,223,280
08/05/2021,574,3,24,153,177
08/05/2021,598,3,101,500,601
08/05/2021,838,3,37,118,155
08/05/2021,584,3,60,401,461
08/05/2021,362,3,110,254,364
08/05/2021,714,3,35,147,182
08/05/2021,431,3,32,129,161
08/05/2021,352,3,38,160,198
08/05/2021,439,3,26,135,161
08/05/2021,686,3,24,134,158
08/05/2021,832,3,30,114,144
08/05/2021,484,3,29,113,142
08/05/2021,823,3,33,140,173
08/05/2021,878,3,0,7,7
08/05/2021,111,3,72,263,335
08/05/2021,660,3,14,80,94
08/05/2021,265,3,32,99,131
08/05/2021,371,3,19,110,129
08/05/2021,1,3,19,117,136
08/05/2021,514,3,16,68,84
08/05/2021,701,3,16,67,83
08/05/2021,391,3,44,248,292
08/05/2021,663,3,31,120,151
08/05/2021,140,3,5,72,77
08/05/2021,463,3,95,414,509
08/05/2021,635,3,29,191,220
08/05/2021,877,3,1,20,21
08/05/2021,840,3,19,192,211
08/05/2021,655,3,60,184,244
08/05/2021,453,3,32,154,186
08/05/2021,692,3,19,48,67
08/05/2021,457,3,21,98,119
08/05/2021,804,3,94,544,638
08/05/2021,402,3,43,206,249
08/05/2021,899,3,66,292,358
08/05/2021,535,3,13,116,129
08/05/2021,104,3,63,230,293
08/05/2021,479,3,16,53,69
08/05/2021,112,3,11,49,60
08/05/2021,264,3,35,83,118
08/05/2021,248,3,29,174,203
08/05/2021,408,3,28,111,139
08/05/2021,901,3,0,4,4
08/05/2021,688,3,13,120,133
08/05/2021,272,3,67,158,225
08/05/2021,934,3,0,10,10
08/05/2021,83,3,118,496,614
08/05/2021,451,3,123,601,724
08/05/2021,183,3,17,80,97
08/05/2021,755,3,47,267,314
08/05/2021,932,3,2,5,7
08/05/2021,848,3,54,252,306
08/05/2021,519,3,65,152,217
08/05/2021,193,3,27,186,213
08/05/2021,475,3,72,225,297
08/05/2021,594,3,39,228,267
08/05/2021,617,3,16,70,86
08/05/2021,106,3,53,303,356
08/05/2021,865,3,22,92,114
08/05/2021,228,3,37,127,164
08/05/2021,917,3,6,18,24
08/05/2021,262,3,29,86,115
08/05/2021,599,3,108,493,601
08/05/2021,395,3,20,72,92
08/05/2021,640,3,27,142,169
08/05/2021,605,3,73,315,388
08/05/2021,283,3,27,138,165
08/05/2021,336,3,97,311,408
08/05/2021,273,3,54,310,364
08/05/2021,377,3,23,99,122
08/05/2021,468,3,23,162,185
08/05/2021,36,3,25,156,181
08/05/2021,13,3,15,65,80
08/05/2021,503,3,18,55,73
08/05/2021,405,3,23,93,116
08/05/2021,595,3,28,126,154
08/05/2021,532,3,105,604,709
08/05/2021,719,3,16,44,60
08/05/2021,874,3,5,9,14
08/05/2021,876,3,0,5,5
08/05/2021,577,3,16,212,228
08/05/2021,44,3,87,273,360
08/05/2021,773,3,26,71,97
08/05/2021,552,3,61,281,342
08/05/2021,331,3,26,99,125
08/05/2021,351,3,61,298,359
08/05/2021,645,3,25,186,211
08/05/2021,771,3,31,321,352
08/05/2021,116,3,25,118,143
08/05/2021,291,3,79,640,719
08/05/2021,606,3,39,219,258
08/05/2021,81,3,14,40,54
08/05/2021,388,3,40,251,291
08/05/2021,333,3,60,805,865
08/05/2021,824,3,35,103,138
08/05/2021,465,3,21,143,164
08/05/2021,293,3,65,510,575
08/05/2021,907,3,73,234,307
08/05/2021,356,3,56,251,307
08/05/2021,79,3,31,141,172
08/05/2021,280,3,14,45,59
08/05/2021,846,3,7,36,43
08/05/2021,637,3,64,296,360
08/05/2021,566,3,9,65,74
08/05/2021,712,3,16,105,121
08/05/2021,217,3,60,414,474
08/05/2021,43,3,19,195,214
08/05/2021,797,3,44,121,165
08/05/2021,311,3,35,182,217
08/05/2021,500,3,12,47,59
08/05/2021,114,3,43,134,177
08/05/2021,783,3,53,274,327
08/05/2021,360,3,28,166,194
08/05/2021,441,3,37,117,154
08/05/2021,531,3,17,167,184
08/05/2021,643,3,28,159,187
08/05/2021,339,3,6,11,17
08/05/2021,158,3,22,114,136
08/05/2021,486,3,32,124,156
08/05/2021,386,3,75,470,545
08/05/2021,490,3,3,35,38
08/05/2021,53,3,35,93,128
08/05/2021,820,3,22,98,120
08/05/2021,921,3,0,11,11
08/05/2021,732,3,7,101,108
08/05/2021,2,3,19,123,142
08/05/2021,256,3,39,125,164
08/05/2021,96,3,19,221,240
08/05/2021,791,3,31,183,214
08/05/2021,203,3,62,121,183
08/05/2021,818,3,69,285,354
08/05/2021,327,3,62,345,407
08/05/2021,410,3,42,377,419
08/05/2021,757,3,68,181,249
08/05/2021,830,3,111,371,482
08/05/2021,363,3,118,267,385
08/05/2021,214,3,63,422,485
08/05/2021,346,3,12,65,77
08/05/2021,827,3,101,328,429
08/05/2021,225,3,40,135,175
08/05/2021,664,3,51,175,226
08/05/2021,483,3,34,150,184
08/05/2021,725,3,24,90,114
08/05/2021,845,3,19,82,101
08/05/2021,160,3,4,23,27
08/05/2021,880,3,0,11,11
08/05/2021,21,3,30,183,213
08/05/2021,208,3,27,151,178
08/05/2021,618,3,26,86,112
08/05/2021,31,3,22,150,172
08/05/2021,534,3,27,160,187
08/05/2021,632,3,4,27,31
08/05/2021,863,3,18,57,75
08/05/2021,235,3,19,185,204
08/05/2021,658,3,15,141,156
08/05/2021,675,3,12,81,93
08/05/2021,60,3,4,24,28
08/05/2021,383,3,94,461,555
08/05/2021,918,3,0,4,4
08/05/2021,194,3,0,4,4
08/05/2021,752,3,43,241,284
08/05/2021,418,3,22,66,88
08/05/2021,900,3,0,8,8
08/05/2021,681,3,25,120,145
08/05/2021,924,3,0,1,1
08/05/2021,629,3,22,147,169
08/05/2021,254,3,18,78,96
08/05/2021,781,3,55,431,486
08/05/2021,789,3,31,120,151
08/05/2021,779,3,24,75,99
08/05/2021,347,3,102,305,407
08/05/2021,335,3,15,123,138
08/05/2021,867,3,19,102,121
08/05/2021,65,3,19,209,228
08/05/2021,592,3,29,175,204
08/05/2021,20,3,9,37,46
08/05/2021,130,3,68,259,327
08/05/2021,396,3,19,48,67
08/05/2021,207,3,24,171,195
08/05/2021,676,3,10,76,86
08/05/2021,869,3,104,255,359
08/05/2021,419,3,83,427,510
08/05/2021,515,3,27,273,300
08/05/2021,224,3,38,133,171
08/05/2021,282,3,19,65,84
08/05/2021,590,3,0,3,3
08/05/2021,373,3,12,91,103
08/05/2021,538,3,22,115,137
08/05/2021,839,3,25,127,152
08/05/2021,430,3,32,139,171
08/05/2021,113,3,9,70,79
08/05/2021,872,3,38,111,149
08/05/2021,650,3,32,121,153
08/05/2021,575,3,11,42,53
08/05/2021,551,3,68,303,371
08/05/2021,137,3,54,272,326
08/05/2021,563,3,21,84,105
08/05/2021,758,3,72,188,260
08/05/2021,569,3,26,171,197
08/05/2021,756,3,52,312,364
08/05/2021,68,3,21,216,237
08/05/2021,662,3,71,208,279
08/05/2021,135,3,58,227,285
08/05/2021,344,3,64,145,209
08/05/2021,9,3,21,140,161
08/05/2021,129,3,67,311,378
08/05/2021,115,3,10,72,82
08/05/2021,884,3,11,183,194
08/05/2021,616,3,26,133,159
08/05/2021,428,3,26,113,139
08/05/2021,542,3,44,136,180
08/05/2021,933,3,0,4,4
08/05/2021,384,3,36,144,180
08/05/2021,219,3,13,70,83
08/05/2021,556,3,99,288,387
08/05/2021,619,3,27,109,136
08/05/2021,887,3,0,16,16
08/05/2021,564,3,36,144,180
08/05/2021,77,3,70,398,468
08/05/2021,215,3,13,67,80
08/05/2021,349,3,17,59,76
08/05/2021,544,3,48,227,275
08/05/2021,323,3,12,62,74
08/05/2021,633,3,10,80,90
08/05/2021,75,3,64,416,480
08/05/2021,322,3,18,86,104
08/05/2021,218,3,62,434,496
08/05/2021,472,3,53,198,251
08/05/2021,403,3,43,211,254
08/05/2021,308,3,19,158,177
08/05/2021,579,3,16,68,84
08/05/2021,764,3,10,33,43
08/05/2021,509,3,39,316,355
08/05/2021,603,3,57,260,317
08/05/2021,58,3,44,443,487
08/05/2021,715,3,62,157,219
08/05/2021,438,3,22,112,134
08/05/2021,761,3,15,44,59
08/05/2021,22,3,27,125,152
08/05/2021,682,3,14,83,97
08/05/2021,303,3,64,447,511
08/05/2021,730,3,12,80,92
08/05/2021,447,3,28,158,186
08/05/2021,800,3,25,107,132
08/05/2021,268,3,48,230,278
08/05/2021,546,3,40,143,183
08/05/2021,8,3,29,261,290
08/05/2021,471,3,19,99,118
08/05/2021,278,3,16,46,62
08/05/2021,122,3,36,118,154
08/05/2021,700,3,23,256,279
08/05/2021,100,3,54,78,132
08/05/2021,615,3,66,158,224
08/05/2021,745,3,12,89,101
08/05/2021,71,3,16,88,104
08/05/2021,370,3,30,220,250
08/05/2021,171,3,12,47,59
08/05/2021,710,3,7,97,104
08/05/2021,89,3,33,172,205
08/05/2021,753,3,30,229,259
08/05/2021,852,3,94,230,324
08/05/2021,481,3,34,126,160
08/05/2021,310,3,74,418,492
08/05/2021,772,3,35,153,188
08/05/2021,127,3,23,153,176
08/05/2021,275,3,46,162,208
08/05/2021,906,3,8,8,16
08/05/2021,742,3,29,152,181
08/05/2021,452,3,35,177,212
08/05/2021,222,3,14,94,108
08/05/2021,612,3,81,467,548
08/05/2021,426,3,25,114,139
08/05/2021,691,3,19,130,149
08/05/2021,861,3,59,115,174
08/05/2021,227,3,37,148,185
08/05/2021,326,3,9,42,51
08/05/2021,52,3,30,150,180
08/05/2021,670,3,117,475,592
08/05/2021,397,3,20,51,71
08/05/2021,300,3,93,765,858
08/05/2021,249,3,122,725,847
08/05/2021,898,3,20,30,50
08/05/2021,833,3,17,43,60
08/05/2021,557,3,15,84,99
08/05/2021,312,3,15,84,99
08/05/2021,768,3,50,471,521
08/05/2021,853,3,18,54,72
08/05/2021,540,3,65,273,338
08/05/2021,48,3,23,101,124
08/05/2021,851,3,11,21,32
08/05/2021,348,3,16,54,70
08/05/2021,72,3,61,390,451
08/05/2021,139,3,53,264,317
08/05/2021,3,3,20,119,139
08/05/2021,622,3,102,375,477
08/05/2021,642,3,29,139,168
08/05/2021,518,3,11,69,80
08/05/2021,782,3,47,235,282
08/05/2021,422,3,45,244,289
08/05/2021,760,3,29,125,154
08/05/2021,92,3,29,142,171
08/05/2021,204,3,49,23,72
08/05/2021,202,3,47,241,288
08/05/2021,754,3,21,223,244
08/05/2021,813,3,23,70,93
08/05/2021,464,3,80,408,488
08/05/2021,292,3,105,753,858
08/05/2021,905,3,2,4,6
08/05/2021,455,3,6,41,47
08/05/2021,414,3,28,117,145
08/05/2021,445,3,22,196,218
08/05/2021,358,3,71,340,411
08/05/2021,156,3,50,160,210
08/05/2021,179,3,17,79,96
08/05/2021,562,3,6,41,47
08/05/2021,828,3,31,167,198
08/05/2021,621,3,27,80,107
08/05/2021,494,3,16,144,160
08/05/2021,653,3,5,59,64
08/05/2021,741,3,10,47,57
08/05/2021,343,3,14,70,84
08/05/2021,641,3,9,19,28
08/05/2021,201,3,10,69,79
08/05/2021,163,3,19,92,111
08/05/2021,909,3,3,11,14
08/05/2021,875,3,9,68,77
08/05/2021,51,3,74,349,423
08/05/2021,354,3,5,3,8
08/05/2021,321,3,14,87,101
08/05/2021,213,3,75,453,528
08/05/2021,128,3,21,159,180
08/05/2021,427,3,55,234,289
08/05/2021,138,3,59,264,323
08/05/2021,936,3,0,16,16
08/05/2021,836,3,48,432,480
08/05/2021,600,3,109,501,610
08/05/2021,252,3,16,85,101
08/05/2021,684,3,30,101,131
08/05/2021,266,3,25,71,96
08/05/2021,417,3,53,430,483
08/05/2021,659,3,14,135,149
08/05/2021,372,3,84,245,329
08/05/2021,295,3,16,44,60
08/05/2021,35,3,26,174,200
08/05/2021,639,3,27,108,135
08/05/2021,919,3,17,117,134
08/05/2021,554,3,24,139,163
08/05/2021,376,3,18,60,78
08/05/2021,627,3,22,70,92
08/05/2021,197,3,21,159,180
08/05/2021,665,3,17,143,160
08/05/2021,307,3,28,195,223
08/05/2021,85,3,58,105,163
08/05/2021,270,3,10,92,102
08/05/2021,674,3,13,131,144
08/05/2021,720,3,16,52,68
08/05/2021,548,3,13,72,85
08/05/2021,649,3,22,83,105
08/05/2021,726,3,20,70,90
08/05/2021,871,3,65,196,261
08/05/2021,169,3,22,200,222
08/05/2021,315,3,10,91,101
08/05/2021,747,3,11,93,104
08/05/2021,297,3,76,575,651
08/05/2021,345,3,38,113,151
08/05/2021,63,3,12,98,110
08/05/2021,148,3,26,166,192
08/05/2021,317,3,81,241,322
08/05/2021,146,3,76,451,527
08/05/2021,513,3,21,209,230
08/05/2021,26,3,37,140,177
08/05/2021,240,3,102,613,715
08/05/2021,810,3,13,44,57
08/05/2021,576,3,5,49,54
08/05/2021,812,3,18,106,124
08/05/2021,211,3,62,422,484
08/05/2021,806,3,54,435,489
08/05/2021,669,3,23,165,188
08/05/2021,57,3,17,223,240
08/05/2021,560,3,88,268,356
08/05/2021,437,3,20,181,201
08/05/2021,657,3,52,229,281
08/05/2021,226,3,36,120,156
08/05/2021,4,3,36,150,186
08/05/2021,368,3,32,208,240
08/05/2021,915,3,0,15,15
08/05/2021,525,3,33,121,154
08/05/2021,67,3,17,175,192
08/05/2021,498,3,13,77,90
08/05/2021,152,3,17,173,190
08/05/2021,671,3,38,291,329
08/05/2021,449,3,42,202,244
08/05/2021,602,3,80,329,409
08/05/2021,793,3,32,133,165
08/05/2021,928,3,0,1,1
08/05/2021,775,3,23,172,195
08/05/2021,41,3,18,158,176
08/05/2021,722,3,10,54,64
08/05/2021,914,3,2,2,4
08/05/2021,926,3,1,13,14
08/05/2021,387,3,39,149,188
08/05/2021,908,3,0,9,9
08/05/2021,693,3,14,108,122
08/05/2021,302,3,76,630,706
08/05/2021,367,3,32,230,262
08/05/2021,536,3,33,129,162
08/05/2021,727,3,18,135,153
08/05/2021,807,3,23,60,83
08/05/2021,338,3,33,138,171
08/05/2021,330,3,17,194,211
08/05/2021,212,3,64,458,522
08/05/2021,304,3,40,200,240
08/05/2021,210,3,24,172,196
08/05/2021,78,3,85,406,491
08/05/2021,902,3,14,82,96
08/05/2021,411,3,53,458,511
08/05/2021,493,3,20,90,110
08/05/2021,117,3,105,285,390
08/05/2021,82,3,37,205,242
08/05/2021,359,3,20,107,127
08/05/2021,261,3,114,575,689
08/05/2021,288,3,16,74,90
08/05/2021,495,3,14,77,91
08/05/2021,328,3,22,79,101
08/05/2021,454,3,12,64,76
08/05/2021,843,3,14,73,87
08/05/2021,910,3,10,179,189
08/05/2021,892,3,4,27,31
08/05/2021,369,3,75,277,352
08/05/2021,685,3,13,131,144
08/05/2021,634,3,17,74,91
08/05/2021,216,3,22,81,103
08/05/2021,233,3,25,125,150
08/05/2021,86,3,15,124,139
08/05/2021,703,3,9,60,69
08/05/2021,511,3,16,176,192
08/05/2021,624,3,6,58,64
08/05/2021,583,3,34,150,184
08/05/2021,748,3,13,72,85
08/05/2021,731,3,16,94,110
08/05/2021,263,3,50,230,280
08/05/2021,487,3,26,111,137
08/05/2021,841,3,22,231,253
08/05/2021,440,3,29,145,174
08/05/2021,381,3,1,6,7
08/05/2021,205,3,62,122,184
08/05/2021,625,3,29,112,141
08/05/2021,374,3,14,79,93
08/05/2021,737,3,10,56,66
08/05/2021,572,3,20,139,159
08/05/2021,91,3,29,112,141
08/05/2021,246,3,109,662,771
08/05/2021,87,3,48,265,313
08/05/2021,749,3,9,39,48
08/05/2021,533,3,28,127,155
08/05/2021,631,3,2,19,21
08/05/2021,435,3,18,81,99
08/05/2021,12,3,10,43,53
08/05/2021,467,3,4,43,47
08/05/2021,433,3,111,536,647
08/05/2021,527,3,23,55,78
08/05/2021,739,3,10,46,56
08/05/2021,881,3,1,6,7
08/05/2021,167,3,40,191,231
08/05/2021,496,3,16,66,82
08/05/2021,529,3,24,79,103
08/05/2021,173,3,10,63,73
08/05/2021,209,3,24,111,135
08/05/2021,390,3,45,312,357
08/05/2021,394,3,19,70,89
08/05/2021,142,3,16,45,61
08/05/2021,816,3,84,343,427
08/05/2021,862,3,39,135,174
08/05/2021,904,3,83,441,524
08/05/2021,652,3,7,45,52
08/05/2021,133,3,27,101,128
08/05/2021,448,3,116,604,720
08/05/2021,145,3,34,145,179
08/05/2021,231,3,29,108,137
08/05/2021,444,3,29,128,157
08/05/2021,922,3,0,7,7
08/05/2021,792,3,38,61,99
08/05/2021,608,3,94,529,623
08/05/2021,507,3,56,409,465
08/05/2021,591,3,11,80,91
08/05/2021,687,3,29,108,137
08/05/2021,353,3,12,44,56
08/05/2021,245,3,112,701,813
08/05/2021,809,3,15,53,68
08/05/2021,25,3,36,104,140
08/05/2021,442,3,28,158,186
08/05/2021,46,3,24,61,85
08/05/2021,555,3,89,252,341
08/05/2021,581,3,24,132,156
08/05/2021,677,3,13,75,88
08/05/2021,119,3,51,262,313
08/05/2021,200,3,14,142,156
08/05/2021,491,3,48,395,443
08/05/2021,446,3,19,174,193
08/05/2021,296,3,27,100,127
08/05/2021,239,3,63,426,489
08/05/2021,401,3,4,56,60
08/05/2021,882,3,0,15,15
08/05/2021,522,3,36,248,284
08/05/2021,416,3,10,72,82
08/05/2021,707,3,37,136,173
08/05/2021,666,3,36,175,211
08/05/2021,281,3,31,97,128
08/05/2021,790,3,37,279,316
08/05/2021,267,3,25,69,94
08/05/2021,182,3,10,85,95
08/05/2021,784,3,72,359,431
08/05/2021,66,3,10,31,41
08/05/2021,450,3,17,146,163
08/05/2021,920,3,0,1,1
08/05/2021,679,3,42,132,174
08/05/2021,530,3,26,97,123
08/05/2021,476,3,14,87,101
08/05/2021,668,3,3,12,15
08/05/2021,821,3,53,154,207
08/05/2021,107,3,111,438,549
08/05/2021,174,3,16,61,77
08/05/2021,316,3,16,153,169
08/05/2021,407,3,34,362,396
08/05/2021,357,3,63,320,383
08/05/2021,290,3,89,667,756
08/05/2021,38,3,19,185,204
08/05/2021,5,3,19,118,137
08/05/2021,559,3,95,278,373
08/05/2021,366,3,23,32,55
08/05/2021,860,3,33,120,153
08/05/2021,854,3,76,377,453
08/05/2021,274,3,0,11,11
08/05/2021,120,3,31,107,138
08/05/2021,623,3,26,174,200
08/05/2021,250,3,95,207,302
08/05/2021,232,3,32,118,150
08/05/2021,480,3,14,56,70
08/05/2021,33,3,54,260,314
08/05/2021,588,3,11,76,87
08/05/2021,108,3,14,94,108
08/05/2021,885,3,16,164,180
08/05/2021,392,3,23,72,95
08/05/2021,767,3,96,471,567
08/05/2021,429,3,29,177,206
08/05/2021,177,3,15,68,83
08/05/2021,199,3,7,53,60
08/05/2021,126,3,70,186,256
08/05/2021,45,3,24,124,148
08/05/2021,341,3,96,306,402
08/05/2021,743,3,8,63,71
08/05/2021,412,3,21,274,295
08/05/2021,543,3,110,381,491
08/05/2021,102,3,88,327,415
08/05/2021,134,3,55,225,280
08/05/2021,510,3,15,60,75
08/05/2021,930,3,0,9,9
08/05/2021,582,3,92,547,639
08/05/2021,706,3,36,134,170
08/05/2021,39,3,24,194,218
08/05/2021,118,3,52,234,286
08/05/2021,230,3,25,149,174
08/05/2021,258,3,96,546,642
08/05/2021,787,3,110,561,671
08/05/2021,234,3,18,74,92
08/05/2021,873,3,29,135,164
08/05/2021,49,3,24,96,120
08/05/2021,521,3,8,60,68
08/05/2021,734,3,7,74,81
08/05/2021,799,3,7,21,28
08/05/2021,923,3,0,4,4
08/05/2021,938,3,0,1,1
08/05/2021,325,3,15,147,162
08/05/2021,364,3,109,256,365
08/05/2021,284,3,12,40,52
08/05/2021,6,3,19,124,143
08/05/2021,539,3,59,239,298
09/05/2021,787,3,77,224,301
09/05/2021,230,3,22,60,82
09/05/2021,49,3,13,33,46
09/05/2021,873,3,21,60,81
09/05/2021,734,3,13,37,50
09/05/2021,923,3,0,2,2
09/05/2021,118,3,42,91,133
09/05/2021,258,3,106,340,446
09/05/2021,539,3,36,85,121
09/05/2021,325,3,9,60,69
09/05/2021,521,3,6,25,31
09/05/2021,364,3,65,141,206
09/05/2021,234,3,17,31,48
09/05/2021,6,3,11,78,89
09/05/2021,799,3,3,14,17
09/05/2021,938,3,0,2,2
09/05/2021,284,3,7,27,34
09/05/2021,534,3,18,63,81
09/05/2021,383,3,54,178,232
09/05/2021,918,3,0,1,1
09/05/2021,681,3,27,60,87
09/05/2021,235,3,18,116,134
09/05/2021,658,3,12,50,62
09/05/2021,900,3,0,5,5
09/05/2021,632,3,1,13,14
09/05/2021,418,3,10,39,49
09/05/2021,675,3,9,44,53
09/05/2021,924,3,0,2,2
09/05/2021,60,3,9,19,28
09/05/2021,194,3,0,1,1
09/05/2021,752,3,47,131,178
09/05/2021,863,3,14,40,54
09/05/2021,570,3,18,64,82
09/05/2021,777,3,22,54,76
09/05/2021,238,3,68,259,327
09/05/2021,187,3,22,46,68
09/05/2021,895,3,19,58,77
09/05/2021,380,3,12,50,62
09/05/2021,423,3,42,304,346
09/05/2021,785,3,67,224,291
09/05/2021,305,3,25,64,89
09/05/2021,696,3,25,69,94
09/05/2021,276,3,25,83,108
09/05/2021,28,3,17,35,52
09/05/2021,286,3,12,63,75
09/05/2021,897,3,4,6,10
09/05/2021,189,3,12,70,82
09/05/2021,400,3,7,25,32
09/05/2021,716,3,11,71,82
09/05/2021,329,3,43,147,190
09/05/2021,301,3,45,225,270
09/05/2021,55,3,10,40,50
09/05/2021,808,3,54,130,184
09/05/2021,459,3,19,87,106
09/05/2021,814,3,16,37,53
09/05/2021,724,3,120,273,393
09/05/2021,299,3,17,69,86
09/05/2021,891,3,19,45,64
09/05/2021,337,3,7,25,32
09/05/2021,508,3,31,118,149
09/05/2021,844,3,1,7,8
09/05/2021,698,3,20,91,111
09/05/2021,181,3,14,45,59
09/05/2021,98,3,48,142,190
09/05/2021,856,3,24,21,45
09/05/2021,319,3,12,35,47
09/05/2021,913,3,2,1,3
09/05/2021,313,3,14,33,47
09/05/2021,550,3,36,92,128
09/05/2021,911,3,13,88,101
09/05/2021,159,3,21,86,107
09/05/2021,587,3,5,13,18
09/05/2021,168,3,15,56,71
09/05/2021,229,3,39,88,127
09/05/2021,561,3,2,35,37
09/05/2021,746,3,16,56,72
09/05/2021,456,3,5,18,23
09/05/2021,721,3,122,378,500
09/05/2021,713,3,34,331,365
09/05/2021,149,3,12,60,72
09/05/2021,164,3,8,62,70
09/05/2021,27,3,93,163,256
09/05/2021,547,3,134,300,434
09/05/2021,770,3,68,172,240
09/05/2021,937,3,1,0,1
09/05/2021,524,3,20,86,106
09/05/2021,673,3,20,76,96
09/05/2021,90,3,8,58,66
09/05/2021,794,3,60,183,243
09/05/2021,567,3,29,68,97
09/05/2021,811,3,14,36,50
09/05/2021,736,3,6,24,30
09/05/2021,206,3,2,6,8
09/05/2021,76,3,37,136,173
09/05/2021,143,3,49,133,182
09/05/2021,750,3,31,127,158
09/05/2021,805,3,20,48,68
09/05/2021,857,3,40,84,124
09/05/2021,294,3,34,89,123
09/05/2021,626,3,13,59,72
09/05/2021,180,3,24,71,95
09/05/2021,84,3,72,175,247
09/05/2021,220,3,16,53,69
09/05/2021,432,3,5,23,28
09/05/2021,886,3,0,5,5
09/05/2021,34,3,10,60,70
09/05/2021,385,3,14,54,68
09/05/2021,285,3,23,50,73
09/05/2021,699,3,22,64,86
09/05/2021,553,3,20,42,62
09/05/2021,23,3,14,23,37
09/05/2021,573,3,26,53,79
09/05/2021,847,3,7,11,18
09/05/2021,50,3,15,39,54
09/05/2021,896,3,138,321,459
09/05/2021,470,3,18,103,121
09/05/2021,849,3,22,96,118
09/05/2021,379,3,28,136,164
09/05/2021,801,3,19,141,160
09/05/2021,819,3,38,88,126
09/05/2021,866,3,40,127,167
09/05/2021,409,3,12,42,54
09/05/2021,11,3,20,65,85
09/05/2021,717,3,13,81,94
09/05/2021,780,3,81,184,265
09/05/2021,70,3,35,136,171
09/05/2021,705,3,7,20,27
09/05/2021,170,3,14,78,92
09/05/2021,638,3,22,70,92
09/05/2021,424,3,43,329,372
09/05/2021,829,3,34,95,129
09/05/2021,614,3,13,68,81
09/05/2021,711,3,19,59,78
09/05/2021,259,3,102,303,405
09/05/2021,271,3,11,35,46
09/05/2021,593,3,69,244,313
09/05/2021,778,3,43,117,160
09/05/2021,255,3,2,6,8
09/05/2021,342,3,17,48,65
09/05/2021,526,3,12,28,40
09/05/2021,817,3,14,81,95
09/05/2021,190,3,19,62,81
09/05/2021,689,3,26,77,103
09/05/2021,184,3,22,54,76
09/05/2021,365,3,28,54,82
09/05/2021,151,3,7,31,38
09/05/2021,420,3,91,161,252
09/05/2021,131,3,40,94,134
09/05/2021,243,3,77,303,380
09/05/2021,188,3,16,74,90
09/05/2021,636,3,14,47,61
09/05/2021,656,3,11,32,43
09/05/2021,340,3,7,12,19
09/05/2021,697,3,20,89,109
09/05/2021,501,3,11,26,37
09/05/2021,80,3,7,28,35
09/05/2021,610,3,45,165,210
09/05/2021,355,3,7,36,43
09/05/2021,97,3,46,114,160
09/05/2021,601,3,17,93,110
09/05/2021,870,3,7,27,34
09/05/2021,733,3,9,45,54
09/05/2021,894,3,36,64,100
09/05/2021,859,3,3,9,12
09/05/2021,499,3,21,83,104
09/05/2021,473,3,15,40,55
09/05/2021,195,3,13,35,48
09/05/2021,59,3,17,78,95
09/05/2021,802,3,34,129,163
09/05/2021,443,3,19,73,92
09/05/2021,309,3,9,35,44
09/05/2021,37,3,22,44,66
09/05/2021,244,3,24,94,118
09/05/2021,161,3,66,163,229
09/05/2021,95,3,46,134,180
09/05/2021,765,3,26,83,109
09/05/2021,704,3,8,27,35
09/05/2021,47,3,21,40,61
09/05/2021,154,3,28,66,94
09/05/2021,242,3,71,294,365
09/05/2021,759,3,8,35,43
09/05/2021,879,3,0,35,35
09/05/2021,751,3,1,5,6
09/05/2021,826,3,28,95,123
09/05/2021,18,3,19,51,70
09/05/2021,236,3,5,11,16
09/05/2021,221,3,16,49,65
09/05/2021,488,3,24,46,70
09/05/2021,738,3,24,78,102
09/05/2021,890,3,4,29,33
09/05/2021,460,3,19,78,97
09/05/2021,99,3,68,173,241
09/05/2021,88,3,20,45,65
09/05/2021,868,3,69,192,261
09/05/2021,466,3,18,62,80
09/05/2021,485,3,25,55,80
09/05/2021,815,3,86,241,327
09/05/2021,101,3,31,121,152
09/05/2021,334,3,66,125,191
09/05/2021,803,3,22,88,110
09/05/2021,64,3,2,16,18
09/05/2021,172,3,11,77,88
09/05/2021,520,3,11,49,60
09/05/2021,723,3,22,59,81
09/05/2021,19,3,26,83,109
09/05/2021,585,3,40,105,145
09/05/2021,7,3,12,79,91
09/05/2021,497,3,28,133,161
09/05/2021,166,3,5,58,63
09/05/2021,123,3,14,47,61
09/05/2021,298,3,66,277,343
09/05/2021,157,3,27,78,105
09/05/2021,196,3,10,7,17
09/05/2021,125,3,29,56,85
09/05/2021,105,3,30,74,104
09/05/2021,798,3,39,100,139
09/05/2021,774,3,23,62,85
09/05/2021,646,3,24,79,103
09/05/2021,683,3,12,99,111
09/05/2021,474,3,14,35,49
09/05/2021,192,3,9,48,57
09/05/2021,162,3,65,162,227
09/05/2021,436,3,10,73,83
09/05/2021,825,3,36,87,123
09/05/2021,393,3,6,25,31
09/05/2021,269,3,14,36,50
09/05/2021,253,3,7,23,30
09/05/2021,350,3,11,40,51
09/05/2021,512,3,15,34,49
09/05/2021,15,3,36,97,133
09/05/2021,597,3,5,34,39
09/05/2021,247,3,34,205,239
09/05/2021,251,3,14,50,64
09/05/2021,186,3,16,43,59
09/05/2021,399,3,44,109,153
09/05/2021,654,3,18,113,131
09/05/2021,462,3,2,11,13
09/05/2021,56,3,20,104,124
09/05/2021,864,3,14,43,57
09/05/2021,776,3,16,79,95
09/05/2021,361,3,68,136,204
09/05/2021,571,3,8,4,12
09/05/2021,17,3,12,35,47
09/05/2021,589,3,16,41,57
09/05/2021,648,3,20,45,65
09/05/2021,287,3,66,284,350
09/05/2021,153,3,29,66,95
09/05/2021,147,3,10,70,80
09/05/2021,413,3,33,136,169
09/05/2021,888,3,6,8,14
09/05/2021,607,3,58,197,255
09/05/2021,332,3,22,63,85
09/05/2021,42,3,17,52,69
09/05/2021,198,3,16,60,76
09/05/2021,504,3,6,41,47
09/05/2021,93,3,21,132,153
09/05/2021,586,3,35,218,253
09/05/2021,477,3,9,45,54
09/05/2021,558,3,3,37,40
09/05/2021,795,3,21,90,111
09/05/2021,492,3,10,52,62
09/05/2021,175,3,18,54,72
09/05/2021,702,3,14,46,60
09/05/2021,69,3,18,65,83
09/05/2021,883,3,7,83,90
09/05/2021,889,3,0,2,2
09/05/2021,858,3,57,125,182
09/05/2021,613,3,10,27,37
09/05/2021,406,3,37,94,131
09/05/2021,537,3,37,87,124
09/05/2021,398,3,3,6,9
09/05/2021,378,3,12,56,68
09/05/2021,845,3,23,54,77
09/05/2021,618,3,16,50,66
09/05/2021,827,3,82,154,236
09/05/2021,21,3,23,71,94
09/05/2021,94,3,1,0,1
09/05/2021,363,3,80,142,222
09/05/2021,346,3,8,38,46
09/05/2021,725,3,16,81,97
09/05/2021,483,3,30,69,99
09/05/2021,208,3,10,51,61
09/05/2021,160,3,2,7,9
09/05/2021,664,3,40,96,136
09/05/2021,225,3,28,75,103
09/05/2021,31,3,10,57,67
09/05/2021,214,3,25,191,216
09/05/2021,880,3,0,11,11
09/05/2021,692,3,13,26,39
09/05/2021,457,3,20,47,67
09/05/2021,453,3,20,71,91
09/05/2021,140,3,6,35,41
09/05/2021,655,3,33,107,140
09/05/2021,663,3,25,68,93
09/05/2021,840,3,21,109,130
09/05/2021,463,3,58,225,283
09/05/2021,877,3,1,19,20
09/05/2021,635,3,17,67,84
09/05/2021,694,3,8,54,62
09/05/2021,680,3,24,51,75
09/05/2021,651,3,14,64,78
09/05/2021,461,3,8,29,37
09/05/2021,517,3,13,30,43
09/05/2021,580,3,33,91,124
09/05/2021,260,3,117,362,479
09/05/2021,421,3,81,136,217
09/05/2021,661,3,7,17,24
09/05/2021,578,3,6,33,39
09/05/2021,469,3,14,97,111
09/05/2021,24,3,15,21,36
09/05/2021,425,3,17,93,110
09/05/2021,458,3,16,100,116
09/05/2021,178,3,21,72,93
09/05/2021,786,3,26,92,118
09/05/2021,528,3,10,28,38
09/05/2021,489,3,3,26,29
09/05/2021,237,3,64,271,335
09/05/2021,735,3,5,33,38
09/05/2021,279,3,31,86,117
09/05/2021,54,3,16,38,54
09/05/2021,788,3,47,70,117
09/05/2021,628,3,19,36,55
09/05/2021,155,3,29,102,131
09/05/2021,318,3,35,108,143
09/05/2021,565,3,72,119,191
09/05/2021,478,3,19,12,31
09/05/2021,289,3,20,72,92
09/05/2021,30,3,43,77,120
09/05/2021,144,3,10,77,87
09/05/2021,124,3,14,30,44
09/05/2021,850,3,66,176,242
09/05/2021,61,3,20,102,122
09/05/2021,604,3,62,129,191
09/05/2021,842,3,13,7,20
09/05/2021,185,3,19,69,88
09/05/2021,823,3,21,65,86
09/05/2021,1,3,11,78,89
09/05/2021,514,3,14,35,49
09/05/2021,701,3,10,39,49
09/05/2021,878,3,1,2,3
09/05/2021,111,3,43,110,153
09/05/2021,371,3,17,43,60
09/05/2021,391,3,29,101,130
09/05/2021,660,3,15,46,61
09/05/2021,265,3,18,43,61
09/05/2021,176,3,22,71,93
09/05/2021,103,3,53,119,172
09/05/2021,314,3,10,28,38
09/05/2021,121,3,119,259,378
09/05/2021,835,3,36,74,110
09/05/2021,257,3,100,303,403
09/05/2021,837,3,49,218,267
09/05/2021,855,3,24,82,106
09/05/2021,709,3,40,102,142
09/05/2021,505,3,12,65,77
09/05/2021,434,3,7,18,25
09/05/2021,32,3,14,51,65
09/05/2021,831,3,20,111,131
09/05/2021,277,3,30,66,96
09/05/2021,389,3,27,108,135
09/05/2021,484,3,24,52,76
09/05/2021,838,3,13,51,64
09/05/2021,136,3,42,108,150
09/05/2021,714,3,36,59,95
09/05/2021,382,3,0,3,3
09/05/2021,584,3,75,232,307
09/05/2021,647,3,14,48,62
09/05/2021,574,3,29,62,91
09/05/2021,439,3,17,80,97
09/05/2021,598,3,88,264,352
09/05/2021,362,3,73,136,209
09/05/2021,404,3,61,152,213
09/05/2021,686,3,11,64,75
09/05/2021,728,3,18,64,82
09/05/2021,352,3,33,92,125
09/05/2021,832,3,21,59,80
09/05/2021,110,3,9,41,50
09/05/2021,431,3,28,70,98
09/05/2021,506,3,13,31,44
09/05/2021,486,3,20,83,103
09/05/2021,53,3,32,73,105
09/05/2021,410,3,24,130,154
09/05/2021,2,3,11,76,87
09/05/2021,531,3,26,104,130
09/05/2021,490,3,2,26,28
09/05/2021,818,3,62,176,238
09/05/2021,339,3,3,15,18
09/05/2021,643,3,13,69,82
09/05/2021,96,3,16,88,104
09/05/2021,921,3,0,5,5
09/05/2021,203,3,14,52,66
09/05/2021,441,3,18,50,68
09/05/2021,820,3,11,72,83
09/05/2021,791,3,22,107,129
09/05/2021,256,3,27,64,91
09/05/2021,386,3,45,176,221
09/05/2021,158,3,16,49,65
09/05/2021,830,3,130,284,414
09/05/2021,757,3,36,80,116
09/05/2021,327,3,45,149,194
09/05/2021,732,3,4,40,44
09/05/2021,13,3,12,39,51
09/05/2021,468,3,17,53,70
09/05/2021,395,3,15,31,46
09/05/2021,640,3,11,54,65
09/05/2021,605,3,67,149,216
09/05/2021,336,3,107,241,348
09/05/2021,283,3,22,54,76
09/05/2021,599,3,91,268,359
09/05/2021,273,3,51,190,241
09/05/2021,377,3,28,38,66
09/05/2021,503,3,12,18,30
09/05/2021,36,3,11,63,74
09/05/2021,405,3,13,33,46
09/05/2021,688,3,10,51,61
09/05/2021,248,3,32,49,81
09/05/2021,402,3,43,101,144
09/05/2021,272,3,17,65,82
09/05/2021,804,3,70,275,345
09/05/2021,104,3,41,89,130
09/05/2021,408,3,18,40,58
09/05/2021,535,3,13,50,63
09/05/2021,264,3,20,40,60
09/05/2021,479,3,9,34,43
09/05/2021,934,3,0,10,10
09/05/2021,112,3,16,39,55
09/05/2021,899,3,50,129,179
09/05/2021,83,3,101,269,370
09/05/2021,901,3,0,2,2
09/05/2021,228,3,22,49,71
09/05/2021,848,3,42,99,141
09/05/2021,475,3,53,107,160
09/05/2021,519,3,18,56,74
09/05/2021,183,3,12,44,56
09/05/2021,917,3,6,5,11
09/05/2021,262,3,16,35,51
09/05/2021,617,3,22,46,68
09/05/2021,451,3,69,306,375
09/05/2021,594,3,38,128,166
09/05/2021,193,3,25,74,99
09/05/2021,106,3,42,159,201
09/05/2021,755,3,44,134,178
09/05/2021,865,3,12,33,45
09/05/2021,932,3,0,3,3
09/05/2021,783,3,40,132,172
09/05/2021,712,3,18,48,66
09/05/2021,79,3,21,57,78
09/05/2021,280,3,13,34,47
09/05/2021,637,3,44,139,183
09/05/2021,465,3,7,53,60
09/05/2021,500,3,12,36,48
09/05/2021,797,3,41,95,136
09/05/2021,566,3,1,39,40
09/05/2021,846,3,6,18,24
09/05/2021,114,3,37,60,97
09/05/2021,907,3,46,107,153
09/05/2021,43,3,15,92,107
09/05/2021,824,3,21,44,65
09/05/2021,293,3,37,155,192
09/05/2021,356,3,39,113,152
09/05/2021,360,3,16,71,87
09/05/2021,333,3,32,279,311
09/05/2021,311,3,34,63,97
09/05/2021,217,3,23,186,209
09/05/2021,876,3,0,3,3
09/05/2021,719,3,13,25,38
09/05/2021,532,3,113,358,471
09/05/2021,874,3,4,11,15
09/05/2021,44,3,41,110,151
09/05/2021,577,3,18,100,118
09/05/2021,595,3,23,54,77
09/05/2021,388,3,27,99,126
09/05/2021,331,3,16,40,56
09/05/2021,291,3,49,229,278
09/05/2021,552,3,38,94,132
09/05/2021,645,3,25,86,111
09/05/2021,606,3,36,75,111
09/05/2021,351,3,72,193,265
09/05/2021,81,3,7,29,36
09/05/2021,771,3,15,102,117
09/05/2021,116,3,13,41,54
09/05/2021,773,3,23,63,86
09/05/2021,39,3,17,95,112
09/05/2021,543,3,126,288,414
09/05/2021,582,3,102,323,425
09/05/2021,134,3,41,105,146
09/05/2021,706,3,39,94,133
09/05/2021,341,3,109,243,352
09/05/2021,930,3,0,8,8
09/05/2021,126,3,23,73,96
09/05/2021,199,3,5,26,31
09/05/2021,45,3,11,79,90
09/05/2021,743,3,9,45,54
09/05/2021,102,3,54,143,197
09/05/2021,510,3,9,18,27
09/05/2021,412,3,12,92,104
09/05/2021,148,3,13,63,76
09/05/2021,63,3,9,38,47
09/05/2021,513,3,15,74,89
09/05/2021,810,3,2,15,17
09/05/2021,146,3,54,147,201
09/05/2021,345,3,25,43,68
09/05/2021,240,3,71,265,336
09/05/2021,576,3,1,9,10
09/05/2021,26,3,25,77,102
09/05/2021,317,3,58,115,173
09/05/2021,812,3,10,48,58
09/05/2021,370,3,21,89,110
09/05/2021,122,3,33,56,89
09/05/2021,700,3,18,89,107
09/05/2021,71,3,13,55,68
09/05/2021,100,3,31,46,77
09/05/2021,753,3,32,102,134
09/05/2021,278,3,14,34,48
09/05/2021,615,3,20,59,79
09/05/2021,89,3,22,88,110
09/05/2021,745,3,13,65,78
09/05/2021,171,3,9,22,31
09/05/2021,710,3,16,48,64
09/05/2021,852,3,71,126,197
09/05/2021,129,3,49,106,155
09/05/2021,616,3,19,73,92
09/05/2021,884,3,9,92,101
09/05/2021,68,3,21,106,127
09/05/2021,756,3,45,164,209
09/05/2021,428,3,14,64,78
09/05/2021,135,3,42,108,150
09/05/2021,662,3,37,118,155
09/05/2021,115,3,11,41,52
09/05/2021,542,3,36,66,102
09/05/2021,9,3,18,62,80
09/05/2021,344,3,19,53,72
09/05/2021,254,3,12,45,57
09/05/2021,207,3,13,58,71
09/05/2021,779,3,18,37,55
09/05/2021,515,3,16,109,125
09/05/2021,347,3,74,173,247
09/05/2021,65,3,17,99,116
09/05/2021,20,3,15,18,33
09/05/2021,396,3,13,30,43
09/05/2021,781,3,50,152,202
09/05/2021,224,3,22,53,75
09/05/2021,867,3,26,47,73
09/05/2021,419,3,56,212,268
09/05/2021,869,3,64,139,203
09/05/2021,592,3,30,86,116
09/05/2021,629,3,9,62,71
09/05/2021,335,3,13,123,136
09/05/2021,130,3,48,125,173
09/05/2021,282,3,25,38,63
09/05/2021,676,3,13,36,49
09/05/2021,789,3,19,63,82
09/05/2021,758,3,22,78,100
09/05/2021,650,3,22,108,130
09/05/2021,872,3,22,39,61
09/05/2021,137,3,42,99,141
09/05/2021,575,3,7,20,27
09/05/2021,430,3,19,81,100
09/05/2021,839,3,14,98,112
09/05/2021,538,3,20,68,88
09/05/2021,373,3,12,55,67
09/05/2021,563,3,7,51,58
09/05/2021,113,3,8,31,39
09/05/2021,551,3,46,110,156
09/05/2021,569,3,28,72,100
09/05/2021,22,3,15,52,67
09/05/2021,546,3,20,30,50
09/05/2021,8,3,29,96,125
09/05/2021,447,3,20,93,113
09/05/2021,471,3,12,58,70
09/05/2021,800,3,20,51,71
09/05/2021,761,3,7,23,30
09/05/2021,682,3,8,32,40
09/05/2021,268,3,45,101,146
09/05/2021,303,3,29,200,229
09/05/2021,730,3,10,42,52
09/05/2021,384,3,23,78,101
09/05/2021,887,3,0,10,10
09/05/2021,564,3,24,79,103
09/05/2021,619,3,14,49,63
09/05/2021,633,3,3,27,30
09/05/2021,544,3,32,74,106
09/05/2021,215,3,11,42,53
09/05/2021,77,3,44,153,197
09/05/2021,556,3,77,123,200
09/05/2021,75,3,42,147,189
09/05/2021,219,3,14,49,63
09/05/2021,349,3,8,35,43
09/05/2021,323,3,9,44,53
09/05/2021,509,3,25,109,134
09/05/2021,58,3,23,129,152
09/05/2021,603,3,57,106,163
09/05/2021,218,3,26,193,219
09/05/2021,764,3,4,20,24
09/05/2021,322,3,16,60,76
09/05/2021,579,3,10,25,35
09/05/2021,438,3,13,38,51
09/05/2021,715,3,58,69,127
09/05/2021,472,3,28,76,104
09/05/2021,308,3,22,59,81
09/05/2021,403,3,42,98,140
09/05/2021,871,3,40,112,152
09/05/2021,726,3,8,54,62
09/05/2021,169,3,10,77,87
09/05/2021,720,3,14,24,38
09/05/2021,297,3,40,189,229
09/05/2021,315,3,8,46,54
09/05/2021,747,3,12,53,65
09/05/2021,548,3,22,37,59
09/05/2021,649,3,22,56,78
09/05/2021,782,3,39,107,146
09/05/2021,464,3,45,223,268
09/05/2021,518,3,10,41,51
09/05/2021,139,3,35,85,120
09/05/2021,813,3,11,45,56
09/05/2021,292,3,57,278,335
09/05/2021,422,3,34,80,114
09/05/2021,622,3,82,160,242
09/05/2021,760,3,15,63,78
09/05/2021,3,3,12,77,89
09/05/2021,72,3,38,156,194
09/05/2021,642,3,13,53,66
09/05/2021,204,3,4,7,11
09/05/2021,92,3,16,89,105
09/05/2021,754,3,15,105,120
09/05/2021,202,3,44,130,174
09/05/2021,310,3,54,163,217
09/05/2021,861,3,65,98,163
09/05/2021,275,3,23,70,93
09/05/2021,691,3,25,49,74
09/05/2021,452,3,23,103,126
09/05/2021,612,3,49,179,228
09/05/2021,742,3,25,75,100
09/05/2021,906,3,4,5,9
09/05/2021,326,3,8,34,42
09/05/2021,772,3,23,65,88
09/05/2021,222,3,14,45,59
09/05/2021,52,3,22,65,87
09/05/2021,481,3,31,55,86
09/05/2021,227,3,17,61,78
09/05/2021,127,3,8,51,59
09/05/2021,426,3,15,55,70
09/05/2021,312,3,23,40,63
09/05/2021,300,3,59,290,349
09/05/2021,540,3,40,103,143
09/05/2021,833,3,18,26,44
09/05/2021,853,3,12,39,51
09/05/2021,397,3,11,24,35
09/05/2021,851,3,5,10,15
09/05/2021,557,3,9,46,55
09/05/2021,768,3,22,131,153
09/05/2021,348,3,9,53,62
09/05/2021,670,3,139,334,473
09/05/2021,48,3,13,35,48
09/05/2021,898,3,20,28,48
09/05/2021,249,3,84,330,414
09/05/2021,376,3,14,21,35
09/05/2021,372,3,47,122,169
09/05/2021,659,3,11,50,61
09/05/2021,554,3,18,51,69
09/05/2021,307,3,28,78,106
09/05/2021,35,3,12,75,87
09/05/2021,270,3,10,35,45
09/05/2021,919,3,14,40,54
09/05/2021,665,3,14,57,71
09/05/2021,295,3,7,25,32
09/05/2021,674,3,6,47,53
09/05/2021,85,3,61,81,142
09/05/2021,639,3,28,43,71
09/05/2021,627,3,14,48,62
09/05/2021,197,3,14,53,67
09/05/2021,828,3,29,85,114
09/05/2021,653,3,6,34,40
09/05/2021,156,3,27,64,91
09/05/2021,179,3,10,39,49
09/05/2021,621,3,19,68,87
09/05/2021,741,3,6,37,43
09/05/2021,455,3,3,15,18
09/05/2021,562,3,7,31,38
09/05/2021,494,3,14,61,75
09/05/2021,445,3,20,130,150
09/05/2021,343,3,9,42,51
09/05/2021,358,3,51,154,205
09/05/2021,905,3,1,1,2
09/05/2021,414,3,17,42,59
09/05/2021,641,3,3,13,16
09/05/2021,201,3,9,33,42
09/05/2021,936,3,2,1,3
09/05/2021,163,3,17,48,65
09/05/2021,417,3,31,145,176
09/05/2021,836,3,25,141,166
09/05/2021,128,3,7,56,63
09/05/2021,427,3,25,90,115
09/05/2021,684,3,16,74,90
09/05/2021,321,3,12,38,50
09/05/2021,138,3,43,90,133
09/05/2021,354,3,1,2,3
09/05/2021,51,3,52,156,208
09/05/2021,252,3,13,32,45
09/05/2021,266,3,19,49,68
09/05/2021,875,3,11,55,66
09/05/2021,213,3,31,203,234
09/05/2021,909,3,1,9,10
09/05/2021,600,3,87,267,354
09/05/2021,250,3,60,117,177
09/05/2021,854,3,51,206,257
09/05/2021,120,3,29,58,87
09/05/2021,366,3,18,27,45
09/05/2021,767,3,64,163,227
09/05/2021,429,3,19,128,147
09/05/2021,392,3,17,32,49
09/05/2021,623,3,20,74,94
09/05/2021,860,3,21,69,90
09/05/2021,33,3,33,76,109
09/05/2021,274,3,0,6,6
09/05/2021,232,3,22,57,79
09/05/2021,885,3,14,81,95
09/05/2021,480,3,12,37,49
09/05/2021,177,3,8,32,40
09/05/2021,108,3,8,39,47
09/05/2021,588,3,17,41,58
09/05/2021,91,3,21,72,93
09/05/2021,435,3,12,68,80
09/05/2021,737,3,6,40,46
09/05/2021,87,3,26,114,140
09/05/2021,625,3,24,48,72
09/05/2021,246,3,78,295,373
09/05/2021,533,3,16,23,39
09/05/2021,374,3,11,37,48
09/05/2021,572,3,27,63,90
09/05/2021,631,3,0,14,14
09/05/2021,749,3,6,9,15
09/05/2021,205,3,15,60,75
09/05/2021,914,3,1,3,4
09/05/2021,302,3,50,228,278
09/05/2021,387,3,28,46,74
09/05/2021,367,3,22,92,114
09/05/2021,727,3,7,51,58
09/05/2021,908,3,1,5,6
09/05/2021,693,3,16,50,66
09/05/2021,536,3,22,51,73
09/05/2021,926,3,0,3,3
09/05/2021,560,3,65,113,178
09/05/2021,669,3,6,50,56
09/05/2021,437,3,17,121,138
09/05/2021,152,3,12,71,83
09/05/2021,211,3,26,190,216
09/05/2021,67,3,17,82,99
09/05/2021,498,3,8,59,67
09/05/2021,525,3,16,84,100
09/05/2021,226,3,23,59,82
09/05/2021,806,3,28,167,195
09/05/2021,4,3,23,74,97
09/05/2021,368,3,21,86,107
09/05/2021,657,3,49,87,136
09/05/2021,57,3,20,113,133
09/05/2021,915,3,0,12,12
09/05/2021,793,3,16,103,119
09/05/2021,602,3,70,153,223
09/05/2021,41,3,16,78,94
09/05/2021,775,3,11,59,70
09/05/2021,722,3,7,28,35
09/05/2021,449,3,26,113,139
09/05/2021,671,3,17,171,188
09/05/2021,487,3,26,47,73
09/05/2021,685,3,14,60,74
09/05/2021,748,3,14,39,53
09/05/2021,369,3,53,117,170
09/05/2021,233,3,27,58,85
09/05/2021,216,3,16,53,69
09/05/2021,263,3,25,81,106
09/05/2021,511,3,6,58,64
09/05/2021,634,3,19,87,106
09/05/2021,624,3,1,24,25
09/05/2021,86,3,8,56,64
09/05/2021,703,3,11,35,46
09/05/2021,381,3,1,2,3
09/05/2021,583,3,28,76,104
09/05/2021,841,3,13,108,121
09/05/2021,440,3,10,48,58
09/05/2021,731,3,12,38,50
09/05/2021,212,3,29,200,229
09/05/2021,807,3,11,33,44
09/05/2021,78,3,99,270,369
09/05/2021,304,3,35,71,106
09/05/2021,210,3,24,89,113
09/05/2021,117,3,77,144,221
09/05/2021,902,3,20,43,63
09/05/2021,493,3,13,62,75
09/05/2021,411,3,31,156,187
09/05/2021,330,3,18,127,145
09/05/2021,338,3,19,122,141
09/05/2021,261,3,116,358,474
09/05/2021,82,3,34,80,114
09/05/2021,454,3,3,20,23
09/05/2021,910,3,7,87,94
09/05/2021,892,3,2,12,14
09/05/2021,328,3,11,50,61
09/05/2021,359,3,24,53,77
09/05/2021,843,3,10,29,39
09/05/2021,288,3,9,34,43
09/05/2021,495,3,10,53,63
09/05/2021,530,3,18,39,57
09/05/2021,174,3,10,35,45
09/05/2021,290,3,54,245,299
09/05/2021,668,3,3,13,16
09/05/2021,821,3,28,73,101
09/05/2021,107,3,72,178,250
09/05/2021,476,3,14,48,62
09/05/2021,559,3,66,117,183
09/05/2021,357,3,41,140,181
09/05/2021,316,3,15,92,107
09/05/2021,679,3,26,65,91
09/05/2021,407,3,20,122,142
09/05/2021,38,3,15,82,97
09/05/2021,5,3,11,78,89
09/05/2021,353,3,9,31,40
09/05/2021,133,3,14,35,49
09/05/2021,448,3,68,300,368
09/05/2021,555,3,62,112,174
09/05/2021,145,3,31,60,91
09/05/2021,581,3,16,51,67
09/05/2021,444,3,16,91,107
09/05/2021,245,3,77,327,404
09/05/2021,591,3,16,35,51
09/05/2021,608,3,61,211,272
09/05/2021,507,3,32,158,190
09/05/2021,922,3,0,4,4
09/05/2021,442,3,17,94,111
09/05/2021,652,3,7,26,33
09/05/2021,904,3,50,210,260
09/05/2021,677,3,6,45,51
09/05/2021,119,3,43,99,142
09/05/2021,200,3,9,56,65
09/05/2021,231,3,26,81,107
09/05/2021,46,3,10,33,43
09/05/2021,687,3,15,82,97
09/05/2021,809,3,17,54,71
09/05/2021,25,3,25,68,93
09/05/2021,792,3,37,60,97
09/05/2021,173,3,12,39,51
09/05/2021,496,3,14,35,49
09/05/2021,142,3,12,32,44
09/05/2021,862,3,28,62,90
09/05/2021,527,3,12,31,43
09/05/2021,529,3,12,49,61
09/05/2021,816,3,54,153,207
09/05/2021,390,3,30,118,148
09/05/2021,467,3,4,14,18
09/05/2021,739,3,6,31,37
09/05/2021,433,3,72,254,326
09/05/2021,394,3,14,29,43
09/05/2021,167,3,28,103,131
09/05/2021,12,3,11,39,50
09/05/2021,881,3,0,4,4
09/05/2021,209,3,25,60,85
09/05/2021,790,3,21,137,158
09/05/2021,450,3,12,66,78
09/05/2021,239,3,30,158,188
09/05/2021,446,3,15,106,121
09/05/2021,182,3,14,59,73
09/05/2021,784,3,49,157,206
09/05/2021,522,3,31,91,122
09/05/2021,707,3,37,89,126
09/05/2021,882,3,0,14,14
09/05/2021,281,3,28,82,110
09/05/2021,66,3,5,16,21
09/05/2021,666,3,29,89,118
09/05/2021,296,3,15,43,58
09/05/2021,267,3,20,47,67
09/05/2021,401,3,9,32,41
09/05/2021,920,3,0,1,1
09/05/2021,416,3,7,39,46
09/05/2021,491,3,24,131,155
10/05/2021,666,3,31,115,146
10/05/2021,446,3,31,135,166
10/05/2021,491,3,42,175,217
10/05/2021,707,3,44,117,161
10/05/2021,522,3,44,102,146
10/05/2021,450,3,10,60,70
10/05/2021,182,3,22,78,100
10/05/2021,296,3,27,67,94
10/05/2021,784,3,65,208,273
10/05/2021,281,3,38,100,138
10/05/2021,882,3,0,24,24
10/05/2021,267,3,25,93,118
10/05/2021,416,3,13,60,73
10/05/2021,66,3,26,90,116
10/05/2021,239,3,49,178,227
10/05/2021,790,3,38,135,173
10/05/2021,401,3,13,74,87
10/05/2021,44,3,57,183,240
10/05/2021,577,3,29,127,156
10/05/2021,874,3,15,77,92
10/05/2021,595,3,28,79,107
10/05/2021,719,3,20,45,65
10/05/2021,532,3,141,462,603
10/05/2021,876,3,0,6,6
10/05/2021,56,3,46,165,211
10/05/2021,247,3,67,243,310
10/05/2021,597,3,16,56,72
10/05/2021,251,3,22,109,131
10/05/2021,825,3,48,135,183
10/05/2021,186,3,24,67,91
10/05/2021,253,3,10,46,56
10/05/2021,350,3,33,77,110
10/05/2021,399,3,73,183,256
10/05/2021,462,3,25,70,95
10/05/2021,393,3,17,67,84
10/05/2021,192,3,14,72,86
10/05/2021,474,3,18,82,100
10/05/2021,162,3,97,253,350
10/05/2021,436,3,25,112,137
10/05/2021,654,3,28,113,141
10/05/2021,15,3,52,123,175
10/05/2021,269,3,26,75,101
10/05/2021,512,3,15,34,49
10/05/2021,683,3,17,119,136
10/05/2021,553,3,18,28,46
10/05/2021,50,3,13,50,63
10/05/2021,23,3,17,44,61
10/05/2021,470,3,37,138,175
10/05/2021,573,3,31,114,145
10/05/2021,849,3,36,137,173
10/05/2021,847,3,1,14,15
10/05/2021,896,3,169,444,613
10/05/2021,819,3,45,115,160
10/05/2021,379,3,39,157,196
10/05/2021,801,3,23,166,189
10/05/2021,380,3,19,108,127
10/05/2021,897,3,8,11,19
10/05/2021,187,3,25,66,91
10/05/2021,189,3,32,99,131
10/05/2021,777,3,32,90,122
10/05/2021,286,3,18,67,85
10/05/2021,785,3,86,256,342
10/05/2021,423,3,60,254,314
10/05/2021,696,3,26,93,119
10/05/2021,570,3,25,102,127
10/05/2021,238,3,85,299,384
10/05/2021,28,3,23,69,92
10/05/2021,400,3,13,67,80
10/05/2021,895,3,28,96,124
10/05/2021,305,3,33,129,162
10/05/2021,276,3,36,107,143
10/05/2021,925,3,0,1,1
10/05/2021,284,3,11,44,55
10/05/2021,6,3,21,113,134
10/05/2021,49,3,14,50,64
10/05/2021,539,3,46,122,168
10/05/2021,873,3,47,126,173
10/05/2021,258,3,132,403,535
10/05/2021,325,3,11,67,78
10/05/2021,118,3,56,168,224
10/05/2021,364,3,69,149,218
10/05/2021,787,3,113,314,427
10/05/2021,521,3,16,42,58
10/05/2021,234,3,10,48,58
10/05/2021,230,3,27,120,147
10/05/2021,799,3,10,25,35
10/05/2021,734,3,36,76,112
10/05/2021,938,3,0,2,2
10/05/2021,418,3,24,52,76
10/05/2021,752,3,49,146,195
10/05/2021,632,3,13,37,50
10/05/2021,900,3,1,3,4
10/05/2021,534,3,22,83,105
10/05/2021,681,3,44,113,157
10/05/2021,675,3,34,86,120
10/05/2021,863,3,34,86,120
10/05/2021,924,3,0,4,4
10/05/2021,658,3,20,85,105
10/05/2021,235,3,32,146,178
10/05/2021,383,3,79,231,310
10/05/2021,60,3,11,41,52
10/05/2021,918,3,0,7,7
10/05/2021,180,3,34,91,125
10/05/2021,34,3,28,98,126
10/05/2021,84,3,92,237,329
10/05/2021,220,3,24,69,93
10/05/2021,285,3,31,70,101
10/05/2021,432,3,25,86,111
10/05/2021,76,3,43,145,188
10/05/2021,750,3,28,109,137
10/05/2021,143,3,80,150,230
10/05/2021,385,3,18,79,97
10/05/2021,699,3,38,102,140
10/05/2021,294,3,44,144,188
10/05/2021,206,3,4,3,7
10/05/2021,805,3,24,78,102
10/05/2021,857,3,53,158,211
10/05/2021,886,3,0,3,3
10/05/2021,626,3,32,84,116
10/05/2021,301,3,64,261,325
10/05/2021,329,3,63,184,247
10/05/2021,724,3,144,367,511
10/05/2021,856,3,49,125,174
10/05/2021,299,3,28,90,118
10/05/2021,814,3,16,63,79
10/05/2021,913,3,3,4,7
10/05/2021,808,3,59,214,273
10/05/2021,698,3,37,104,141
10/05/2021,459,3,31,138,169
10/05/2021,98,3,57,179,236
10/05/2021,891,3,34,90,124
10/05/2021,55,3,17,69,86
10/05/2021,550,3,49,136,185
10/05/2021,508,3,37,146,183
10/05/2021,319,3,16,52,68
10/05/2021,313,3,21,55,76
10/05/2021,911,3,19,127,146
10/05/2021,844,3,14,46,60
10/05/2021,337,3,11,40,51
10/05/2021,181,3,17,68,85
10/05/2021,716,3,33,116,149
10/05/2021,149,3,33,94,127
10/05/2021,794,3,67,206,273
10/05/2021,770,3,104,179,283
10/05/2021,90,3,31,83,114
10/05/2021,567,3,38,129,167
10/05/2021,736,3,10,28,38
10/05/2021,27,3,100,169,269
10/05/2021,159,3,28,115,143
10/05/2021,524,3,40,134,174
10/05/2021,673,3,38,136,174
10/05/2021,456,3,17,81,98
10/05/2021,547,3,165,423,588
10/05/2021,713,3,39,295,334
10/05/2021,561,3,12,66,78
10/05/2021,164,3,21,72,93
10/05/2021,811,3,24,78,102
10/05/2021,229,3,60,149,209
10/05/2021,746,3,21,111,132
10/05/2021,168,3,24,95,119
10/05/2021,721,3,145,487,632
10/05/2021,587,3,8,29,37
10/05/2021,123,3,30,92,122
10/05/2021,774,3,35,95,130
10/05/2021,798,3,78,164,242
10/05/2021,166,3,9,60,69
10/05/2021,646,3,24,103,127
10/05/2021,125,3,39,90,129
10/05/2021,105,3,52,131,183
10/05/2021,7,3,24,113,137
10/05/2021,585,3,76,167,243
10/05/2021,497,3,39,170,209
10/05/2021,157,3,38,106,144
10/05/2021,298,3,88,330,418
10/05/2021,196,3,15,62,77
10/05/2021,733,3,13,81,94
10/05/2021,870,3,18,49,67
10/05/2021,80,3,15,46,61
10/05/2021,97,3,63,181,244
10/05/2021,610,3,53,200,253
10/05/2021,656,3,15,31,46
10/05/2021,859,3,4,6,10
10/05/2021,697,3,38,104,142
10/05/2021,499,3,29,88,117
10/05/2021,355,3,18,64,82
10/05/2021,601,3,37,94,131
10/05/2021,501,3,37,146,183
10/05/2021,188,3,33,117,150
10/05/2021,340,3,31,100,131
10/05/2021,636,3,15,79,94
10/05/2021,894,3,38,77,115
10/05/2021,424,3,64,281,345
10/05/2021,780,3,102,196,298
10/05/2021,638,3,46,139,185
10/05/2021,11,3,28,108,136
10/05/2021,170,3,29,108,137
10/05/2021,409,3,27,53,80
10/05/2021,829,3,35,112,147
10/05/2021,70,3,39,144,183
10/05/2021,705,3,8,46,54
10/05/2021,614,3,37,98,135
10/05/2021,711,3,23,77,100
10/05/2021,717,3,36,127,163
10/05/2021,866,3,44,130,174
10/05/2021,259,3,126,353,479
10/05/2021,271,3,18,75,93
10/05/2021,420,3,105,173,278
10/05/2021,243,3,101,339,440
10/05/2021,342,3,27,97,124
10/05/2021,190,3,28,114,142
10/05/2021,526,3,23,74,97
10/05/2021,593,3,93,323,416
10/05/2021,817,3,30,122,152
10/05/2021,151,3,11,64,75
10/05/2021,184,3,31,78,109
10/05/2021,255,3,2,5,7
10/05/2021,365,3,34,65,99
10/05/2021,689,3,39,88,127
10/05/2021,131,3,52,178,230
10/05/2021,778,3,65,151,216
10/05/2021,939,3,0,1,1
10/05/2021,723,3,25,100,125
10/05/2021,64,3,21,51,72
10/05/2021,485,3,36,80,116
10/05/2021,868,3,76,238,314
10/05/2021,520,3,15,60,75
10/05/2021,101,3,54,138,192
10/05/2021,460,3,32,102,134
10/05/2021,19,3,43,126,169
10/05/2021,88,3,32,71,103
10/05/2021,803,3,34,144,178
10/05/2021,738,3,33,91,124
10/05/2021,466,3,23,99,122
10/05/2021,815,3,117,364,481
10/05/2021,334,3,84,195,279
10/05/2021,890,3,5,22,27
10/05/2021,99,3,69,234,303
10/05/2021,172,3,24,107,131
10/05/2021,443,3,29,103,132
10/05/2021,195,3,13,57,70
10/05/2021,473,3,26,93,119
10/05/2021,95,3,48,151,199
10/05/2021,244,3,49,112,161
10/05/2021,802,3,38,170,208
10/05/2021,37,3,29,69,98
10/05/2021,59,3,26,89,115
10/05/2021,309,3,16,49,65
10/05/2021,161,3,95,256,351
10/05/2021,154,3,36,125,161
10/05/2021,242,3,86,308,394
10/05/2021,221,3,20,66,86
10/05/2021,765,3,35,104,139
10/05/2021,236,3,30,63,93
10/05/2021,488,3,26,84,110
10/05/2021,704,3,11,57,68
10/05/2021,879,3,0,41,41
10/05/2021,826,3,55,143,198
10/05/2021,47,3,34,85,119
10/05/2021,751,3,2,6,8
10/05/2021,759,3,13,58,71
10/05/2021,18,3,33,84,117
10/05/2021,333,3,35,220,255
10/05/2021,465,3,16,91,107
10/05/2021,360,3,26,133,159
10/05/2021,311,3,40,114,154
10/05/2021,114,3,57,112,169
10/05/2021,79,3,31,79,110
10/05/2021,846,3,1,21,22
10/05/2021,500,3,12,24,36
10/05/2021,217,3,37,208,245
10/05/2021,783,3,57,188,245
10/05/2021,824,3,46,138,184
10/05/2021,293,3,49,176,225
10/05/2021,712,3,23,80,103
10/05/2021,43,3,34,129,163
10/05/2021,280,3,14,38,52
10/05/2021,356,3,68,199,267
10/05/2021,566,3,13,68,81
10/05/2021,907,3,70,179,249
10/05/2021,637,3,68,183,251
10/05/2021,797,3,51,114,165
10/05/2021,61,3,36,133,169
10/05/2021,850,3,96,284,380
10/05/2021,289,3,32,102,134
10/05/2021,604,3,78,195,273
10/05/2021,842,3,11,15,26
10/05/2021,144,3,34,111,145
10/05/2021,185,3,24,86,110
10/05/2021,124,3,29,73,102
10/05/2021,30,3,48,101,149
10/05/2021,31,3,34,100,134
10/05/2021,346,3,14,57,71
10/05/2021,664,3,52,146,198
10/05/2021,208,3,15,72,87
10/05/2021,214,3,41,216,257
10/05/2021,725,3,27,113,140
10/05/2021,94,3,2,0,2
10/05/2021,483,3,44,102,146
10/05/2021,618,3,32,95,127
10/05/2021,363,3,81,147,228
10/05/2021,845,3,34,90,124
10/05/2021,225,3,34,99,133
10/05/2021,21,3,38,103,141
10/05/2021,160,3,3,4,7
10/05/2021,827,3,97,172,269
10/05/2021,880,3,0,13,13
10/05/2021,332,3,47,107,154
10/05/2021,361,3,71,146,217
10/05/2021,648,3,23,67,90
10/05/2021,42,3,23,84,107
10/05/2021,287,3,90,350,440
10/05/2021,776,3,28,113,141
10/05/2021,198,3,42,118,160
10/05/2021,147,3,33,101,134
10/05/2021,17,3,18,88,106
10/05/2021,607,3,71,238,309
10/05/2021,888,3,1,11,12
10/05/2021,571,3,24,76,100
10/05/2021,153,3,39,126,165
10/05/2021,864,3,34,93,127
10/05/2021,413,3,45,173,218
10/05/2021,589,3,23,76,99
10/05/2021,858,3,61,187,248
10/05/2021,406,3,53,122,175
10/05/2021,477,3,35,76,111
10/05/2021,613,3,13,56,69
10/05/2021,93,3,34,165,199
10/05/2021,69,3,30,106,136
10/05/2021,175,3,31,88,119
10/05/2021,504,3,9,35,44
10/05/2021,537,3,58,141,199
10/05/2021,398,3,5,17,22
10/05/2021,586,3,54,251,305
10/05/2021,378,3,22,89,111
10/05/2021,702,3,23,82,105
10/05/2021,795,3,30,130,160
10/05/2021,889,3,0,9,9
10/05/2021,558,3,17,71,88
10/05/2021,903,3,1,1,2
10/05/2021,883,3,4,50,54
10/05/2021,492,3,8,62,70
10/05/2021,458,3,28,142,170
10/05/2021,178,3,37,97,134
10/05/2021,318,3,61,175,236
10/05/2021,478,3,25,13,38
10/05/2021,735,3,11,52,63
10/05/2021,237,3,91,298,389
10/05/2021,628,3,22,65,87
10/05/2021,788,3,103,255,358
10/05/2021,565,3,79,189,268
10/05/2021,489,3,2,20,22
10/05/2021,279,3,43,113,156
10/05/2021,54,3,26,62,88
10/05/2021,786,3,41,118,159
10/05/2021,155,3,44,117,161
10/05/2021,528,3,20,56,76
10/05/2021,635,3,25,96,121
10/05/2021,692,3,28,60,88
10/05/2021,655,3,47,156,203
10/05/2021,463,3,64,241,305
10/05/2021,140,3,15,58,73
10/05/2021,457,3,31,65,96
10/05/2021,663,3,35,95,130
10/05/2021,453,3,31,110,141
10/05/2021,877,3,1,11,12
10/05/2021,840,3,31,132,163
10/05/2021,24,3,19,43,62
10/05/2021,260,3,147,448,595
10/05/2021,578,3,17,37,54
10/05/2021,694,3,19,84,103
10/05/2021,425,3,38,139,177
10/05/2021,421,3,90,145,235
10/05/2021,680,3,31,74,105
10/05/2021,517,3,27,69,96
10/05/2021,661,3,39,116,155
10/05/2021,461,3,26,105,131
10/05/2021,469,3,26,111,137
10/05/2021,651,3,22,71,93
10/05/2021,580,3,26,95,121
10/05/2021,451,3,78,343,421
10/05/2021,262,3,27,52,79
10/05/2021,594,3,55,181,236
10/05/2021,755,3,58,193,251
10/05/2021,475,3,57,159,216
10/05/2021,865,3,10,44,54
10/05/2021,519,3,31,83,114
10/05/2021,617,3,30,75,105
10/05/2021,183,3,19,73,92
10/05/2021,917,3,1,9,10
10/05/2021,848,3,58,187,245
10/05/2021,228,3,29,82,111
10/05/2021,193,3,29,134,163
10/05/2021,932,3,0,1,1
10/05/2021,106,3,41,149,190
10/05/2021,714,3,41,136,177
10/05/2021,362,3,79,142,221
10/05/2021,647,3,30,87,117
10/05/2021,838,3,13,70,83
10/05/2021,832,3,24,102,126
10/05/2021,506,3,33,134,167
10/05/2021,598,3,110,314,424
10/05/2021,110,3,19,88,107
10/05/2021,584,3,96,321,417
10/05/2021,404,3,76,223,299
10/05/2021,484,3,36,78,114
10/05/2021,136,3,62,145,207
10/05/2021,439,3,29,95,124
10/05/2021,352,3,52,119,171
10/05/2021,574,3,39,121,160
10/05/2021,728,3,41,101,142
10/05/2021,431,3,38,95,133
10/05/2021,686,3,16,104,120
10/05/2021,382,3,0,2,2
10/05/2021,878,3,1,3,4
10/05/2021,265,3,25,72,97
10/05/2021,514,3,15,34,49
10/05/2021,1,3,20,111,131
10/05/2021,391,3,61,152,213
10/05/2021,371,3,27,65,92
10/05/2021,701,3,20,69,89
10/05/2021,660,3,19,92,111
10/05/2021,111,3,65,165,230
10/05/2021,823,3,19,77,96
10/05/2021,831,3,42,126,168
10/05/2021,835,3,38,149,187
10/05/2021,314,3,13,42,55
10/05/2021,32,3,32,93,125
10/05/2021,505,3,21,52,73
10/05/2021,709,3,52,132,184
10/05/2021,257,3,123,364,487
10/05/2021,434,3,10,28,38
10/05/2021,121,3,146,372,518
10/05/2021,277,3,39,95,134
10/05/2021,389,3,66,155,221
10/05/2021,855,3,29,127,156
10/05/2021,837,3,51,190,241
10/05/2021,176,3,37,99,136
10/05/2021,103,3,77,174,251
10/05/2021,112,3,19,60,79
10/05/2021,899,3,68,177,245
10/05/2021,272,3,39,96,135
10/05/2021,934,3,0,12,12
10/05/2021,408,3,42,135,177
10/05/2021,104,3,50,144,194
10/05/2021,264,3,35,55,90
10/05/2021,83,3,133,364,497
10/05/2021,402,3,55,149,204
10/05/2021,688,3,18,84,102
10/05/2021,479,3,7,51,58
10/05/2021,901,3,1,3,4
10/05/2021,535,3,19,73,92
10/05/2021,248,3,48,88,136
10/05/2021,804,3,100,314,414
10/05/2021,486,3,37,119,156
10/05/2021,203,3,30,77,107
10/05/2021,732,3,13,62,75
10/05/2021,410,3,33,177,210
10/05/2021,53,3,46,93,139
10/05/2021,96,3,41,97,138
10/05/2021,339,3,28,91,119
10/05/2021,643,3,43,106,149
10/05/2021,490,3,5,47,52
10/05/2021,327,3,65,184,249
10/05/2021,830,3,160,416,576
10/05/2021,158,3,31,95,126
10/05/2021,386,3,84,234,318
10/05/2021,2,3,21,110,131
10/05/2021,820,3,25,101,126
10/05/2021,818,3,66,198,264
10/05/2021,921,3,0,4,4
10/05/2021,256,3,38,92,130
10/05/2021,757,3,67,139,206
10/05/2021,531,3,33,137,170
10/05/2021,791,3,45,153,198
10/05/2021,441,3,44,142,186
10/05/2021,273,3,50,215,265
10/05/2021,13,3,15,69,84
10/05/2021,640,3,31,77,108
10/05/2021,599,3,116,343,459
10/05/2021,395,3,27,69,96
10/05/2021,468,3,28,102,130
10/05/2021,503,3,20,103,123
10/05/2021,336,3,137,348,485
10/05/2021,405,3,14,49,63
10/05/2021,377,3,39,66,105
10/05/2021,605,3,79,208,287
10/05/2021,283,3,26,76,102
10/05/2021,36,3,30,94,124
10/05/2021,467,3,23,78,101
10/05/2021,529,3,23,113,136
10/05/2021,816,3,89,221,310
10/05/2021,527,3,22,79,101
10/05/2021,739,3,13,47,60
10/05/2021,209,3,21,85,106
10/05/2021,142,3,11,40,51
10/05/2021,167,3,43,154,197
10/05/2021,881,3,1,8,9
10/05/2021,173,3,27,73,100
10/05/2021,496,3,14,37,51
10/05/2021,862,3,47,116,163
10/05/2021,390,3,64,178,242
10/05/2021,394,3,23,68,91
10/05/2021,12,3,9,33,42
10/05/2021,433,3,79,248,327
10/05/2021,307,3,37,147,184
10/05/2021,919,3,35,106,141
10/05/2021,659,3,20,78,98
10/05/2021,639,3,35,68,103
10/05/2021,627,3,29,85,114
10/05/2021,295,3,24,79,103
10/05/2021,85,3,73,84,157
10/05/2021,674,3,16,75,91
10/05/2021,270,3,16,46,62
10/05/2021,554,3,37,69,106
10/05/2021,376,3,17,43,60
10/05/2021,372,3,86,202,288
10/05/2021,35,3,35,121,156
10/05/2021,665,3,21,91,112
10/05/2021,197,3,19,87,106
10/05/2021,551,3,52,147,199
10/05/2021,538,3,29,112,141
10/05/2021,430,3,35,101,136
10/05/2021,113,3,15,59,74
10/05/2021,563,3,26,97,123
10/05/2021,872,3,21,57,78
10/05/2021,650,3,43,136,179
10/05/2021,569,3,35,119,154
10/05/2021,839,3,26,105,131
10/05/2021,575,3,14,56,70
10/05/2021,758,3,36,107,143
10/05/2021,373,3,30,103,133
10/05/2021,137,3,56,186,242
10/05/2021,513,3,24,58,82
10/05/2021,317,3,61,174,235
10/05/2021,148,3,20,67,87
10/05/2021,812,3,17,93,110
10/05/2021,810,3,21,75,96
10/05/2021,63,3,22,72,94
10/05/2021,146,3,84,150,234
10/05/2021,26,3,36,99,135
10/05/2021,576,3,6,12,18
10/05/2021,345,3,26,75,101
10/05/2021,240,3,90,303,393
10/05/2021,116,3,14,61,75
10/05/2021,331,3,30,67,97
10/05/2021,291,3,60,257,317
10/05/2021,81,3,16,45,61
10/05/2021,773,3,33,96,129
10/05/2021,645,3,25,96,121
10/05/2021,351,3,80,218,298
10/05/2021,388,3,55,167,222
10/05/2021,552,3,51,147,198
10/05/2021,771,3,28,127,155
10/05/2021,606,3,43,131,174
10/05/2021,39,3,36,133,169
10/05/2021,930,3,0,6,6
10/05/2021,199,3,18,56,74
10/05/2021,706,3,46,127,173
10/05/2021,412,3,14,89,103
10/05/2021,743,3,17,74,91
10/05/2021,510,3,34,111,145
10/05/2021,45,3,31,107,138
10/05/2021,341,3,128,331,459
10/05/2021,126,3,42,110,152
10/05/2021,102,3,56,205,261
10/05/2021,543,3,154,416,570
10/05/2021,582,3,129,421,550
10/05/2021,134,3,62,143,205
10/05/2021,254,3,16,57,73
10/05/2021,676,3,37,72,109
10/05/2021,592,3,37,125,162
10/05/2021,515,3,11,90,101
10/05/2021,629,3,38,95,133
10/05/2021,282,3,30,73,103
10/05/2021,869,3,67,144,211
10/05/2021,789,3,43,107,150
10/05/2021,419,3,57,208,265
10/05/2021,335,3,29,135,164
10/05/2021,224,3,28,90,118
10/05/2021,207,3,26,86,112
10/05/2021,65,3,35,141,176
10/05/2021,347,3,103,251,354
10/05/2021,20,3,23,49,72
10/05/2021,867,3,31,72,103
10/05/2021,779,3,24,63,87
10/05/2021,130,3,80,173,253
10/05/2021,396,3,21,60,81
10/05/2021,781,3,59,161,220
10/05/2021,122,3,63,104,167
10/05/2021,852,3,68,130,198
10/05/2021,753,3,29,106,135
10/05/2021,615,3,33,91,124
10/05/2021,278,3,29,69,98
10/05/2021,745,3,19,108,127
10/05/2021,700,3,39,105,144
10/05/2021,100,3,52,194,246
10/05/2021,71,3,28,91,119
10/05/2021,89,3,40,152,192
10/05/2021,171,3,10,35,45
10/05/2021,710,3,24,80,104
10/05/2021,370,3,39,132,171
10/05/2021,115,3,16,58,74
10/05/2021,616,3,52,129,181
10/05/2021,428,3,32,94,126
10/05/2021,542,3,62,122,184
10/05/2021,756,3,56,213,269
10/05/2021,344,3,27,77,104
10/05/2021,135,3,66,149,215
10/05/2021,884,3,4,52,56
10/05/2021,68,3,37,148,185
10/05/2021,129,3,64,196,260
10/05/2021,9,3,42,120,162
10/05/2021,933,3,0,3,3
10/05/2021,662,3,58,199,257
10/05/2021,670,3,173,498,671
10/05/2021,898,3,33,41,74
10/05/2021,249,3,112,370,482
10/05/2021,851,3,25,71,96
10/05/2021,348,3,15,74,89
10/05/2021,312,3,30,58,88
10/05/2021,768,3,42,102,144
10/05/2021,397,3,22,65,87
10/05/2021,540,3,52,155,207
10/05/2021,300,3,81,306,387
10/05/2021,833,3,14,48,62
10/05/2021,557,3,24,81,105
10/05/2021,853,3,27,68,95
10/05/2021,48,3,14,53,67
10/05/2021,472,3,64,179,243
10/05/2021,308,3,30,116,146
10/05/2021,509,3,27,131,158
10/05/2021,322,3,29,100,129
10/05/2021,403,3,54,145,199
10/05/2021,764,3,11,30,41
10/05/2021,603,3,76,174,250
10/05/2021,218,3,40,217,257
10/05/2021,58,3,37,160,197
10/05/2021,579,3,15,34,49
10/05/2021,715,3,79,163,242
10/05/2021,438,3,30,87,117
10/05/2021,682,3,19,57,76
10/05/2021,303,3,46,234,280
10/05/2021,546,3,44,124,168
10/05/2021,8,3,50,111,161
10/05/2021,761,3,16,47,63
10/05/2021,471,3,22,94,116
10/05/2021,268,3,57,149,206
10/05/2021,730,3,23,67,90
10/05/2021,447,3,34,110,144
10/05/2021,22,3,28,92,120
10/05/2021,800,3,49,98,147
10/05/2021,619,3,24,45,69
10/05/2021,887,3,0,9,9
10/05/2021,75,3,51,170,221
10/05/2021,215,3,24,60,84
10/05/2021,384,3,40,115,155
10/05/2021,564,3,29,121,150
10/05/2021,349,3,23,87,110
10/05/2021,633,3,11,54,65
10/05/2021,323,3,23,83,106
10/05/2021,544,3,45,110,155
10/05/2021,556,3,84,193,277
10/05/2021,77,3,53,176,229
10/05/2021,219,3,27,78,105
10/05/2021,772,3,44,137,181
10/05/2021,310,3,97,240,337
10/05/2021,861,3,90,157,247
10/05/2021,52,3,48,129,177
10/05/2021,426,3,31,79,110
10/05/2021,227,3,29,101,130
10/05/2021,612,3,71,219,290
10/05/2021,481,3,39,90,129
10/05/2021,691,3,26,103,129
10/05/2021,222,3,23,62,85
10/05/2021,452,3,41,132,173
10/05/2021,275,3,24,114,138
10/05/2021,742,3,28,85,113
10/05/2021,127,3,21,86,107
10/05/2021,326,3,20,49,69
10/05/2021,906,3,5,10,15
10/05/2021,871,3,41,110,151
10/05/2021,297,3,53,221,274
10/05/2021,315,3,12,54,66
10/05/2021,747,3,22,95,117
10/05/2021,720,3,21,56,77
10/05/2021,726,3,19,96,115
10/05/2021,548,3,33,62,95
10/05/2021,649,3,31,85,116
10/05/2021,169,3,25,106,131
10/05/2021,464,3,46,212,258
10/05/2021,204,3,26,48,74
10/05/2021,642,3,39,83,122
10/05/2021,760,3,31,95,126
10/05/2021,139,3,49,153,202
10/05/2021,292,3,76,336,412
10/05/2021,782,3,55,176,231
10/05/2021,72,3,54,203,257
10/05/2021,92,3,46,125,171
10/05/2021,422,3,38,118,156
10/05/2021,202,3,66,212,278
10/05/2021,622,3,96,177,273
10/05/2021,518,3,19,67,86
10/05/2021,754,3,34,152,186
10/05/2021,813,3,23,89,112
10/05/2021,3,3,18,111,129
10/05/2021,581,3,37,108,145
10/05/2021,507,3,41,206,247
10/05/2021,200,3,27,72,99
10/05/2021,555,3,63,168,231
10/05/2021,608,3,84,264,348
10/05/2021,652,3,14,45,59
10/05/2021,119,3,56,175,231
10/05/2021,46,3,20,84,104
10/05/2021,353,3,17,53,70
10/05/2021,809,3,23,86,109
10/05/2021,442,3,33,116,149
10/05/2021,133,3,14,55,69
10/05/2021,444,3,21,131,152
10/05/2021,231,3,39,109,148
10/05/2021,25,3,46,116,162
10/05/2021,591,3,30,73,103
10/05/2021,677,3,16,71,87
10/05/2021,245,3,114,360,474
10/05/2021,792,3,32,86,118
10/05/2021,145,3,39,118,157
10/05/2021,922,3,0,3,3
10/05/2021,448,3,81,302,383
10/05/2021,904,3,50,193,243
10/05/2021,687,3,33,129,162
10/05/2021,793,3,36,127,163
10/05/2021,671,3,31,184,215
10/05/2021,928,3,0,1,1
10/05/2021,41,3,30,120,150
10/05/2021,602,3,96,240,336
10/05/2021,449,3,40,122,162
10/05/2021,722,3,15,57,72
10/05/2021,775,3,21,100,121
10/05/2021,854,3,57,231,288
10/05/2021,392,3,28,67,95
10/05/2021,860,3,32,87,119
10/05/2021,232,3,37,96,133
10/05/2021,885,3,5,53,58
10/05/2021,588,3,27,75,102
10/05/2021,250,3,62,131,193
10/05/2021,429,3,33,160,193
10/05/2021,274,3,1,12,13
10/05/2021,623,3,34,117,151
10/05/2021,767,3,99,168,267
10/05/2021,33,3,45,147,192
10/05/2021,480,3,12,63,75
10/05/2021,108,3,21,66,87
10/05/2021,177,3,20,68,88
10/05/2021,366,3,29,40,69
10/05/2021,120,3,53,105,158
10/05/2021,621,3,30,86,116
10/05/2021,641,3,27,64,91
10/05/2021,494,3,24,66,90
10/05/2021,156,3,27,121,148
10/05/2021,414,3,40,136,176
10/05/2021,562,3,13,37,50
10/05/2021,455,3,23,38,61
10/05/2021,653,3,13,47,60
10/05/2021,828,3,42,105,147
10/05/2021,445,3,38,150,188
10/05/2021,358,3,80,255,335
10/05/2021,741,3,11,55,66
10/05/2021,201,3,27,74,101
10/05/2021,905,3,0,1,1
10/05/2021,343,3,16,85,101
10/05/2021,179,3,26,87,113
10/05/2021,51,3,86,261,347
10/05/2021,417,3,46,183,229
10/05/2021,213,3,44,230,274
10/05/2021,138,3,56,180,236
10/05/2021,128,3,21,91,112
10/05/2021,684,3,33,125,158
10/05/2021,427,3,62,200,262
10/05/2021,266,3,23,93,116
10/05/2021,252,3,28,88,116
10/05/2021,936,3,3,4,7
10/05/2021,321,3,27,70,97
10/05/2021,354,3,3,3,6
10/05/2021,163,3,23,89,112
10/05/2021,875,3,20,75,95
10/05/2021,600,3,109,385,494
10/05/2021,836,3,35,169,204
10/05/2021,909,3,2,11,13
10/05/2021,498,3,9,76,85
10/05/2021,806,3,62,180,242
10/05/2021,4,3,27,106,133
10/05/2021,657,3,68,154,222
10/05/2021,211,3,41,216,257
10/05/2021,669,3,17,75,92
10/05/2021,525,3,33,120,153
10/05/2021,67,3,38,118,156
10/05/2021,560,3,70,174,244
10/05/2021,368,3,42,129,171
10/05/2021,226,3,37,99,136
10/05/2021,437,3,29,132,161
10/05/2021,915,3,0,14,14
10/05/2021,57,3,37,146,183
10/05/2021,152,3,35,104,139
10/05/2021,625,3,31,69,100
10/05/2021,205,3,28,80,108
10/05/2021,533,3,33,77,110
10/05/2021,91,3,36,98,134
10/05/2021,374,3,25,69,94
10/05/2021,435,3,34,99,133
10/05/2021,87,3,57,185,242
10/05/2021,572,3,40,118,158
10/05/2021,631,3,10,33,43
10/05/2021,246,3,109,329,438
10/05/2021,749,3,23,65,88
10/05/2021,737,3,10,52,62
10/05/2021,387,3,46,55,101
10/05/2021,536,3,31,85,116
10/05/2021,367,3,41,135,176
10/05/2021,693,3,17,59,76
10/05/2021,302,3,58,244,302
10/05/2021,914,3,2,1,3
10/05/2021,926,3,3,3,6
10/05/2021,908,3,0,6,6
10/05/2021,727,3,19,72,91
10/05/2021,559,3,71,180,251
10/05/2021,316,3,33,103,136
10/05/2021,5,3,20,108,128
10/05/2021,38,3,32,124,156
10/05/2021,530,3,22,55,77
10/05/2021,679,3,30,90,120
10/05/2021,668,3,17,49,66
10/05/2021,476,3,37,94,131
10/05/2021,407,3,32,170,202
10/05/2021,107,3,77,269,346
10/05/2021,174,3,29,81,110
10/05/2021,290,3,67,276,343
10/05/2021,357,3,71,213,284
10/05/2021,821,3,54,124,178
10/05/2021,330,3,34,157,191
10/05/2021,212,3,45,233,278
10/05/2021,78,3,115,399,514
10/05/2021,493,3,14,73,87
10/05/2021,902,3,32,83,115
10/05/2021,117,3,74,152,226
10/05/2021,210,3,21,85,106
10/05/2021,411,3,47,193,240
10/05/2021,304,3,42,145,187
10/05/2021,807,3,23,80,103
10/05/2021,338,3,42,151,193
10/05/2021,216,3,30,104,134
10/05/2021,86,3,29,80,109
10/05/2021,748,3,39,73,112
10/05/2021,703,3,15,72,87
10/05/2021,263,3,31,102,133
10/05/2021,634,3,40,133,173
10/05/2021,841,3,10,65,75
10/05/2021,487,3,32,69,101
10/05/2021,440,3,29,124,153
10/05/2021,624,3,9,42,51
10/05/2021,511,3,14,73,87
10/05/2021,685,3,20,87,107
10/05/2021,731,3,24,92,116
10/05/2021,369,3,74,202,276
10/05/2021,381,3,1,1,2
10/05/2021,233,3,48,119,167
10/05/2021,583,3,33,105,138
10/05/2021,892,3,11,5,16
10/05/2021,495,3,9,70,79
10/05/2021,261,3,144,444,588
10/05/2021,288,3,14,62,76
10/05/2021,910,3,4,49,53
10/05/2021,359,3,44,105,149
10/05/2021,843,3,14,57,71
10/05/2021,454,3,29,92,121
10/05/2021,328,3,29,95,124
10/05/2021,82,3,51,110,161
11/05/2021,359,3,56,113,169
11/05/2021,261,3,132,432,564
11/05/2021,288,3,15,61,76
11/05/2021,82,3,51,129,180
11/05/2021,843,3,20,59,79
11/05/2021,910,3,3,30,33
11/05/2021,328,3,31,101,132
11/05/2021,495,3,16,91,107
11/05/2021,892,3,10,5,15
11/05/2021,454,3,28,120,148
11/05/2021,256,3,30,101,131
11/05/2021,830,3,163,420,583
11/05/2021,53,3,39,98,137
11/05/2021,486,3,34,148,182
11/05/2021,791,3,44,161,205
11/05/2021,203,3,40,73,113
11/05/2021,2,3,31,96,127
11/05/2021,820,3,21,117,138
11/05/2021,732,3,14,67,81
11/05/2021,339,3,29,120,149
11/05/2021,757,3,67,137,204
11/05/2021,818,3,65,214,279
11/05/2021,921,3,0,5,5
11/05/2021,643,3,36,121,157
11/05/2021,490,3,11,71,82
11/05/2021,410,3,28,174,202
11/05/2021,441,3,72,222,294
11/05/2021,327,3,68,193,261
11/05/2021,96,3,40,119,159
11/05/2021,531,3,29,131,160
11/05/2021,158,3,29,108,137
11/05/2021,386,3,85,289,374
11/05/2021,101,3,48,143,191
11/05/2021,803,3,35,148,183
11/05/2021,99,3,90,247,337
11/05/2021,466,3,35,114,149
11/05/2021,520,3,15,51,66
11/05/2021,485,3,39,103,142
11/05/2021,172,3,21,109,130
11/05/2021,88,3,26,100,126
11/05/2021,815,3,115,366,481
11/05/2021,868,3,77,241,318
11/05/2021,723,3,39,113,152
11/05/2021,334,3,83,210,293
11/05/2021,890,3,4,23,27
11/05/2021,19,3,50,120,170
11/05/2021,64,3,30,69,99
11/05/2021,738,3,33,104,137
11/05/2021,460,3,35,115,150
11/05/2021,924,3,0,4,4
11/05/2021,863,3,29,108,137
11/05/2021,681,3,55,128,183
11/05/2021,918,3,0,7,7
11/05/2021,418,3,25,46,71
11/05/2021,383,3,76,220,296
11/05/2021,900,3,2,2,4
11/05/2021,752,3,41,162,203
11/05/2021,658,3,26,88,114
11/05/2021,632,3,16,32,48
11/05/2021,675,3,41,100,141
11/05/2021,534,3,25,77,102
11/05/2021,235,3,32,145,177
11/05/2021,60,3,15,45,60
11/05/2021,462,3,22,102,124
11/05/2021,251,3,19,95,114
11/05/2021,474,3,26,83,109
11/05/2021,186,3,25,77,102
11/05/2021,399,3,78,203,281
11/05/2021,247,3,76,232,308
11/05/2021,825,3,46,170,216
11/05/2021,436,3,20,131,151
11/05/2021,683,3,25,126,151
11/05/2021,162,3,97,257,354
11/05/2021,269,3,19,87,106
11/05/2021,56,3,37,185,222
11/05/2021,350,3,34,102,136
11/05/2021,15,3,48,115,163
11/05/2021,393,3,20,60,80
11/05/2021,253,3,12,48,60
11/05/2021,512,3,13,43,56
11/05/2021,654,3,31,124,155
11/05/2021,597,3,16,64,80
11/05/2021,192,3,23,74,97
11/05/2021,450,3,11,54,65
11/05/2021,522,3,48,107,155
11/05/2021,784,3,61,211,272
11/05/2021,239,3,48,188,236
11/05/2021,401,3,20,78,98
11/05/2021,790,3,43,151,194
11/05/2021,182,3,21,81,102
11/05/2021,66,3,26,123,149
11/05/2021,267,3,19,97,116
11/05/2021,882,3,0,14,14
11/05/2021,416,3,13,71,84
11/05/2021,491,3,46,167,213
11/05/2021,707,3,47,134,181
11/05/2021,281,3,39,132,171
11/05/2021,446,3,31,130,161
11/05/2021,666,3,41,134,175
11/05/2021,296,3,26,65,91
11/05/2021,874,3,20,105,125
11/05/2021,876,3,0,7,7
11/05/2021,44,3,80,189,269
11/05/2021,577,3,29,134,163
11/05/2021,595,3,32,72,104
11/05/2021,719,3,20,51,71
11/05/2021,532,3,129,425,554
11/05/2021,258,3,123,387,510
11/05/2021,521,3,18,45,63
11/05/2021,539,3,51,129,180
11/05/2021,799,3,8,23,31
11/05/2021,325,3,10,68,78
11/05/2021,873,3,51,135,186
11/05/2021,364,3,64,150,214
11/05/2021,49,3,17,44,61
11/05/2021,284,3,17,46,63
11/05/2021,230,3,34,119,153
11/05/2021,234,3,16,45,61
11/05/2021,787,3,111,303,414
11/05/2021,938,3,0,3,3
11/05/2021,118,3,51,154,205
11/05/2021,734,3,30,79,109
11/05/2021,6,3,31,94,125
11/05/2021,847,3,4,18,22
11/05/2021,553,3,17,24,41
11/05/2021,573,3,28,122,150
11/05/2021,801,3,27,185,212
11/05/2021,23,3,17,46,63
11/05/2021,849,3,36,146,182
11/05/2021,819,3,40,121,161
11/05/2021,379,3,51,183,234
11/05/2021,896,3,175,450,625
11/05/2021,50,3,14,45,59
11/05/2021,470,3,31,125,156
11/05/2021,187,3,23,65,88
11/05/2021,276,3,39,137,176
11/05/2021,777,3,31,93,124
11/05/2021,423,3,61,287,348
11/05/2021,897,3,8,13,21
11/05/2021,305,3,28,152,180
11/05/2021,400,3,18,71,89
11/05/2021,380,3,26,117,143
11/05/2021,696,3,35,112,147
11/05/2021,286,3,18,60,78
11/05/2021,785,3,83,258,341
11/05/2021,238,3,91,313,404
11/05/2021,189,3,30,109,139
11/05/2021,895,3,25,111,136
11/05/2021,570,3,25,111,136
11/05/2021,28,3,23,73,96
11/05/2021,939,3,0,1,1
11/05/2021,526,3,27,84,111
11/05/2021,151,3,17,57,74
11/05/2021,243,3,106,361,467
11/05/2021,184,3,40,102,142
11/05/2021,131,3,43,160,203
11/05/2021,817,3,33,126,159
11/05/2021,190,3,27,111,138
11/05/2021,365,3,39,73,112
11/05/2021,593,3,93,295,388
11/05/2021,342,3,38,107,145
11/05/2021,689,3,34,102,136
11/05/2021,778,3,66,149,215
11/05/2021,271,3,16,77,93
11/05/2021,420,3,99,185,284
11/05/2021,255,3,3,4,7
11/05/2021,259,3,106,335,441
11/05/2021,587,3,8,25,33
11/05/2021,164,3,18,77,95
11/05/2021,561,3,15,64,79
11/05/2021,673,3,44,138,182
11/05/2021,567,3,37,139,176
11/05/2021,721,3,131,447,578
11/05/2021,229,3,68,173,241
11/05/2021,736,3,14,36,50
11/05/2021,90,3,28,89,117
11/05/2021,937,3,1,0,1
11/05/2021,168,3,26,94,120
11/05/2021,159,3,31,127,158
11/05/2021,746,3,25,101,126
11/05/2021,770,3,95,195,290
11/05/2021,27,3,95,182,277
11/05/2021,794,3,75,246,321
11/05/2021,524,3,40,134,174
11/05/2021,713,3,40,316,356
11/05/2021,811,3,27,88,115
11/05/2021,547,3,170,431,601
11/05/2021,149,3,25,98,123
11/05/2021,456,3,20,104,124
11/05/2021,294,3,45,153,198
11/05/2021,699,3,40,117,157
11/05/2021,432,3,22,106,128
11/05/2021,626,3,36,105,141
11/05/2021,285,3,35,82,117
11/05/2021,206,3,5,5,10
11/05/2021,805,3,23,73,96
11/05/2021,34,3,22,110,132
11/05/2021,76,3,40,140,180
11/05/2021,385,3,16,71,87
11/05/2021,143,3,79,160,239
11/05/2021,180,3,39,126,165
11/05/2021,857,3,38,140,178
11/05/2021,84,3,87,211,298
11/05/2021,220,3,21,80,101
11/05/2021,886,3,1,4,5
11/05/2021,750,3,23,123,146
11/05/2021,337,3,13,29,42
11/05/2021,891,3,30,88,118
11/05/2021,313,3,22,56,78
11/05/2021,856,3,56,141,197
11/05/2021,716,3,34,127,161
11/05/2021,911,3,28,128,156
11/05/2021,913,3,2,5,7
11/05/2021,55,3,19,68,87
11/05/2021,508,3,38,147,185
11/05/2021,808,3,81,218,299
11/05/2021,698,3,39,119,158
11/05/2021,319,3,16,61,77
11/05/2021,459,3,39,176,215
11/05/2021,814,3,24,69,93
11/05/2021,301,3,63,284,347
11/05/2021,724,3,149,380,529
11/05/2021,329,3,66,195,261
11/05/2021,844,3,16,59,75
11/05/2021,98,3,61,164,225
11/05/2021,181,3,16,73,89
11/05/2021,299,3,24,96,120
11/05/2021,550,3,54,135,189
11/05/2021,780,3,96,215,311
11/05/2021,614,3,35,111,146
11/05/2021,866,3,38,150,188
11/05/2021,424,3,64,306,370
11/05/2021,638,3,41,138,179
11/05/2021,829,3,42,114,156
11/05/2021,170,3,26,111,137
11/05/2021,11,3,27,121,148
11/05/2021,70,3,37,140,177
11/05/2021,409,3,28,49,77
11/05/2021,717,3,36,136,172
11/05/2021,705,3,13,50,63
11/05/2021,711,3,19,71,90
11/05/2021,105,3,58,125,183
11/05/2021,798,3,76,157,233
11/05/2021,196,3,20,61,81
11/05/2021,125,3,50,100,150
11/05/2021,585,3,73,161,234
11/05/2021,646,3,23,97,120
11/05/2021,166,3,8,59,67
11/05/2021,298,3,84,366,450
11/05/2021,497,3,41,159,200
11/05/2021,774,3,29,102,131
11/05/2021,123,3,23,111,134
11/05/2021,157,3,26,92,118
11/05/2021,7,3,35,103,138
11/05/2021,894,3,40,77,117
11/05/2021,340,3,32,128,160
11/05/2021,601,3,43,116,159
11/05/2021,697,3,39,121,160
11/05/2021,97,3,87,185,272
11/05/2021,656,3,20,28,48
11/05/2021,188,3,33,122,155
11/05/2021,355,3,18,58,76
11/05/2021,859,3,6,9,15
11/05/2021,870,3,17,61,78
11/05/2021,501,3,42,159,201
11/05/2021,733,3,17,90,107
11/05/2021,636,3,13,70,83
11/05/2021,499,3,27,81,108
11/05/2021,80,3,15,40,55
11/05/2021,610,3,54,206,260
11/05/2021,402,3,40,155,195
11/05/2021,804,3,111,325,436
11/05/2021,248,3,44,89,133
11/05/2021,479,3,7,43,50
11/05/2021,272,3,47,98,145
11/05/2021,408,3,43,153,196
11/05/2021,901,3,3,3,6
11/05/2021,899,3,66,166,232
11/05/2021,934,3,1,13,14
11/05/2021,104,3,62,152,214
11/05/2021,688,3,16,82,98
11/05/2021,83,3,123,355,478
11/05/2021,112,3,20,59,79
11/05/2021,535,3,16,68,84
11/05/2021,264,3,38,66,104
11/05/2021,903,3,0,1,1
11/05/2021,398,3,8,18,26
11/05/2021,613,3,13,54,67
11/05/2021,406,3,48,113,161
11/05/2021,69,3,32,109,141
11/05/2021,795,3,36,156,192
11/05/2021,586,3,66,249,315
11/05/2021,504,3,10,24,34
11/05/2021,492,3,13,80,93
11/05/2021,558,3,24,77,101
11/05/2021,93,3,36,212,248
11/05/2021,702,3,21,86,107
11/05/2021,537,3,61,157,218
11/05/2021,175,3,37,101,138
11/05/2021,378,3,27,88,115
11/05/2021,883,3,3,32,35
11/05/2021,477,3,37,80,117
11/05/2021,889,3,0,8,8
11/05/2021,858,3,60,188,248
11/05/2021,311,3,39,126,165
11/05/2021,217,3,49,207,256
11/05/2021,500,3,6,34,40
11/05/2021,907,3,78,211,289
11/05/2021,280,3,14,44,58
11/05/2021,846,3,2,22,24
11/05/2021,356,3,63,180,243
11/05/2021,333,3,34,241,275
11/05/2021,114,3,52,103,155
11/05/2021,637,3,63,174,237
11/05/2021,43,3,44,138,182
11/05/2021,465,3,19,109,128
11/05/2021,360,3,26,154,180
11/05/2021,783,3,58,191,249
11/05/2021,566,3,20,78,98
11/05/2021,293,3,48,210,258
11/05/2021,79,3,22,67,89
11/05/2021,797,3,44,123,167
11/05/2021,712,3,21,75,96
11/05/2021,824,3,63,203,266
11/05/2021,802,3,36,155,191
11/05/2021,195,3,21,57,78
11/05/2021,37,3,26,72,98
11/05/2021,161,3,94,261,355
11/05/2021,95,3,40,166,206
11/05/2021,59,3,25,97,122
11/05/2021,309,3,16,52,68
11/05/2021,244,3,53,112,165
11/05/2021,443,3,37,127,164
11/05/2021,473,3,27,111,138
11/05/2021,488,3,28,90,118
11/05/2021,221,3,19,81,100
11/05/2021,765,3,33,115,148
11/05/2021,154,3,29,148,177
11/05/2021,236,3,33,63,96
11/05/2021,826,3,57,203,260
11/05/2021,47,3,45,94,139
11/05/2021,759,3,15,68,83
11/05/2021,879,3,1,21,22
11/05/2021,18,3,41,83,124
11/05/2021,242,3,90,322,412
11/05/2021,751,3,2,9,11
11/05/2021,704,3,14,64,78
11/05/2021,413,3,43,170,213
11/05/2021,648,3,27,77,104
11/05/2021,153,3,31,148,179
11/05/2021,589,3,32,79,111
11/05/2021,198,3,44,148,192
11/05/2021,17,3,28,87,115
11/05/2021,864,3,37,97,134
11/05/2021,607,3,76,239,315
11/05/2021,147,3,37,100,137
11/05/2021,361,3,66,144,210
11/05/2021,287,3,90,372,462
11/05/2021,332,3,42,120,162
11/05/2021,571,3,24,87,111
11/05/2021,888,3,2,13,15
11/05/2021,776,3,29,114,143
11/05/2021,42,3,19,84,103
11/05/2021,61,3,37,160,197
11/05/2021,185,3,32,109,141
11/05/2021,30,3,44,105,149
11/05/2021,850,3,102,308,410
11/05/2021,842,3,13,15,28
11/05/2021,604,3,73,211,284
11/05/2021,289,3,32,102,134
11/05/2021,124,3,19,86,105
11/05/2021,144,3,41,115,156
11/05/2021,208,3,19,72,91
11/05/2021,31,3,26,117,143
11/05/2021,880,3,1,14,15
11/05/2021,664,3,50,181,231
11/05/2021,845,3,28,105,133
11/05/2021,483,3,46,120,166
11/05/2021,725,3,24,101,125
11/05/2021,363,3,75,148,223
11/05/2021,225,3,35,121,156
11/05/2021,618,3,35,106,141
11/05/2021,346,3,12,61,73
11/05/2021,160,3,4,3,7
11/05/2021,214,3,54,219,273
11/05/2021,94,3,2,0,2
11/05/2021,21,3,48,99,147
11/05/2021,827,3,92,174,266
11/05/2021,103,3,78,192,270
11/05/2021,277,3,37,101,138
11/05/2021,709,3,56,144,200
11/05/2021,32,3,33,84,117
11/05/2021,176,3,42,126,168
11/05/2021,855,3,37,151,188
11/05/2021,389,3,66,214,280
11/05/2021,831,3,40,165,205
11/05/2021,505,3,18,54,72
11/05/2021,837,3,47,181,228
11/05/2021,434,3,12,24,36
11/05/2021,314,3,13,36,49
11/05/2021,835,3,32,161,193
11/05/2021,121,3,150,384,534
11/05/2021,257,3,114,350,464
11/05/2021,680,3,31,82,113
11/05/2021,260,3,133,432,565
11/05/2021,661,3,40,163,203
11/05/2021,694,3,22,88,110
11/05/2021,461,3,24,115,139
11/05/2021,651,3,27,102,129
11/05/2021,425,3,34,158,192
11/05/2021,580,3,28,93,121
11/05/2021,421,3,88,162,250
11/05/2021,517,3,28,68,96
11/05/2021,578,3,16,39,55
11/05/2021,469,3,31,122,153
11/05/2021,24,3,18,46,64
11/05/2021,786,3,43,121,164
11/05/2021,735,3,16,60,76
11/05/2021,155,3,50,122,172
11/05/2021,279,3,46,143,189
11/05/2021,458,3,31,164,195
11/05/2021,478,3,30,13,43
11/05/2021,788,3,106,269,375
11/05/2021,628,3,21,71,92
11/05/2021,528,3,22,58,80
11/05/2021,565,3,85,187,272
11/05/2021,237,3,103,317,420
11/05/2021,318,3,52,185,237
11/05/2021,489,3,5,37,42
11/05/2021,178,3,41,121,162
11/05/2021,54,3,26,61,87
11/05/2021,457,3,30,75,105
11/05/2021,840,3,27,155,182
11/05/2021,635,3,30,109,139
11/05/2021,140,3,15,69,84
11/05/2021,463,3,75,267,342
11/05/2021,655,3,47,190,237
11/05/2021,663,3,33,117,150
11/05/2021,877,3,0,11,11
11/05/2021,453,3,36,131,167
11/05/2021,692,3,25,85,110
11/05/2021,514,3,13,40,53
11/05/2021,391,3,65,213,278
11/05/2021,823,3,25,75,100
11/05/2021,111,3,69,185,254
11/05/2021,701,3,19,85,104
11/05/2021,371,3,27,75,102
11/05/2021,265,3,28,74,102
11/05/2021,1,3,30,97,127
11/05/2021,660,3,21,88,109
11/05/2021,878,3,1,4,5
11/05/2021,932,3,0,1,1
11/05/2021,755,3,56,203,259
11/05/2021,228,3,33,88,121
11/05/2021,106,3,35,161,196
11/05/2021,848,3,48,172,220
11/05/2021,594,3,55,165,220
11/05/2021,183,3,28,94,122
11/05/2021,451,3,94,379,473
11/05/2021,617,3,27,84,111
11/05/2021,917,3,1,13,14
11/05/2021,193,3,31,130,161
11/05/2021,865,3,11,42,53
11/05/2021,262,3,29,63,92
11/05/2021,519,3,44,74,118
11/05/2021,475,3,58,152,210
11/05/2021,404,3,68,225,293
11/05/2021,838,3,11,65,76
11/05/2021,431,3,43,109,152
11/05/2021,484,3,40,102,142
11/05/2021,714,3,33,151,184
11/05/2021,832,3,26,105,131
11/05/2021,584,3,83,295,378
11/05/2021,506,3,43,135,178
11/05/2021,439,3,33,99,132
11/05/2021,352,3,42,134,176
11/05/2021,362,3,70,142,212
11/05/2021,728,3,37,160,197
11/05/2021,574,3,35,133,168
11/05/2021,598,3,100,309,409
11/05/2021,647,3,32,99,131
11/05/2021,382,3,1,15,16
11/05/2021,110,3,29,93,122
11/05/2021,136,3,60,131,191
11/05/2021,686,3,20,92,112
11/05/2021,86,3,26,85,111
11/05/2021,233,3,58,134,192
11/05/2021,511,3,18,61,79
11/05/2021,263,3,40,120,160
11/05/2021,703,3,17,83,100
11/05/2021,634,3,37,130,167
11/05/2021,583,3,26,107,133
11/05/2021,440,3,38,157,195
11/05/2021,841,3,9,43,52
11/05/2021,487,3,34,83,117
11/05/2021,216,3,38,105,143
11/05/2021,624,3,10,36,46
11/05/2021,731,3,30,100,130
11/05/2021,381,3,2,0,2
11/05/2021,369,3,73,208,281
11/05/2021,748,3,35,79,114
11/05/2021,685,3,16,77,93
11/05/2021,861,3,95,172,267
11/05/2021,426,3,37,99,136
11/05/2021,52,3,49,153,202
11/05/2021,691,3,22,119,141
11/05/2021,127,3,20,103,123
11/05/2021,481,3,42,105,147
11/05/2021,612,3,67,217,284
11/05/2021,326,3,19,55,74
11/05/2021,772,3,48,163,211
11/05/2021,742,3,28,96,124
11/05/2021,227,3,35,96,131
11/05/2021,906,3,6,7,13
11/05/2021,275,3,40,125,165
11/05/2021,452,3,47,147,194
11/05/2021,310,3,91,231,322
11/05/2021,222,3,21,77,98
11/05/2021,582,3,116,395,511
11/05/2021,412,3,9,82,91
11/05/2021,510,3,36,117,153
11/05/2021,706,3,49,133,182
11/05/2021,126,3,51,105,156
11/05/2021,39,3,46,141,187
11/05/2021,341,3,134,309,443
11/05/2021,199,3,15,60,75
11/05/2021,102,3,81,210,291
11/05/2021,930,3,1,9,10
11/05/2021,134,3,60,131,191
11/05/2021,45,3,26,116,142
11/05/2021,543,3,159,417,576
11/05/2021,743,3,19,72,91
11/05/2021,197,3,24,84,108
11/05/2021,627,3,28,92,120
11/05/2021,85,3,61,88,149
11/05/2021,372,3,88,188,276
11/05/2021,270,3,15,57,72
11/05/2021,35,3,30,135,165
11/05/2021,659,3,28,76,104
11/05/2021,919,3,37,120,157
11/05/2021,295,3,19,87,106
11/05/2021,674,3,14,69,83
11/05/2021,665,3,27,96,123
11/05/2021,307,3,34,171,205
11/05/2021,639,3,34,84,118
11/05/2021,554,3,45,85,130
11/05/2021,376,3,16,45,61
11/05/2021,377,3,43,82,125
11/05/2021,605,3,79,227,306
11/05/2021,336,3,147,356,503
11/05/2021,503,3,26,108,134
11/05/2021,395,3,29,77,106
11/05/2021,36,3,24,111,135
11/05/2021,405,3,14,43,57
11/05/2021,13,3,15,84,99
11/05/2021,273,3,42,236,278
11/05/2021,468,3,34,120,154
11/05/2021,283,3,29,84,113
11/05/2021,599,3,101,327,428
11/05/2021,640,3,28,92,120
11/05/2021,739,3,18,54,72
11/05/2021,390,3,68,237,305
11/05/2021,862,3,51,139,190
11/05/2021,496,3,12,40,52
11/05/2021,527,3,25,88,113
11/05/2021,209,3,11,72,83
11/05/2021,12,3,14,40,54
11/05/2021,394,3,28,79,107
11/05/2021,167,3,37,162,199
11/05/2021,142,3,12,42,54
11/05/2021,467,3,20,99,119
11/05/2021,881,3,0,7,7
11/05/2021,529,3,30,120,150
11/05/2021,816,3,84,218,302
11/05/2021,173,3,27,82,109
11/05/2021,433,3,83,274,357
11/05/2021,81,3,15,43,58
11/05/2021,351,3,75,227,302
11/05/2021,773,3,28,108,136
11/05/2021,645,3,25,91,116
11/05/2021,388,3,57,217,274
11/05/2021,116,3,15,51,66
11/05/2021,291,3,56,279,335
11/05/2021,331,3,30,85,115
11/05/2021,552,3,56,157,213
11/05/2021,606,3,40,128,168
11/05/2021,771,3,24,122,146
11/05/2021,758,3,47,100,147
11/05/2021,551,3,56,164,220
11/05/2021,538,3,33,117,150
11/05/2021,839,3,26,128,154
11/05/2021,563,3,30,95,125
11/05/2021,650,3,36,160,196
11/05/2021,137,3,45,166,211
11/05/2021,569,3,31,128,159
11/05/2021,113,3,26,61,87
11/05/2021,575,3,19,49,68
11/05/2021,430,3,36,121,157
11/05/2021,872,3,16,55,71
11/05/2021,373,3,36,104,140
11/05/2021,146,3,83,163,246
11/05/2021,810,3,37,116,153
11/05/2021,345,3,21,74,95
11/05/2021,812,3,24,91,115
11/05/2021,513,3,21,57,78
11/05/2021,576,3,6,17,23
11/05/2021,317,3,63,169,232
11/05/2021,63,3,20,79,99
11/05/2021,148,3,17,62,79
11/05/2021,240,3,95,324,419
11/05/2021,26,3,42,126,168
11/05/2021,619,3,19,69,88
11/05/2021,887,3,1,12,13
11/05/2021,384,3,42,135,177
11/05/2021,77,3,50,175,225
11/05/2021,544,3,44,114,158
11/05/2021,633,3,12,56,68
11/05/2021,219,3,33,88,121
11/05/2021,564,3,37,127,164
11/05/2021,75,3,50,173,223
11/05/2021,215,3,23,58,81
11/05/2021,323,3,20,68,88
11/05/2021,556,3,87,186,273
11/05/2021,349,3,25,80,105
11/05/2021,756,3,52,220,272
11/05/2021,135,3,61,138,199
11/05/2021,344,3,38,70,108
11/05/2021,68,3,39,179,218
11/05/2021,9,3,42,140,182
11/05/2021,129,3,58,177,235
11/05/2021,428,3,32,105,137
11/05/2021,662,3,62,245,307
11/05/2021,884,3,3,33,36
11/05/2021,542,3,72,134,206
11/05/2021,933,3,0,1,1
11/05/2021,115,3,17,59,76
11/05/2021,616,3,55,151,206
11/05/2021,676,3,33,76,109
11/05/2021,20,3,26,56,82
11/05/2021,130,3,73,162,235
11/05/2021,335,3,28,151,179
11/05/2021,224,3,33,91,124
11/05/2021,515,3,19,107,126
11/05/2021,419,3,50,219,269
11/05/2021,592,3,35,114,149
11/05/2021,869,3,66,144,210
11/05/2021,347,3,104,260,364
11/05/2021,396,3,24,60,84
11/05/2021,781,3,63,162,225
11/05/2021,254,3,21,68,89
11/05/2021,282,3,34,111,145
11/05/2021,65,3,31,158,189
11/05/2021,779,3,22,71,93
11/05/2021,629,3,30,106,136
11/05/2021,207,3,25,91,116
11/05/2021,789,3,41,131,172
11/05/2021,867,3,33,83,116
11/05/2021,753,3,28,118,146
11/05/2021,89,3,46,172,218
11/05/2021,278,3,36,99,135
11/05/2021,852,3,69,150,219
11/05/2021,745,3,27,110,137
11/05/2021,370,3,34,145,179
11/05/2021,700,3,39,122,161
11/05/2021,71,3,24,98,122
11/05/2021,710,3,22,75,97
11/05/2021,171,3,12,32,44
11/05/2021,122,3,68,120,188
11/05/2021,100,3,76,211,287
11/05/2021,615,3,43,82,125
11/05/2021,800,3,55,118,173
11/05/2021,22,3,32,100,132
11/05/2021,682,3,15,44,59
11/05/2021,8,3,53,114,167
11/05/2021,303,3,61,234,295
11/05/2021,447,3,36,119,155
11/05/2021,268,3,55,173,228
11/05/2021,471,3,28,107,135
11/05/2021,761,3,16,41,57
11/05/2021,546,3,52,145,197
11/05/2021,730,3,13,77,90
11/05/2021,853,3,26,80,106
11/05/2021,851,3,20,88,108
11/05/2021,540,3,56,167,223
11/05/2021,898,3,37,51,88
11/05/2021,249,3,119,382,501
11/05/2021,768,3,42,102,144
11/05/2021,348,3,12,84,96
11/05/2021,48,3,14,50,64
11/05/2021,397,3,24,60,84
11/05/2021,670,3,176,486,662
11/05/2021,833,3,21,52,73
11/05/2021,300,3,77,326,403
11/05/2021,557,3,30,92,122
11/05/2021,312,3,25,68,93
11/05/2021,308,3,27,141,168
11/05/2021,438,3,39,99,138
11/05/2021,715,3,80,166,246
11/05/2021,579,3,20,30,50
11/05/2021,218,3,53,217,270
11/05/2021,322,3,29,93,122
11/05/2021,603,3,80,191,271
11/05/2021,509,3,30,131,161
11/05/2021,764,3,10,28,38
11/05/2021,403,3,44,154,198
11/05/2021,472,3,70,235,305
11/05/2021,58,3,34,158,192
11/05/2021,330,3,38,168,206
11/05/2021,117,3,71,171,242
11/05/2021,210,3,17,83,100
11/05/2021,411,3,45,198,243
11/05/2021,902,3,36,94,130
11/05/2021,78,3,117,394,511
11/05/2021,807,3,28,75,103
11/05/2021,338,3,36,181,217
11/05/2021,304,3,32,162,194
11/05/2021,212,3,62,236,298
11/05/2021,493,3,18,91,109
11/05/2021,138,3,45,154,199
11/05/2021,417,3,43,185,228
11/05/2021,266,3,21,93,114
11/05/2021,600,3,113,394,507
11/05/2021,909,3,1,11,12
11/05/2021,836,3,30,174,204
11/05/2021,684,3,35,132,167
11/05/2021,128,3,19,108,127
11/05/2021,213,3,56,230,286
11/05/2021,252,3,33,97,130
11/05/2021,51,3,80,245,325
11/05/2021,427,3,73,249,322
11/05/2021,936,3,1,4,5
11/05/2021,163,3,22,110,132
11/05/2021,875,3,24,82,106
11/05/2021,321,3,26,64,90
11/05/2021,354,3,4,0,4
11/05/2021,904,3,41,178,219
11/05/2021,145,3,26,144,170
11/05/2021,119,3,53,154,207
11/05/2021,25,3,31,144,175
11/05/2021,591,3,34,85,119
11/05/2021,555,3,68,166,234
11/05/2021,245,3,122,370,492
11/05/2021,353,3,12,44,56
11/05/2021,687,3,33,133,166
11/05/2021,677,3,16,71,87
11/05/2021,652,3,17,68,85
11/05/2021,133,3,14,51,65
11/05/2021,448,3,96,343,439
11/05/2021,231,3,43,140,183
11/05/2021,507,3,44,217,261
11/05/2021,608,3,85,258,343
11/05/2021,809,3,23,91,114
11/05/2021,442,3,34,118,152
11/05/2021,444,3,23,163,186
11/05/2021,200,3,24,81,105
11/05/2021,46,3,26,85,111
11/05/2021,792,3,27,94,121
11/05/2021,581,3,43,123,166
11/05/2021,922,3,0,4,4
11/05/2021,169,3,22,111,133
11/05/2021,747,3,24,86,110
11/05/2021,871,3,42,104,146
11/05/2021,315,3,7,47,54
11/05/2021,726,3,25,111,136
11/05/2021,548,3,27,68,95
11/05/2021,720,3,23,64,87
11/05/2021,649,3,29,86,115
11/05/2021,297,3,48,239,287
11/05/2021,422,3,36,113,149
11/05/2021,622,3,91,184,275
11/05/2021,518,3,22,83,105
11/05/2021,139,3,37,141,178
11/05/2021,642,3,33,96,129
11/05/2021,204,3,26,54,80
11/05/2021,3,3,27,97,124
11/05/2021,72,3,49,203,252
11/05/2021,292,3,71,347,418
11/05/2021,760,3,40,92,132
11/05/2021,464,3,53,221,274
11/05/2021,754,3,33,168,201
11/05/2021,813,3,29,89,118
11/05/2021,92,3,47,130,177
11/05/2021,782,3,61,175,236
11/05/2021,202,3,66,230,296
11/05/2021,358,3,75,238,313
11/05/2021,562,3,19,48,67
11/05/2021,343,3,21,86,107
11/05/2021,156,3,39,139,178
11/05/2021,741,3,13,52,65
11/05/2021,621,3,38,109,147
11/05/2021,494,3,18,73,91
11/05/2021,414,3,44,155,199
11/05/2021,653,3,16,61,77
11/05/2021,641,3,23,78,101
11/05/2021,179,3,31,87,118
11/05/2021,455,3,30,58,88
11/05/2021,445,3,36,194,230
11/05/2021,201,3,23,87,110
11/05/2021,828,3,46,112,158
11/05/2021,41,3,37,117,154
11/05/2021,793,3,33,152,185
11/05/2021,671,3,41,188,229
11/05/2021,775,3,23,107,130
11/05/2021,928,3,0,1,1
11/05/2021,602,3,94,270,364
11/05/2021,722,3,18,57,75
11/05/2021,449,3,52,142,194
11/05/2021,120,3,61,119,180
11/05/2021,366,3,35,48,83
11/05/2021,108,3,20,72,92
11/05/2021,177,3,27,64,91
11/05/2021,885,3,4,33,37
11/05/2021,480,3,14,59,73
11/05/2021,429,3,33,196,229
11/05/2021,588,3,33,78,111
11/05/2021,274,3,0,10,10
11/05/2021,232,3,41,125,166
11/05/2021,854,3,70,270,340
11/05/2021,623,3,35,122,157
11/05/2021,767,3,91,187,278
11/05/2021,392,3,31,75,106
11/05/2021,860,3,26,94,120
11/05/2021,250,3,62,132,194
11/05/2021,33,3,33,136,169
11/05/2021,290,3,63,299,362
11/05/2021,476,3,38,97,135
11/05/2021,5,3,29,94,123
11/05/2021,357,3,65,189,254
11/05/2021,679,3,39,112,151
11/05/2021,668,3,11,53,64
11/05/2021,407,3,26,178,204
11/05/2021,174,3,31,79,110
11/05/2021,107,3,92,274,366
11/05/2021,38,3,41,128,169
11/05/2021,821,3,58,113,171
11/05/2021,530,3,21,60,81
11/05/2021,316,3,33,131,164
11/05/2021,559,3,76,178,254
11/05/2021,87,3,64,231,295
11/05/2021,246,3,117,347,464
11/05/2021,737,3,11,46,57
11/05/2021,533,3,31,83,114
11/05/2021,749,3,23,112,135
11/05/2021,625,3,35,85,120
11/05/2021,374,3,26,63,89
11/05/2021,631,3,13,29,42
11/05/2021,91,3,27,122,149
11/05/2021,205,3,26,78,104
11/05/2021,435,3,28,100,128
11/05/2021,572,3,34,122,156
11/05/2021,368,3,36,146,182
11/05/2021,657,3,73,168,241
11/05/2021,4,3,19,109,128
11/05/2021,915,3,1,14,15
11/05/2021,806,3,58,238,296
11/05/2021,226,3,41,122,163
11/05/2021,211,3,54,215,269
11/05/2021,560,3,72,170,242
11/05/2021,525,3,35,128,163
11/05/2021,57,3,37,172,209
11/05/2021,67,3,35,151,186
11/05/2021,437,3,29,176,205
11/05/2021,669,3,16,71,87
11/05/2021,152,3,41,106,147
11/05/2021,498,3,16,93,109
11/05/2021,914,3,2,3,5
11/05/2021,367,3,35,145,180
11/05/2021,387,3,43,111,154
11/05/2021,727,3,15,66,81
11/05/2021,908,3,0,5,5
11/05/2021,302,3,57,268,325
11/05/2021,693,3,18,73,91
11/05/2021,926,3,3,4,7
11/05/2021,536,3,28,75,103
12/05/2021,302,3,53,293,346
12/05/2021,926,3,4,5,9
12/05/2021,693,3,18,77,95
12/05/2021,387,3,38,84,122
12/05/2021,908,3,0,6,6
12/05/2021,727,3,19,92,111
12/05/2021,914,3,4,5,9
12/05/2021,536,3,37,69,106
12/05/2021,367,3,35,144,179
12/05/2021,451,3,94,376,470
12/05/2021,228,3,37,84,121
12/05/2021,475,3,55,151,206
12/05/2021,262,3,35,68,103
12/05/2021,755,3,46,204,250
12/05/2021,183,3,27,101,128
12/05/2021,932,3,0,2,2
12/05/2021,106,3,32,175,207
12/05/2021,617,3,29,87,116
12/05/2021,193,3,21,136,157
12/05/2021,865,3,11,48,59
12/05/2021,917,3,0,9,9
12/05/2021,594,3,42,163,205
12/05/2021,519,3,37,85,122
12/05/2021,848,3,52,164,216
12/05/2021,711,3,19,89,108
12/05/2021,70,3,44,155,199
12/05/2021,11,3,35,138,173
12/05/2021,409,3,22,54,76
12/05/2021,638,3,42,169,211
12/05/2021,424,3,65,305,370
12/05/2021,829,3,36,103,139
12/05/2021,866,3,35,147,182
12/05/2021,614,3,34,113,147
12/05/2021,717,3,36,136,172
12/05/2021,170,3,23,112,135
12/05/2021,780,3,91,229,320
12/05/2021,705,3,9,60,69
12/05/2021,532,3,117,433,550
12/05/2021,874,3,26,129,155
12/05/2021,577,3,26,128,154
12/05/2021,44,3,85,218,303
12/05/2021,595,3,36,73,109
12/05/2021,876,3,0,7,7
12/05/2021,719,3,16,62,78
12/05/2021,738,3,27,92,119
12/05/2021,88,3,25,96,121
12/05/2021,868,3,69,254,323
12/05/2021,101,3,47,118,165
12/05/2021,99,3,94,281,375
12/05/2021,815,3,121,357,478
12/05/2021,485,3,33,103,136
12/05/2021,803,3,27,146,173
12/05/2021,334,3,73,209,282
12/05/2021,460,3,29,121,150
12/05/2021,172,3,20,108,128
12/05/2021,520,3,14,66,80
12/05/2021,723,3,39,130,169
12/05/2021,466,3,36,137,173
12/05/2021,64,3,30,71,101
12/05/2021,19,3,43,138,181
12/05/2021,890,3,6,27,33
12/05/2021,910,3,3,47,50
12/05/2021,82,3,52,141,193
12/05/2021,843,3,21,71,92
12/05/2021,288,3,17,63,80
12/05/2021,359,3,46,129,175
12/05/2021,454,3,26,111,137
12/05/2021,892,3,11,5,16
12/05/2021,328,3,26,97,123
12/05/2021,261,3,122,441,563
12/05/2021,495,3,16,84,100
12/05/2021,53,3,42,97,139
12/05/2021,441,3,72,243,315
12/05/2021,818,3,61,219,280
12/05/2021,339,3,28,117,145
12/05/2021,386,3,90,264,354
12/05/2021,531,3,29,139,168
12/05/2021,791,3,39,179,218
12/05/2021,732,3,16,58,74
12/05/2021,203,3,34,83,117
12/05/2021,158,3,24,100,124
12/05/2021,256,3,32,86,118
12/05/2021,410,3,27,150,177
12/05/2021,327,3,65,198,263
12/05/2021,643,3,40,121,161
12/05/2021,921,3,0,3,3
12/05/2021,2,3,27,105,132
12/05/2021,490,3,15,62,77
12/05/2021,757,3,60,151,211
12/05/2021,820,3,22,114,136
12/05/2021,830,3,159,417,576
12/05/2021,486,3,32,136,168
12/05/2021,96,3,43,103,146
12/05/2021,522,3,51,105,156
12/05/2021,182,3,22,95,117
12/05/2021,446,3,27,158,185
12/05/2021,666,3,27,137,164
12/05/2021,281,3,29,132,161
12/05/2021,296,3,34,76,110
12/05/2021,267,3,26,109,135
12/05/2021,784,3,73,232,305
12/05/2021,707,3,36,132,168
12/05/2021,401,3,14,84,98
12/05/2021,66,3,27,131,158
12/05/2021,239,3,49,191,240
12/05/2021,416,3,17,60,77
12/05/2021,450,3,12,56,68
12/05/2021,790,3,35,144,179
12/05/2021,491,3,48,200,248
12/05/2021,882,3,0,26,26
12/05/2021,675,3,36,117,153
12/05/2021,924,3,0,3,3
12/05/2021,752,3,34,158,192
12/05/2021,658,3,18,97,115
12/05/2021,418,3,20,43,63
12/05/2021,235,3,26,174,200
12/05/2021,863,3,30,100,130
12/05/2021,681,3,49,141,190
12/05/2021,534,3,23,90,113
12/05/2021,60,3,11,49,60
12/05/2021,383,3,72,256,328
12/05/2021,632,3,12,36,48
12/05/2021,900,3,0,2,2
12/05/2021,918,3,0,3,3
12/05/2021,436,3,22,153,175
12/05/2021,474,3,25,88,113
12/05/2021,15,3,43,122,165
12/05/2021,56,3,37,188,225
12/05/2021,512,3,8,41,49
12/05/2021,247,3,69,238,307
12/05/2021,162,3,107,250,357
12/05/2021,269,3,22,97,119
12/05/2021,683,3,25,128,153
12/05/2021,399,3,64,215,279
12/05/2021,462,3,22,106,128
12/05/2021,393,3,17,72,89
12/05/2021,192,3,14,77,91
12/05/2021,825,3,43,166,209
12/05/2021,597,3,17,74,91
12/05/2021,253,3,12,61,73
12/05/2021,654,3,27,112,139
12/05/2021,350,3,29,119,148
12/05/2021,251,3,15,102,117
12/05/2021,186,3,26,80,106
12/05/2021,844,3,17,57,74
12/05/2021,337,3,15,31,46
12/05/2021,98,3,63,170,233
12/05/2021,856,3,49,150,199
12/05/2021,299,3,21,96,117
12/05/2021,508,3,35,166,201
12/05/2021,891,3,29,102,131
12/05/2021,724,3,153,358,511
12/05/2021,329,3,64,199,263
12/05/2021,459,3,35,196,231
12/05/2021,698,3,42,112,154
12/05/2021,911,3,32,167,199
12/05/2021,301,3,61,313,374
12/05/2021,313,3,18,64,82
12/05/2021,814,3,16,69,85
12/05/2021,716,3,35,124,159
12/05/2021,550,3,50,136,186
12/05/2021,181,3,22,81,103
12/05/2021,913,3,3,6,9
12/05/2021,55,3,12,77,89
12/05/2021,319,3,16,71,87
12/05/2021,808,3,86,245,331
12/05/2021,276,3,29,136,165
12/05/2021,187,3,25,63,88
12/05/2021,238,3,89,303,392
12/05/2021,777,3,35,73,108
12/05/2021,897,3,7,14,21
12/05/2021,423,3,62,291,353
12/05/2021,895,3,29,119,148
12/05/2021,380,3,29,146,175
12/05/2021,696,3,23,116,139
12/05/2021,28,3,19,95,114
12/05/2021,570,3,18,104,122
12/05/2021,189,3,30,107,137
12/05/2021,400,3,15,82,97
12/05/2021,785,3,87,266,353
12/05/2021,305,3,26,173,199
12/05/2021,286,3,15,59,74
12/05/2021,734,3,30,62,92
12/05/2021,923,3,0,1,1
12/05/2021,118,3,58,158,216
12/05/2021,521,3,20,45,65
12/05/2021,539,3,46,124,170
12/05/2021,364,3,70,150,220
12/05/2021,873,3,38,145,183
12/05/2021,258,3,110,404,514
12/05/2021,284,3,12,51,63
12/05/2021,49,3,15,51,66
12/05/2021,234,3,21,47,68
12/05/2021,799,3,8,24,32
12/05/2021,6,3,27,102,129
12/05/2021,325,3,11,60,71
12/05/2021,230,3,25,113,138
12/05/2021,787,3,114,336,450
12/05/2021,925,3,0,1,1
12/05/2021,573,3,23,110,133
12/05/2021,50,3,13,52,65
12/05/2021,801,3,28,192,220
12/05/2021,23,3,19,35,54
12/05/2021,896,3,176,436,612
12/05/2021,379,3,52,187,239
12/05/2021,849,3,33,154,187
12/05/2021,553,3,25,24,49
12/05/2021,470,3,34,121,155
12/05/2021,819,3,46,127,173
12/05/2021,847,3,0,18,18
12/05/2021,699,3,35,118,153
12/05/2021,206,3,7,8,15
12/05/2021,34,3,20,118,138
12/05/2021,857,3,40,124,164
12/05/2021,805,3,29,83,112
12/05/2021,84,3,96,206,302
12/05/2021,886,3,0,7,7
12/05/2021,432,3,24,112,136
12/05/2021,76,3,50,164,214
12/05/2021,143,3,68,169,237
12/05/2021,180,3,27,129,156
12/05/2021,285,3,30,77,107
12/05/2021,626,3,30,110,140
12/05/2021,294,3,33,144,177
12/05/2021,385,3,18,94,112
12/05/2021,750,3,18,125,143
12/05/2021,220,3,23,87,110
12/05/2021,420,3,94,200,294
12/05/2021,243,3,100,353,453
12/05/2021,342,3,29,103,132
12/05/2021,365,3,34,66,100
12/05/2021,778,3,53,140,193
12/05/2021,131,3,52,158,210
12/05/2021,593,3,80,292,372
12/05/2021,255,3,4,6,10
12/05/2021,184,3,36,105,141
12/05/2021,259,3,102,353,455
12/05/2021,689,3,26,95,121
12/05/2021,151,3,19,78,97
12/05/2021,817,3,27,123,150
12/05/2021,190,3,24,116,140
12/05/2021,526,3,33,91,124
12/05/2021,271,3,24,91,115
12/05/2021,794,3,69,252,321
12/05/2021,164,3,19,78,97
12/05/2021,561,3,10,63,73
12/05/2021,149,3,22,105,127
12/05/2021,27,3,92,199,291
12/05/2021,746,3,20,108,128
12/05/2021,229,3,55,181,236
12/05/2021,587,3,5,33,38
12/05/2021,567,3,30,127,157
12/05/2021,673,3,35,144,179
12/05/2021,547,3,169,423,592
12/05/2021,736,3,13,36,49
12/05/2021,770,3,87,216,303
12/05/2021,713,3,43,323,366
12/05/2021,168,3,29,124,153
12/05/2021,811,3,24,96,120
12/05/2021,524,3,34,137,171
12/05/2021,721,3,116,457,573
12/05/2021,159,3,36,128,164
12/05/2021,456,3,21,124,145
12/05/2021,90,3,37,97,134
12/05/2021,371,3,21,78,99
12/05/2021,111,3,60,172,232
12/05/2021,265,3,37,83,120
12/05/2021,878,3,1,9,10
12/05/2021,391,3,63,167,230
12/05/2021,1,3,27,104,131
12/05/2021,660,3,16,89,105
12/05/2021,701,3,17,95,112
12/05/2021,514,3,10,41,51
12/05/2021,823,3,31,64,95
12/05/2021,751,3,3,12,15
12/05/2021,154,3,26,165,191
12/05/2021,879,3,0,22,22
12/05/2021,221,3,21,89,110
12/05/2021,765,3,30,123,153
12/05/2021,759,3,16,62,78
12/05/2021,242,3,89,312,401
12/05/2021,488,3,32,75,107
12/05/2021,704,3,11,72,83
12/05/2021,18,3,36,95,131
12/05/2021,47,3,42,104,146
12/05/2021,826,3,59,165,224
12/05/2021,236,3,33,87,120
12/05/2021,899,3,61,178,239
12/05/2021,248,3,44,88,132
12/05/2021,688,3,21,101,122
12/05/2021,901,3,1,3,4
12/05/2021,264,3,42,67,109
12/05/2021,112,3,22,58,80
12/05/2021,804,3,98,318,416
12/05/2021,408,3,37,163,200
12/05/2021,535,3,21,88,109
12/05/2021,402,3,44,170,214
12/05/2021,479,3,8,52,60
12/05/2021,83,3,129,334,463
12/05/2021,272,3,40,115,155
12/05/2021,104,3,71,166,237
12/05/2021,934,3,0,12,12
12/05/2021,123,3,27,115,142
12/05/2021,105,3,69,131,200
12/05/2021,196,3,13,73,86
12/05/2021,646,3,25,103,128
12/05/2021,497,3,47,197,244
12/05/2021,125,3,49,103,152
12/05/2021,166,3,10,57,67
12/05/2021,774,3,29,123,152
12/05/2021,798,3,65,167,232
12/05/2021,585,3,60,180,240
12/05/2021,298,3,81,375,456
12/05/2021,157,3,25,94,119
12/05/2021,7,3,28,108,136
12/05/2021,355,3,10,50,60
12/05/2021,601,3,47,107,154
12/05/2021,188,3,27,123,150
12/05/2021,501,3,46,192,238
12/05/2021,499,3,23,89,112
12/05/2021,97,3,92,221,313
12/05/2021,656,3,9,36,45
12/05/2021,636,3,21,64,85
12/05/2021,894,3,36,86,122
12/05/2021,80,3,15,44,59
12/05/2021,697,3,43,110,153
12/05/2021,340,3,32,127,159
12/05/2021,733,3,14,79,93
12/05/2021,610,3,63,226,289
12/05/2021,870,3,23,62,85
12/05/2021,859,3,7,8,15
12/05/2021,37,3,30,90,120
12/05/2021,59,3,32,93,125
12/05/2021,473,3,23,110,133
12/05/2021,802,3,38,164,202
12/05/2021,95,3,37,163,200
12/05/2021,443,3,33,131,164
12/05/2021,244,3,50,136,186
12/05/2021,195,3,14,66,80
12/05/2021,309,3,15,52,67
12/05/2021,161,3,104,254,358
12/05/2021,398,3,4,20,24
12/05/2021,702,3,20,104,124
12/05/2021,378,3,21,100,121
12/05/2021,883,3,3,58,61
12/05/2021,586,3,58,257,315
12/05/2021,477,3,26,85,111
12/05/2021,406,3,44,120,164
12/05/2021,795,3,37,170,207
12/05/2021,558,3,23,81,104
12/05/2021,504,3,13,41,54
12/05/2021,613,3,13,59,72
12/05/2021,858,3,62,178,240
12/05/2021,903,3,0,1,1
12/05/2021,537,3,46,146,192
12/05/2021,175,3,32,106,138
12/05/2021,492,3,12,69,81
12/05/2021,69,3,29,114,143
12/05/2021,889,3,1,3,4
12/05/2021,93,3,29,238,267
12/05/2021,797,3,55,127,182
12/05/2021,43,3,40,149,189
12/05/2021,846,3,2,20,22
12/05/2021,360,3,29,159,188
12/05/2021,356,3,64,209,273
12/05/2021,783,3,52,190,242
12/05/2021,114,3,56,115,171
12/05/2021,712,3,19,90,109
12/05/2021,79,3,21,72,93
12/05/2021,293,3,45,215,260
12/05/2021,566,3,19,87,106
12/05/2021,824,3,60,216,276
12/05/2021,333,3,35,246,281
12/05/2021,907,3,63,224,287
12/05/2021,280,3,9,38,47
12/05/2021,465,3,16,119,135
12/05/2021,217,3,39,213,252
12/05/2021,637,3,63,177,240
12/05/2021,311,3,31,118,149
12/05/2021,500,3,5,27,32
12/05/2021,840,3,24,175,199
12/05/2021,655,3,44,197,241
12/05/2021,692,3,17,83,100
12/05/2021,457,3,25,76,101
12/05/2021,635,3,29,110,139
12/05/2021,453,3,39,160,199
12/05/2021,663,3,28,120,148
12/05/2021,877,3,1,20,21
12/05/2021,463,3,70,272,342
12/05/2021,140,3,18,73,91
12/05/2021,880,3,0,13,13
12/05/2021,664,3,46,182,228
12/05/2021,618,3,27,100,127
12/05/2021,827,3,85,185,270
12/05/2021,725,3,23,98,121
12/05/2021,225,3,29,128,157
12/05/2021,845,3,29,107,136
12/05/2021,363,3,77,140,217
12/05/2021,483,3,41,123,164
12/05/2021,94,3,2,0,2
12/05/2021,346,3,10,64,74
12/05/2021,214,3,43,223,266
12/05/2021,160,3,3,5,8
12/05/2021,21,3,42,109,151
12/05/2021,208,3,22,63,85
12/05/2021,31,3,28,106,134
12/05/2021,589,3,29,90,119
12/05/2021,571,3,19,86,105
12/05/2021,864,3,27,96,123
12/05/2021,147,3,38,115,153
12/05/2021,332,3,40,124,164
12/05/2021,648,3,23,79,102
12/05/2021,153,3,27,167,194
12/05/2021,607,3,78,265,343
12/05/2021,361,3,69,140,209
12/05/2021,42,3,26,105,131
12/05/2021,287,3,89,392,481
12/05/2021,17,3,23,103,126
12/05/2021,776,3,25,124,149
12/05/2021,413,3,35,161,196
12/05/2021,888,3,0,11,11
12/05/2021,198,3,36,142,178
12/05/2021,144,3,38,128,166
12/05/2021,850,3,106,295,401
12/05/2021,289,3,37,111,148
12/05/2021,61,3,34,165,199
12/05/2021,124,3,22,89,111
12/05/2021,604,3,63,209,272
12/05/2021,185,3,28,111,139
12/05/2021,842,3,10,15,25
12/05/2021,30,3,46,104,150
12/05/2021,458,3,33,185,218
12/05/2021,178,3,38,109,147
12/05/2021,786,3,47,142,189
12/05/2021,478,3,28,12,40
12/05/2021,279,3,36,146,182
12/05/2021,565,3,83,193,276
12/05/2021,528,3,26,53,79
12/05/2021,788,3,113,310,423
12/05/2021,155,3,48,139,187
12/05/2021,318,3,55,216,271
12/05/2021,628,3,24,61,85
12/05/2021,489,3,7,30,37
12/05/2021,237,3,92,308,400
12/05/2021,54,3,20,60,80
12/05/2021,735,3,14,50,64
12/05/2021,103,3,72,194,266
12/05/2021,277,3,39,86,125
12/05/2021,837,3,50,190,240
12/05/2021,257,3,100,368,468
12/05/2021,855,3,42,191,233
12/05/2021,389,3,61,174,235
12/05/2021,434,3,10,30,40
12/05/2021,505,3,18,59,77
12/05/2021,176,3,38,120,158
12/05/2021,314,3,11,47,58
12/05/2021,835,3,33,167,200
12/05/2021,709,3,43,147,190
12/05/2021,121,3,151,378,529
12/05/2021,831,3,36,159,195
12/05/2021,32,3,26,90,116
12/05/2021,517,3,29,80,109
12/05/2021,694,3,18,105,123
12/05/2021,260,3,124,449,573
12/05/2021,661,3,40,163,203
12/05/2021,680,3,38,88,126
12/05/2021,580,3,26,100,126
12/05/2021,421,3,84,171,255
12/05/2021,461,3,28,114,142
12/05/2021,651,3,24,83,107
12/05/2021,469,3,26,110,136
12/05/2021,24,3,20,36,56
12/05/2021,425,3,35,161,196
12/05/2021,578,3,19,41,60
12/05/2021,57,3,32,176,208
12/05/2021,669,3,19,88,107
12/05/2021,437,3,27,201,228
12/05/2021,67,3,35,159,194
12/05/2021,525,3,30,128,158
12/05/2021,498,3,15,83,98
12/05/2021,211,3,43,221,264
12/05/2021,152,3,40,121,161
12/05/2021,4,3,23,101,124
12/05/2021,915,3,0,13,13
12/05/2021,368,3,35,138,173
12/05/2021,806,3,59,183,242
12/05/2021,226,3,33,125,158
12/05/2021,560,3,67,185,252
12/05/2021,657,3,63,164,227
12/05/2021,447,3,29,109,138
12/05/2021,546,3,51,140,191
12/05/2021,761,3,17,41,58
12/05/2021,303,3,55,244,299
12/05/2021,730,3,13,76,89
12/05/2021,800,3,47,132,179
12/05/2021,268,3,44,163,207
12/05/2021,682,3,20,45,65
12/05/2021,471,3,28,129,157
12/05/2021,8,3,53,109,162
12/05/2021,22,3,22,87,109
12/05/2021,167,3,42,174,216
12/05/2021,862,3,41,154,195
12/05/2021,496,3,9,43,52
12/05/2021,394,3,26,81,107
12/05/2021,142,3,11,40,51
12/05/2021,527,3,24,85,109
12/05/2021,433,3,75,264,339
12/05/2021,881,3,0,9,9
12/05/2021,467,3,20,99,119
12/05/2021,529,3,32,121,153
12/05/2021,12,3,16,47,63
12/05/2021,209,3,15,77,92
12/05/2021,390,3,66,190,256
12/05/2021,739,3,14,53,67
12/05/2021,173,3,23,90,113
12/05/2021,816,3,82,239,321
12/05/2021,227,3,36,100,136
12/05/2021,127,3,17,101,118
12/05/2021,426,3,31,101,132
12/05/2021,326,3,25,58,83
12/05/2021,906,3,7,5,12
12/05/2021,742,3,22,98,120
12/05/2021,52,3,37,160,197
12/05/2021,222,3,20,78,98
12/05/2021,310,3,85,265,350
12/05/2021,452,3,37,151,188
12/05/2021,772,3,40,175,215
12/05/2021,612,3,68,240,308
12/05/2021,691,3,18,136,154
12/05/2021,275,3,38,137,175
12/05/2021,481,3,35,101,136
12/05/2021,861,3,96,171,267
12/05/2021,506,3,48,167,215
12/05/2021,110,3,20,102,122
12/05/2021,584,3,78,289,367
12/05/2021,431,3,34,117,151
12/05/2021,352,3,32,133,165
12/05/2021,838,3,16,66,82
12/05/2021,382,3,0,2,2
12/05/2021,598,3,108,292,400
12/05/2021,728,3,43,138,181
12/05/2021,574,3,25,132,157
12/05/2021,362,3,72,139,211
12/05/2021,439,3,26,101,127
12/05/2021,484,3,33,101,134
12/05/2021,832,3,32,120,152
12/05/2021,686,3,19,106,125
12/05/2021,647,3,30,115,145
12/05/2021,404,3,66,220,286
12/05/2021,136,3,57,152,209
12/05/2021,714,3,35,157,192
12/05/2021,731,3,28,97,125
12/05/2021,511,3,22,82,104
12/05/2021,381,3,1,2,3
12/05/2021,369,3,67,206,273
12/05/2021,216,3,28,105,133
12/05/2021,624,3,12,40,52
12/05/2021,440,3,45,160,205
12/05/2021,685,3,21,107,128
12/05/2021,583,3,30,95,125
12/05/2021,487,3,30,79,109
12/05/2021,703,3,19,92,111
12/05/2021,233,3,51,140,191
12/05/2021,748,3,38,90,128
12/05/2021,841,3,7,64,71
12/05/2021,86,3,36,94,130
12/05/2021,263,3,48,138,186
12/05/2021,634,3,35,107,142
12/05/2021,605,3,70,231,301
12/05/2021,468,3,30,121,151
12/05/2021,377,3,43,90,133
12/05/2021,36,3,30,103,133
12/05/2021,640,3,31,88,119
12/05/2021,336,3,145,355,500
12/05/2021,405,3,13,51,64
12/05/2021,13,3,26,92,118
12/05/2021,503,3,26,135,161
12/05/2021,283,3,26,79,105
12/05/2021,273,3,42,269,311
12/05/2021,599,3,109,318,427
12/05/2021,395,3,27,78,105
12/05/2021,706,3,37,137,174
12/05/2021,412,3,6,62,68
12/05/2021,930,3,0,12,12
12/05/2021,341,3,136,324,460
12/05/2021,126,3,43,122,165
12/05/2021,39,3,42,150,192
12/05/2021,510,3,39,154,193
12/05/2021,45,3,25,136,161
12/05/2021,543,3,159,412,571
12/05/2021,582,3,108,403,511
12/05/2021,134,3,57,150,207
12/05/2021,199,3,14,67,81
12/05/2021,743,3,16,80,96
12/05/2021,102,3,81,238,319
12/05/2021,372,3,75,215,290
12/05/2021,197,3,17,96,113
12/05/2021,639,3,31,86,117
12/05/2021,665,3,22,104,126
12/05/2021,659,3,18,88,106
12/05/2021,627,3,25,97,122
12/05/2021,307,3,31,176,207
12/05/2021,85,3,64,66,130
12/05/2021,919,3,28,129,157
12/05/2021,674,3,18,86,104
12/05/2021,295,3,24,90,114
12/05/2021,554,3,43,94,137
12/05/2021,35,3,32,124,156
12/05/2021,270,3,11,57,68
12/05/2021,376,3,21,34,55
12/05/2021,370,3,35,146,181
12/05/2021,700,3,42,118,160
12/05/2021,710,3,21,88,109
12/05/2021,852,3,64,169,233
12/05/2021,122,3,61,137,198
12/05/2021,89,3,45,149,194
12/05/2021,753,3,21,118,139
12/05/2021,278,3,24,104,128
12/05/2021,615,3,36,95,131
12/05/2021,71,3,27,108,135
12/05/2021,745,3,20,116,136
12/05/2021,100,3,82,247,329
12/05/2021,171,3,9,41,50
12/05/2021,26,3,44,113,157
12/05/2021,148,3,17,74,91
12/05/2021,240,3,91,314,405
12/05/2021,63,3,24,70,94
12/05/2021,812,3,25,116,141
12/05/2021,345,3,26,67,93
12/05/2021,810,3,38,130,168
12/05/2021,317,3,58,171,229
12/05/2021,513,3,17,62,79
12/05/2021,146,3,72,171,243
12/05/2021,576,3,10,21,31
12/05/2021,771,3,23,117,140
12/05/2021,351,3,62,253,315
12/05/2021,388,3,53,178,231
12/05/2021,606,3,31,138,169
12/05/2021,291,3,50,301,351
12/05/2021,116,3,11,69,80
12/05/2021,331,3,27,92,119
12/05/2021,81,3,16,42,58
12/05/2021,645,3,24,110,134
12/05/2021,773,3,29,125,154
12/05/2021,552,3,52,145,197
12/05/2021,430,3,34,135,169
12/05/2021,872,3,23,59,82
12/05/2021,839,3,23,137,160
12/05/2021,758,3,43,115,158
12/05/2021,569,3,30,124,154
12/05/2021,650,3,39,155,194
12/05/2021,113,3,15,73,88
12/05/2021,575,3,16,54,70
12/05/2021,563,3,30,105,135
12/05/2021,373,3,31,110,141
12/05/2021,137,3,48,158,206
12/05/2021,551,3,49,160,209
12/05/2021,538,3,29,125,154
12/05/2021,869,3,69,141,210
12/05/2021,207,3,26,82,108
12/05/2021,515,3,21,89,110
12/05/2021,867,3,26,85,111
12/05/2021,335,3,25,148,173
12/05/2021,20,3,24,47,71
12/05/2021,419,3,51,204,255
12/05/2021,65,3,29,169,198
12/05/2021,789,3,26,140,166
12/05/2021,676,3,36,81,117
12/05/2021,130,3,64,182,246
12/05/2021,779,3,26,59,85
12/05/2021,781,3,54,169,223
12/05/2021,282,3,23,117,140
12/05/2021,224,3,37,89,126
12/05/2021,629,3,31,98,129
12/05/2021,592,3,24,117,141
12/05/2021,347,3,111,232,343
12/05/2021,254,3,24,79,103
12/05/2021,396,3,25,66,91
12/05/2021,215,3,14,57,71
12/05/2021,77,3,56,192,248
12/05/2021,633,3,8,63,71
12/05/2021,323,3,15,54,69
12/05/2021,544,3,45,105,150
12/05/2021,219,3,23,92,115
12/05/2021,75,3,57,192,249
12/05/2021,619,3,15,49,64
12/05/2021,564,3,32,127,159
12/05/2021,349,3,24,92,116
12/05/2021,556,3,86,197,283
12/05/2021,384,3,36,126,162
12/05/2021,887,3,0,15,15
12/05/2021,662,3,61,254,315
12/05/2021,542,3,72,154,226
12/05/2021,129,3,60,172,232
12/05/2021,616,3,42,138,180
12/05/2021,756,3,44,223,267
12/05/2021,68,3,33,177,210
12/05/2021,115,3,18,62,80
12/05/2021,135,3,59,158,217
12/05/2021,428,3,29,109,138
12/05/2021,344,3,35,85,120
12/05/2021,884,3,3,54,57
12/05/2021,9,3,37,142,179
12/05/2021,91,3,26,112,138
12/05/2021,572,3,28,127,155
12/05/2021,625,3,29,78,107
12/05/2021,87,3,60,182,242
12/05/2021,374,3,30,60,90
12/05/2021,435,3,30,113,143
12/05/2021,246,3,106,336,442
12/05/2021,205,3,19,83,102
12/05/2021,749,3,22,145,167
12/05/2021,533,3,35,75,110
12/05/2021,737,3,13,37,50
12/05/2021,631,3,10,34,44
12/05/2021,3,3,25,104,129
12/05/2021,92,3,47,143,190
12/05/2021,464,3,52,218,270
12/05/2021,518,3,16,72,88
12/05/2021,204,3,20,70,90
12/05/2021,139,3,42,135,177
12/05/2021,422,3,32,98,130
12/05/2021,813,3,32,92,124
12/05/2021,72,3,62,221,283
12/05/2021,202,3,55,227,282
12/05/2021,642,3,36,91,127
12/05/2021,760,3,30,101,131
12/05/2021,782,3,52,177,229
12/05/2021,754,3,32,167,199
12/05/2021,292,3,69,370,439
12/05/2021,622,3,86,192,278
12/05/2021,807,3,27,80,107
12/05/2021,210,3,24,86,110
12/05/2021,338,3,36,176,212
12/05/2021,902,3,35,105,140
12/05/2021,117,3,70,189,259
12/05/2021,330,3,30,195,225
12/05/2021,304,3,32,165,197
12/05/2021,493,3,16,81,97
12/05/2021,212,3,58,247,305
12/05/2021,411,3,35,190,225
12/05/2021,78,3,108,389,497
12/05/2021,670,3,169,485,654
12/05/2021,397,3,22,67,89
12/05/2021,898,3,35,54,89
12/05/2021,851,3,19,93,112
12/05/2021,348,3,10,86,96
12/05/2021,312,3,25,72,97
12/05/2021,249,3,107,376,483
12/05/2021,768,3,40,110,150
12/05/2021,833,3,14,55,69
12/05/2021,540,3,51,160,211
12/05/2021,300,3,65,354,419
12/05/2021,853,3,22,73,95
12/05/2021,557,3,31,96,127
12/05/2021,48,3,15,53,68
12/05/2021,403,3,45,165,210
12/05/2021,579,3,11,38,49
12/05/2021,603,3,70,195,265
12/05/2021,715,3,84,173,257
12/05/2021,308,3,25,156,181
12/05/2021,58,3,30,133,163
12/05/2021,438,3,36,98,134
12/05/2021,218,3,44,224,268
12/05/2021,509,3,27,144,171
12/05/2021,472,3,68,243,311
12/05/2021,322,3,24,81,105
12/05/2021,764,3,13,21,34
12/05/2021,726,3,19,100,119
12/05/2021,649,3,26,87,113
12/05/2021,548,3,22,72,94
12/05/2021,169,3,22,109,131
12/05/2021,720,3,17,72,89
12/05/2021,871,3,32,91,123
12/05/2021,315,3,10,49,59
12/05/2021,747,3,19,88,107
12/05/2021,297,3,45,265,310
12/05/2021,909,3,2,11,13
12/05/2021,417,3,35,173,208
12/05/2021,321,3,30,61,91
12/05/2021,266,3,27,115,142
12/05/2021,51,3,87,278,365
12/05/2021,836,3,27,153,180
12/05/2021,875,3,23,93,116
12/05/2021,936,3,2,6,8
12/05/2021,427,3,78,278,356
12/05/2021,252,3,30,90,120
12/05/2021,163,3,21,121,142
12/05/2021,128,3,15,109,124
12/05/2021,684,3,30,136,166
12/05/2021,138,3,50,147,197
12/05/2021,354,3,1,0,1
12/05/2021,213,3,46,233,279
12/05/2021,600,3,119,396,515
12/05/2021,507,3,46,236,282
12/05/2021,904,3,37,164,201
12/05/2021,652,3,14,65,79
12/05/2021,200,3,25,83,108
12/05/2021,677,3,17,59,76
12/05/2021,444,3,24,153,177
12/05/2021,591,3,33,96,129
12/05/2021,442,3,28,130,158
12/05/2021,231,3,29,156,185
12/05/2021,555,3,65,169,234
12/05/2021,608,3,81,298,379
12/05/2021,46,3,26,89,115
12/05/2021,119,3,59,157,216
12/05/2021,133,3,12,57,69
12/05/2021,809,3,20,101,121
12/05/2021,353,3,9,38,47
12/05/2021,448,3,96,348,444
12/05/2021,581,3,32,124,156
12/05/2021,25,3,33,155,188
12/05/2021,687,3,28,134,162
12/05/2021,145,3,26,160,186
12/05/2021,245,3,111,355,466
12/05/2021,792,3,28,88,116
12/05/2021,5,3,26,103,129
12/05/2021,821,3,43,142,185
12/05/2021,38,3,39,143,182
12/05/2021,668,3,15,54,69
12/05/2021,316,3,29,134,163
12/05/2021,357,3,63,220,283
12/05/2021,559,3,71,188,259
12/05/2021,476,3,27,94,121
12/05/2021,679,3,47,123,170
12/05/2021,407,3,25,152,177
12/05/2021,290,3,60,316,376
12/05/2021,530,3,24,50,74
12/05/2021,174,3,29,86,115
12/05/2021,107,3,96,307,403
12/05/2021,928,3,0,1,1
12/05/2021,602,3,77,268,345
12/05/2021,793,3,35,154,189
12/05/2021,41,3,29,119,148
12/05/2021,722,3,12,57,69
12/05/2021,775,3,22,103,125
12/05/2021,671,3,36,187,223
12/05/2021,449,3,52,143,195
12/05/2021,414,3,38,162,200
12/05/2021,179,3,29,98,127
12/05/2021,905,3,0,4,4
12/05/2021,358,3,80,270,350
12/05/2021,653,3,18,61,79
12/05/2021,343,3,16,88,104
12/05/2021,156,3,40,159,199
12/05/2021,828,3,36,138,174
12/05/2021,741,3,12,48,60
12/05/2021,455,3,28,59,87
12/05/2021,445,3,34,214,248
12/05/2021,562,3,17,40,57
12/05/2021,201,3,24,100,124
12/05/2021,621,3,23,119,142
12/05/2021,641,3,27,70,97
12/05/2021,494,3,11,82,93
12/05/2021,33,3,39,128,167
12/05/2021,120,3,60,131,191
12/05/2021,177,3,26,76,102
12/05/2021,429,3,29,216,245
12/05/2021,885,3,3,45,48
12/05/2021,232,3,35,129,164
12/05/2021,366,3,30,52,82
12/05/2021,767,3,88,197,285
12/05/2021,108,3,21,63,84
12/05/2021,392,3,32,76,108
12/05/2021,854,3,64,269,333
12/05/2021,623,3,26,124,150
12/05/2021,860,3,26,90,116
12/05/2021,480,3,13,64,77
12/05/2021,250,3,63,127,190
12/05/2021,588,3,31,96,127
12/05/2021,274,3,0,11,11
13/05/2021,177,3,20,66,86
13/05/2021,366,3,31,42,73
13/05/2021,767,3,87,234,321
13/05/2021,885,3,6,100,106
13/05/2021,623,3,25,137,162
13/05/2021,232,3,39,130,169
13/05/2021,274,3,0,16,16
13/05/2021,250,3,62,121,183
13/05/2021,588,3,24,101,125
13/05/2021,392,3,27,93,120
13/05/2021,860,3,30,105,135
13/05/2021,854,3,65,250,315
13/05/2021,108,3,27,70,97
13/05/2021,120,3,57,129,186
13/05/2021,480,3,12,67,79
13/05/2021,429,3,39,223,262
13/05/2021,33,3,34,120,154
13/05/2021,277,3,35,108,143
13/05/2021,389,3,59,198,257
13/05/2021,176,3,42,104,146
13/05/2021,434,3,7,26,33
13/05/2021,32,3,23,80,103
13/05/2021,855,3,39,200,239
13/05/2021,709,3,37,160,197
13/05/2021,837,3,48,207,255
13/05/2021,314,3,12,53,65
13/05/2021,257,3,103,348,451
13/05/2021,103,3,80,210,290
13/05/2021,505,3,18,66,84
13/05/2021,121,3,139,357,496
13/05/2021,831,3,40,187,227
13/05/2021,835,3,33,164,197
13/05/2021,84,3,95,203,298
13/05/2021,76,3,47,162,209
13/05/2021,626,3,32,133,165
13/05/2021,857,3,31,122,153
13/05/2021,34,3,30,115,145
13/05/2021,143,3,79,212,291
13/05/2021,206,3,6,7,13
13/05/2021,699,3,30,107,137
13/05/2021,180,3,30,144,174
13/05/2021,220,3,33,66,99
13/05/2021,385,3,22,88,110
13/05/2021,750,3,24,132,156
13/05/2021,285,3,24,78,102
13/05/2021,886,3,0,21,21
13/05/2021,294,3,35,168,203
13/05/2021,432,3,33,150,183
13/05/2021,805,3,29,96,125
13/05/2021,96,3,42,106,148
13/05/2021,158,3,26,107,133
13/05/2021,757,3,67,224,291
13/05/2021,643,3,39,137,176
13/05/2021,410,3,29,181,210
13/05/2021,486,3,37,162,199
13/05/2021,441,3,71,230,301
13/05/2021,386,3,74,291,365
13/05/2021,531,3,45,143,188
13/05/2021,732,3,16,69,85
13/05/2021,818,3,62,212,274
13/05/2021,53,3,46,102,148
13/05/2021,921,3,0,6,6
13/05/2021,820,3,26,117,143
13/05/2021,830,3,159,411,570
13/05/2021,327,3,55,208,263
13/05/2021,256,3,38,69,107
13/05/2021,490,3,11,73,84
13/05/2021,791,3,40,192,232
13/05/2021,2,3,27,113,140
13/05/2021,339,3,42,156,198
13/05/2021,203,3,31,92,123
13/05/2021,711,3,22,83,105
13/05/2021,866,3,38,170,208
13/05/2021,70,3,40,155,195
13/05/2021,424,3,60,328,388
13/05/2021,705,3,8,49,57
13/05/2021,409,3,16,68,84
13/05/2021,780,3,91,266,357
13/05/2021,614,3,35,126,161
13/05/2021,170,3,24,140,164
13/05/2021,11,3,34,127,161
13/05/2021,717,3,42,158,200
13/05/2021,638,3,52,167,219
13/05/2021,829,3,40,110,150
13/05/2021,914,3,4,4,8
13/05/2021,926,3,4,8,12
13/05/2021,536,3,25,87,112
13/05/2021,387,3,32,112,144
13/05/2021,908,3,0,9,9
13/05/2021,302,3,66,296,362
13/05/2021,727,3,22,95,117
13/05/2021,693,3,23,67,90
13/05/2021,367,3,31,166,197
13/05/2021,193,3,25,143,168
13/05/2021,865,3,19,61,80
13/05/2021,848,3,41,169,210
13/05/2021,917,3,2,24,26
13/05/2021,228,3,35,92,127
13/05/2021,617,3,32,99,131
13/05/2021,755,3,42,183,225
13/05/2021,594,3,51,170,221
13/05/2021,106,3,37,183,220
13/05/2021,451,3,100,382,482
13/05/2021,262,3,28,78,106
13/05/2021,183,3,20,99,119
13/05/2021,932,3,0,9,9
13/05/2021,475,3,55,153,208
13/05/2021,519,3,34,82,116
13/05/2021,495,3,15,93,108
13/05/2021,82,3,52,141,193
13/05/2021,261,3,128,437,565
13/05/2021,454,3,34,160,194
13/05/2021,892,3,15,11,26
13/05/2021,910,3,6,103,109
13/05/2021,843,3,19,71,90
13/05/2021,359,3,50,137,187
13/05/2021,288,3,17,68,85
13/05/2021,328,3,22,99,121
13/05/2021,876,3,0,12,12
13/05/2021,595,3,32,82,114
13/05/2021,577,3,36,155,191
13/05/2021,532,3,128,418,546
13/05/2021,44,3,80,228,308
13/05/2021,719,3,17,73,90
13/05/2021,874,3,22,134,156
13/05/2021,868,3,66,245,311
13/05/2021,99,3,95,285,380
13/05/2021,19,3,38,162,200
13/05/2021,815,3,119,377,496
13/05/2021,172,3,20,133,153
13/05/2021,723,3,38,138,176
13/05/2021,460,3,28,124,152
13/05/2021,485,3,23,106,129
13/05/2021,520,3,14,63,77
13/05/2021,738,3,34,93,127
13/05/2021,64,3,21,72,93
13/05/2021,890,3,7,29,36
13/05/2021,334,3,86,190,276
13/05/2021,466,3,30,144,174
13/05/2021,88,3,30,111,141
13/05/2021,803,3,29,171,200
13/05/2021,101,3,46,130,176
13/05/2021,553,3,23,30,53
13/05/2021,379,3,46,176,222
13/05/2021,847,3,2,39,41
13/05/2021,801,3,39,189,228
13/05/2021,819,3,47,131,178
13/05/2021,50,3,20,66,86
13/05/2021,849,3,31,152,183
13/05/2021,573,3,30,122,152
13/05/2021,23,3,21,32,53
13/05/2021,896,3,169,420,589
13/05/2021,470,3,37,140,177
13/05/2021,192,3,21,81,102
13/05/2021,597,3,26,77,103
13/05/2021,15,3,52,126,178
13/05/2021,186,3,24,80,104
13/05/2021,436,3,32,171,203
13/05/2021,683,3,24,133,157
13/05/2021,512,3,7,48,55
13/05/2021,393,3,17,87,104
13/05/2021,350,3,21,131,152
13/05/2021,269,3,28,93,121
13/05/2021,474,3,21,109,130
13/05/2021,825,3,57,194,251
13/05/2021,162,3,107,266,373
13/05/2021,56,3,42,191,233
13/05/2021,247,3,71,292,363
13/05/2021,399,3,67,211,278
13/05/2021,462,3,22,116,138
13/05/2021,654,3,34,136,170
13/05/2021,253,3,14,64,78
13/05/2021,251,3,14,108,122
13/05/2021,882,3,0,33,33
13/05/2021,707,3,33,139,172
13/05/2021,182,3,33,91,124
13/05/2021,239,3,38,193,231
13/05/2021,666,3,28,129,157
13/05/2021,66,3,28,134,162
13/05/2021,522,3,51,122,173
13/05/2021,446,3,26,173,199
13/05/2021,920,3,0,1,1
13/05/2021,416,3,14,72,86
13/05/2021,790,3,42,166,208
13/05/2021,491,3,44,248,292
13/05/2021,296,3,30,81,111
13/05/2021,281,3,31,160,191
13/05/2021,784,3,63,281,344
13/05/2021,267,3,28,101,129
13/05/2021,401,3,17,79,96
13/05/2021,450,3,13,57,70
13/05/2021,534,3,23,93,116
13/05/2021,235,3,24,198,222
13/05/2021,900,3,0,2,2
13/05/2021,383,3,64,264,328
13/05/2021,418,3,15,56,71
13/05/2021,194,3,1,1,2
13/05/2021,924,3,0,4,4
13/05/2021,863,3,38,110,148
13/05/2021,60,3,11,51,62
13/05/2021,681,3,54,145,199
13/05/2021,658,3,14,92,106
13/05/2021,675,3,35,127,162
13/05/2021,752,3,39,185,224
13/05/2021,632,3,16,41,57
13/05/2021,918,3,0,7,7
13/05/2021,6,3,28,114,142
13/05/2021,787,3,101,379,480
13/05/2021,364,3,68,139,207
13/05/2021,258,3,117,400,517
13/05/2021,118,3,52,159,211
13/05/2021,234,3,22,47,69
13/05/2021,734,3,21,79,100
13/05/2021,49,3,19,67,86
13/05/2021,873,3,46,128,174
13/05/2021,539,3,38,141,179
13/05/2021,799,3,7,28,35
13/05/2021,284,3,10,45,55
13/05/2021,230,3,28,138,166
13/05/2021,325,3,6,73,79
13/05/2021,521,3,22,44,66
13/05/2021,925,3,0,2,2
13/05/2021,938,3,0,2,2
13/05/2021,716,3,34,136,170
13/05/2021,808,3,82,242,324
13/05/2021,911,3,31,184,215
13/05/2021,814,3,12,73,85
13/05/2021,313,3,15,58,73
13/05/2021,98,3,61,163,224
13/05/2021,844,3,14,68,82
13/05/2021,299,3,30,110,140
13/05/2021,698,3,42,122,164
13/05/2021,329,3,54,209,263
13/05/2021,508,3,32,196,228
13/05/2021,337,3,13,40,53
13/05/2021,55,3,15,78,93
13/05/2021,913,3,3,5,8
13/05/2021,181,3,20,67,87
13/05/2021,550,3,41,155,196
13/05/2021,319,3,11,72,83
13/05/2021,724,3,138,348,486
13/05/2021,891,3,30,109,139
13/05/2021,301,3,81,314,395
13/05/2021,856,3,59,146,205
13/05/2021,459,3,41,202,243
13/05/2021,276,3,31,156,187
13/05/2021,897,3,9,19,28
13/05/2021,696,3,29,109,138
13/05/2021,305,3,26,167,193
13/05/2021,189,3,31,106,137
13/05/2021,28,3,20,92,112
13/05/2021,400,3,17,72,89
13/05/2021,380,3,34,150,184
13/05/2021,570,3,18,108,126
13/05/2021,895,3,27,130,157
13/05/2021,785,3,74,311,385
13/05/2021,423,3,58,309,367
13/05/2021,238,3,84,298,382
13/05/2021,187,3,17,77,94
13/05/2021,286,3,24,70,94
13/05/2021,777,3,37,71,108
13/05/2021,489,3,5,27,32
13/05/2021,237,3,89,319,408
13/05/2021,788,3,97,356,453
13/05/2021,786,3,41,156,197
13/05/2021,528,3,32,70,102
13/05/2021,318,3,60,209,269
13/05/2021,478,3,28,13,41
13/05/2021,54,3,19,73,92
13/05/2021,155,3,61,160,221
13/05/2021,178,3,36,90,126
13/05/2021,458,3,35,187,222
13/05/2021,565,3,76,193,269
13/05/2021,735,3,13,51,64
13/05/2021,628,3,26,57,83
13/05/2021,279,3,39,169,208
13/05/2021,894,3,33,86,119
13/05/2021,499,3,26,114,140
13/05/2021,601,3,47,116,163
13/05/2021,636,3,17,71,88
13/05/2021,355,3,16,58,74
13/05/2021,697,3,42,122,164
13/05/2021,610,3,61,225,286
13/05/2021,656,3,11,41,52
13/05/2021,501,3,44,241,285
13/05/2021,870,3,16,73,89
13/05/2021,97,3,81,196,277
13/05/2021,340,3,42,165,207
13/05/2021,859,3,7,4,11
13/05/2021,80,3,17,43,60
13/05/2021,188,3,28,120,148
13/05/2021,733,3,15,91,106
13/05/2021,1,3,27,114,141
13/05/2021,514,3,11,48,59
13/05/2021,660,3,21,94,115
13/05/2021,701,3,17,97,114
13/05/2021,265,3,31,91,122
13/05/2021,391,3,52,186,238
13/05/2021,878,3,1,33,34
13/05/2021,111,3,61,172,233
13/05/2021,823,3,32,75,107
13/05/2021,371,3,26,101,127
13/05/2021,365,3,37,57,94
13/05/2021,526,3,36,104,140
13/05/2021,420,3,81,223,304
13/05/2021,151,3,20,84,104
13/05/2021,593,3,93,280,373
13/05/2021,243,3,96,366,462
13/05/2021,184,3,24,100,124
13/05/2021,778,3,58,135,193
13/05/2021,271,3,32,90,122
13/05/2021,131,3,37,160,197
13/05/2021,190,3,28,114,142
13/05/2021,342,3,31,131,162
13/05/2021,689,3,39,86,125
13/05/2021,259,3,108,347,455
13/05/2021,939,3,0,1,1
13/05/2021,255,3,4,5,9
13/05/2021,817,3,25,132,157
13/05/2021,168,3,24,130,154
13/05/2021,770,3,90,260,350
13/05/2021,673,3,34,188,222
13/05/2021,811,3,27,99,126
13/05/2021,164,3,14,100,114
13/05/2021,524,3,34,142,176
13/05/2021,561,3,15,63,78
13/05/2021,587,3,6,27,33
13/05/2021,27,3,77,238,315
13/05/2021,721,3,137,454,591
13/05/2021,229,3,63,191,254
13/05/2021,713,3,43,335,378
13/05/2021,746,3,21,124,145
13/05/2021,567,3,37,143,180
13/05/2021,149,3,23,115,138
13/05/2021,456,3,29,132,161
13/05/2021,547,3,161,411,572
13/05/2021,736,3,10,36,46
13/05/2021,159,3,41,122,163
13/05/2021,90,3,31,107,138
13/05/2021,937,3,1,0,1
13/05/2021,794,3,69,245,314
13/05/2021,585,3,64,244,308
13/05/2021,166,3,4,74,78
13/05/2021,298,3,91,385,476
13/05/2021,196,3,17,65,82
13/05/2021,123,3,36,110,146
13/05/2021,497,3,41,244,285
13/05/2021,774,3,25,124,149
13/05/2021,125,3,44,99,143
13/05/2021,935,3,0,1,1
13/05/2021,7,3,29,114,143
13/05/2021,646,3,30,112,142
13/05/2021,157,3,35,87,122
13/05/2021,105,3,61,111,172
13/05/2021,798,3,70,244,314
13/05/2021,826,3,54,184,238
13/05/2021,47,3,53,107,160
13/05/2021,765,3,45,152,197
13/05/2021,154,3,26,154,180
13/05/2021,704,3,9,66,75
13/05/2021,18,3,29,118,147
13/05/2021,488,3,30,74,104
13/05/2021,236,3,33,116,149
13/05/2021,751,3,0,14,14
13/05/2021,879,3,3,40,43
13/05/2021,759,3,15,66,81
13/05/2021,221,3,32,65,97
13/05/2021,242,3,88,331,419
13/05/2021,272,3,36,117,153
13/05/2021,899,3,52,200,252
13/05/2021,804,3,96,339,435
13/05/2021,112,3,19,55,74
13/05/2021,408,3,43,198,241
13/05/2021,248,3,46,81,127
13/05/2021,264,3,30,72,102
13/05/2021,688,3,23,108,131
13/05/2021,901,3,1,3,4
13/05/2021,535,3,24,90,114
13/05/2021,104,3,63,146,209
13/05/2021,402,3,57,169,226
13/05/2021,934,3,0,22,22
13/05/2021,83,3,127,342,469
13/05/2021,479,3,11,53,64
13/05/2021,144,3,34,148,182
13/05/2021,30,3,44,112,156
13/05/2021,604,3,78,187,265
13/05/2021,842,3,10,14,24
13/05/2021,185,3,20,116,136
13/05/2021,61,3,30,166,196
13/05/2021,850,3,115,295,410
13/05/2021,124,3,32,86,118
13/05/2021,289,3,33,120,153
13/05/2021,465,3,26,162,188
13/05/2021,907,3,69,236,305
13/05/2021,846,3,3,47,50
13/05/2021,360,3,42,177,219
13/05/2021,783,3,43,207,250
13/05/2021,356,3,59,199,258
13/05/2021,566,3,24,92,116
13/05/2021,712,3,23,85,108
13/05/2021,797,3,54,125,179
13/05/2021,293,3,52,205,257
13/05/2021,333,3,34,259,293
13/05/2021,79,3,29,67,96
13/05/2021,114,3,55,121,176
13/05/2021,500,3,3,32,35
13/05/2021,280,3,13,46,59
13/05/2021,43,3,39,160,199
13/05/2021,637,3,52,205,257
13/05/2021,311,3,39,115,154
13/05/2021,824,3,58,218,276
13/05/2021,217,3,47,247,294
13/05/2021,244,3,41,154,195
13/05/2021,59,3,31,99,130
13/05/2021,802,3,36,204,240
13/05/2021,443,3,37,159,196
13/05/2021,161,3,106,267,373
13/05/2021,37,3,35,94,129
13/05/2021,95,3,40,193,233
13/05/2021,195,3,15,69,84
13/05/2021,473,3,25,112,137
13/05/2021,309,3,15,56,71
13/05/2021,537,3,50,153,203
13/05/2021,406,3,52,123,175
13/05/2021,93,3,40,239,279
13/05/2021,795,3,31,177,208
13/05/2021,613,3,9,64,73
13/05/2021,378,3,24,121,145
13/05/2021,702,3,15,96,111
13/05/2021,504,3,12,40,52
13/05/2021,883,3,6,118,124
13/05/2021,477,3,22,118,140
13/05/2021,558,3,27,90,117
13/05/2021,586,3,70,285,355
13/05/2021,398,3,3,18,21
13/05/2021,492,3,11,79,90
13/05/2021,69,3,36,106,142
13/05/2021,175,3,30,94,124
13/05/2021,858,3,61,178,239
13/05/2021,903,3,0,2,2
13/05/2021,889,3,0,5,5
13/05/2021,361,3,64,139,203
13/05/2021,776,3,28,139,167
13/05/2021,571,3,23,93,116
13/05/2021,147,3,34,128,162
13/05/2021,198,3,43,134,177
13/05/2021,17,3,20,101,121
13/05/2021,287,3,103,393,496
13/05/2021,607,3,73,266,339
13/05/2021,648,3,15,87,102
13/05/2021,589,3,26,95,121
13/05/2021,42,3,22,110,132
13/05/2021,332,3,31,153,184
13/05/2021,888,3,2,30,32
13/05/2021,153,3,28,150,178
13/05/2021,864,3,30,97,127
13/05/2021,413,3,32,184,216
13/05/2021,663,3,43,157,200
13/05/2021,655,3,59,227,286
13/05/2021,635,3,31,121,152
13/05/2021,692,3,27,73,100
13/05/2021,840,3,22,183,205
13/05/2021,140,3,26,75,101
13/05/2021,457,3,18,72,90
13/05/2021,463,3,73,270,343
13/05/2021,877,3,3,34,37
13/05/2021,453,3,37,166,203
13/05/2021,21,3,36,129,165
13/05/2021,363,3,70,140,210
13/05/2021,31,3,33,123,156
13/05/2021,483,3,33,134,167
13/05/2021,845,3,34,125,159
13/05/2021,346,3,17,76,93
13/05/2021,664,3,62,210,272
13/05/2021,208,3,22,78,100
13/05/2021,827,3,70,216,286
13/05/2021,880,3,0,24,24
13/05/2021,725,3,28,109,137
13/05/2021,214,3,54,256,310
13/05/2021,618,3,40,117,157
13/05/2021,94,3,1,1,2
13/05/2021,225,3,45,161,206
13/05/2021,160,3,3,7,10
13/05/2021,179,3,28,88,116
13/05/2021,741,3,13,53,66
13/05/2021,621,3,25,123,148
13/05/2021,358,3,73,285,358
13/05/2021,828,3,42,129,171
13/05/2021,494,3,11,77,88
13/05/2021,905,3,2,5,7
13/05/2021,156,3,37,159,196
13/05/2021,414,3,44,205,249
13/05/2021,201,3,28,92,120
13/05/2021,641,3,26,99,125
13/05/2021,562,3,20,43,63
13/05/2021,445,3,38,221,259
13/05/2021,343,3,20,100,120
13/05/2021,653,3,11,56,67
13/05/2021,455,3,23,86,109
13/05/2021,419,3,57,227,284
13/05/2021,396,3,20,84,104
13/05/2021,869,3,70,134,204
13/05/2021,207,3,27,100,127
13/05/2021,676,3,26,88,114
13/05/2021,592,3,34,116,150
13/05/2021,335,3,29,181,210
13/05/2021,629,3,33,112,145
13/05/2021,789,3,34,112,146
13/05/2021,347,3,109,240,349
13/05/2021,20,3,20,43,63
13/05/2021,781,3,60,195,255
13/05/2021,867,3,33,86,119
13/05/2021,515,3,18,99,117
13/05/2021,65,3,32,167,199
13/05/2021,779,3,30,55,85
13/05/2021,130,3,73,241,314
13/05/2021,282,3,29,138,167
13/05/2021,224,3,37,98,135
13/05/2021,254,3,24,76,100
13/05/2021,263,3,43,149,192
13/05/2021,841,3,8,147,155
13/05/2021,511,3,21,98,119
13/05/2021,624,3,11,41,52
13/05/2021,748,3,25,100,125
13/05/2021,86,3,30,106,136
13/05/2021,634,3,36,139,175
13/05/2021,703,3,17,99,116
13/05/2021,440,3,49,186,235
13/05/2021,381,3,4,0,4
13/05/2021,233,3,56,150,206
13/05/2021,369,3,66,228,294
13/05/2021,216,3,33,136,169
13/05/2021,685,3,25,102,127
13/05/2021,487,3,25,94,119
13/05/2021,583,3,28,99,127
13/05/2021,731,3,32,117,149
13/05/2021,761,3,14,48,62
13/05/2021,22,3,28,86,114
13/05/2021,682,3,25,55,80
13/05/2021,800,3,45,135,180
13/05/2021,447,3,26,99,125
13/05/2021,268,3,63,182,245
13/05/2021,303,3,64,282,346
13/05/2021,546,3,45,163,208
13/05/2021,471,3,24,135,159
13/05/2021,8,3,53,125,178
13/05/2021,730,3,18,80,98
13/05/2021,425,3,40,204,244
13/05/2021,580,3,37,124,161
13/05/2021,260,3,129,439,568
13/05/2021,680,3,39,88,127
13/05/2021,661,3,53,204,257
13/05/2021,651,3,28,75,103
13/05/2021,517,3,21,89,110
13/05/2021,24,3,19,31,50
13/05/2021,421,3,71,184,255
13/05/2021,578,3,15,51,66
13/05/2021,469,3,27,151,178
13/05/2021,694,3,24,113,137
13/05/2021,461,3,39,149,188
13/05/2021,525,3,28,138,166
13/05/2021,498,3,14,90,104
13/05/2021,67,3,27,153,180
13/05/2021,560,3,69,186,255
13/05/2021,669,3,23,98,121
13/05/2021,437,3,31,211,242
13/05/2021,226,3,39,127,166
13/05/2021,211,3,54,253,307
13/05/2021,4,3,22,98,120
13/05/2021,152,3,35,133,168
13/05/2021,368,3,33,160,193
13/05/2021,806,3,53,200,253
13/05/2021,57,3,32,186,218
13/05/2021,915,3,0,28,28
13/05/2021,657,3,69,152,221
13/05/2021,647,3,29,102,131
13/05/2021,110,3,21,100,121
13/05/2021,686,3,17,107,124
13/05/2021,832,3,33,131,164
13/05/2021,431,3,26,114,140
13/05/2021,584,3,99,291,390
13/05/2021,838,3,16,75,91
13/05/2021,728,3,39,156,195
13/05/2021,714,3,39,128,167
13/05/2021,352,3,39,161,200
13/05/2021,598,3,103,308,411
13/05/2021,484,3,26,101,127
13/05/2021,574,3,32,133,165
13/05/2021,404,3,74,226,300
13/05/2021,439,3,25,107,132
13/05/2021,362,3,71,135,206
13/05/2021,382,3,0,6,6
13/05/2021,506,3,42,232,274
13/05/2021,136,3,69,217,286
13/05/2021,142,3,12,41,53
13/05/2021,816,3,69,261,330
13/05/2021,527,3,26,99,125
13/05/2021,12,3,9,44,53
13/05/2021,433,3,82,268,350
13/05/2021,529,3,40,131,171
13/05/2021,496,3,9,49,58
13/05/2021,739,3,17,49,66
13/05/2021,390,3,63,214,277
13/05/2021,173,3,29,96,125
13/05/2021,167,3,44,168,212
13/05/2021,394,3,23,101,124
13/05/2021,209,3,16,91,107
13/05/2021,467,3,20,119,139
13/05/2021,862,3,42,167,209
13/05/2021,881,3,0,16,16
13/05/2021,742,3,32,91,123
13/05/2021,481,3,27,102,129
13/05/2021,691,3,21,138,159
13/05/2021,906,3,9,8,17
13/05/2021,310,3,71,273,344
13/05/2021,861,3,82,170,252
13/05/2021,772,3,47,135,182
13/05/2021,52,3,42,138,180
13/05/2021,275,3,38,146,184
13/05/2021,127,3,18,111,129
13/05/2021,326,3,17,66,83
13/05/2021,452,3,34,169,203
13/05/2021,222,3,32,61,93
13/05/2021,426,3,24,106,130
13/05/2021,227,3,34,106,140
13/05/2021,612,3,64,242,306
13/05/2021,839,3,33,130,163
13/05/2021,113,3,17,77,94
13/05/2021,758,3,36,114,150
13/05/2021,569,3,30,132,162
13/05/2021,551,3,52,166,218
13/05/2021,872,3,25,50,75
13/05/2021,137,3,35,162,197
13/05/2021,373,3,34,121,155
13/05/2021,563,3,37,118,155
13/05/2021,538,3,36,118,154
13/05/2021,430,3,30,149,179
13/05/2021,650,3,49,182,231
13/05/2021,575,3,15,54,69
13/05/2021,197,3,25,103,128
13/05/2021,307,3,29,169,198
13/05/2021,270,3,14,71,85
13/05/2021,85,3,60,56,116
13/05/2021,919,3,37,116,153
13/05/2021,659,3,15,98,113
13/05/2021,376,3,22,29,51
13/05/2021,554,3,48,102,150
13/05/2021,627,3,33,112,145
13/05/2021,372,3,76,278,354
13/05/2021,35,3,36,136,172
13/05/2021,674,3,22,97,119
13/05/2021,295,3,27,105,132
13/05/2021,639,3,25,94,119
13/05/2021,665,3,20,113,133
13/05/2021,395,3,22,93,115
13/05/2021,283,3,19,87,106
13/05/2021,13,3,22,96,118
13/05/2021,336,3,136,332,468
13/05/2021,273,3,45,255,300
13/05/2021,405,3,19,64,83
13/05/2021,503,3,24,177,201
13/05/2021,377,3,37,119,156
13/05/2021,599,3,105,317,422
13/05/2021,605,3,84,204,288
13/05/2021,36,3,32,112,144
13/05/2021,468,3,35,128,163
13/05/2021,640,3,27,103,130
13/05/2021,543,3,153,403,556
13/05/2021,134,3,67,215,282
13/05/2021,930,3,2,21,23
13/05/2021,412,3,12,70,82
13/05/2021,582,3,121,405,526
13/05/2021,126,3,39,135,174
13/05/2021,743,3,17,90,107
13/05/2021,341,3,129,313,442
13/05/2021,706,3,36,133,169
13/05/2021,39,3,38,152,190
13/05/2021,102,3,75,231,306
13/05/2021,199,3,19,60,79
13/05/2021,45,3,35,165,200
13/05/2021,510,3,35,199,234
13/05/2021,388,3,48,211,259
13/05/2021,645,3,34,121,155
13/05/2021,81,3,14,44,58
13/05/2021,116,3,14,73,87
13/05/2021,291,3,63,296,359
13/05/2021,771,3,26,136,162
13/05/2021,606,3,43,125,168
13/05/2021,552,3,46,165,211
13/05/2021,351,3,64,252,316
13/05/2021,331,3,32,96,128
13/05/2021,773,3,22,119,141
13/05/2021,171,3,5,42,47
13/05/2021,370,3,28,164,192
13/05/2021,89,3,40,158,198
13/05/2021,753,3,29,134,163
13/05/2021,278,3,25,132,157
13/05/2021,615,3,33,107,140
13/05/2021,700,3,41,126,167
13/05/2021,710,3,21,88,109
13/05/2021,745,3,23,138,161
13/05/2021,122,3,60,135,195
13/05/2021,100,3,83,267,350
13/05/2021,71,3,25,104,129
13/05/2021,852,3,58,174,232
13/05/2021,513,3,21,69,90
13/05/2021,63,3,27,77,104
13/05/2021,345,3,31,61,92
13/05/2021,146,3,82,220,302
13/05/2021,240,3,85,321,406
13/05/2021,576,3,9,33,42
13/05/2021,317,3,58,172,230
13/05/2021,26,3,42,101,143
13/05/2021,810,3,37,125,162
13/05/2021,812,3,30,120,150
13/05/2021,148,3,13,65,78
13/05/2021,41,3,29,127,156
13/05/2021,775,3,19,110,129
13/05/2021,671,3,44,206,250
13/05/2021,722,3,14,70,84
13/05/2021,793,3,43,166,209
13/05/2021,449,3,45,150,195
13/05/2021,602,3,104,275,379
13/05/2021,509,3,27,176,203
13/05/2021,579,3,10,41,51
13/05/2021,322,3,21,94,115
13/05/2021,438,3,38,108,146
13/05/2021,472,3,76,266,342
13/05/2021,715,3,75,171,246
13/05/2021,58,3,34,164,198
13/05/2021,308,3,25,144,169
13/05/2021,603,3,79,179,258
13/05/2021,403,3,56,165,221
13/05/2021,764,3,10,31,41
13/05/2021,218,3,56,256,312
13/05/2021,246,3,94,360,454
13/05/2021,374,3,34,67,101
13/05/2021,87,3,54,205,259
13/05/2021,625,3,24,83,107
13/05/2021,91,3,35,131,166
13/05/2021,435,3,35,118,153
13/05/2021,205,3,17,86,103
13/05/2021,533,3,30,98,128
13/05/2021,631,3,9,30,39
13/05/2021,749,3,22,160,182
13/05/2021,737,3,12,52,64
13/05/2021,572,3,33,138,171
13/05/2021,384,3,40,112,152
13/05/2021,349,3,20,104,124
13/05/2021,215,3,13,80,93
13/05/2021,323,3,13,60,73
13/05/2021,75,3,54,198,252
13/05/2021,887,3,6,31,37
13/05/2021,619,3,25,44,69
13/05/2021,77,3,49,200,249
13/05/2021,556,3,81,203,284
13/05/2021,219,3,24,114,138
13/05/2021,544,3,38,124,162
13/05/2021,633,3,14,75,89
13/05/2021,564,3,31,129,160
13/05/2021,129,3,53,173,226
13/05/2021,616,3,52,149,201
13/05/2021,756,3,42,205,247
13/05/2021,9,3,41,113,154
13/05/2021,662,3,80,277,357
13/05/2021,135,3,68,225,293
13/05/2021,68,3,32,178,210
13/05/2021,428,3,29,114,143
13/05/2021,884,3,6,106,112
13/05/2021,344,3,33,92,125
13/05/2021,115,3,18,62,80
13/05/2021,542,3,68,155,223
13/05/2021,933,3,0,1,1
13/05/2021,397,3,18,82,100
13/05/2021,670,3,177,478,655
13/05/2021,249,3,103,393,496
13/05/2021,833,3,10,63,73
13/05/2021,48,3,20,68,88
13/05/2021,853,3,26,88,114
13/05/2021,557,3,37,105,142
13/05/2021,300,3,78,361,439
13/05/2021,312,3,39,76,115
13/05/2021,898,3,33,44,77
13/05/2021,348,3,14,101,115
13/05/2021,540,3,46,181,227
13/05/2021,851,3,20,103,123
13/05/2021,768,3,47,121,168
13/05/2021,782,3,42,183,225
13/05/2021,464,3,48,205,253
13/05/2021,72,3,56,211,267
13/05/2021,813,3,38,115,153
13/05/2021,622,3,70,222,292
13/05/2021,139,3,36,133,169
13/05/2021,92,3,44,161,205
13/05/2021,760,3,30,105,135
13/05/2021,3,3,29,113,142
13/05/2021,422,3,35,116,151
13/05/2021,754,3,35,181,216
13/05/2021,202,3,52,219,271
13/05/2021,518,3,17,79,96
13/05/2021,292,3,93,379,472
13/05/2021,204,3,20,79,99
13/05/2021,642,3,32,114,146
13/05/2021,902,3,30,110,140
13/05/2021,338,3,44,201,245
13/05/2021,212,3,64,282,346
13/05/2021,304,3,34,160,194
13/05/2021,210,3,32,118,150
13/05/2021,493,3,16,87,103
13/05/2021,117,3,63,203,266
13/05/2021,78,3,121,383,504
13/05/2021,411,3,43,217,260
13/05/2021,330,3,27,219,246
13/05/2021,807,3,36,90,126
13/05/2021,107,3,96,294,390
13/05/2021,5,3,27,114,141
13/05/2021,679,3,44,121,165
13/05/2021,530,3,21,59,80
13/05/2021,559,3,70,191,261
13/05/2021,668,3,15,79,94
13/05/2021,476,3,23,121,144
13/05/2021,290,3,74,325,399
13/05/2021,821,3,35,157,192
13/05/2021,174,3,25,73,98
13/05/2021,357,3,62,211,273
13/05/2021,38,3,34,148,182
13/05/2021,316,3,24,137,161
13/05/2021,407,3,29,181,210
13/05/2021,875,3,22,101,123
13/05/2021,936,3,3,5,8
13/05/2021,321,3,33,71,104
13/05/2021,600,3,115,391,506
13/05/2021,213,3,58,275,333
13/05/2021,51,3,78,297,375
13/05/2021,684,3,30,131,161
13/05/2021,128,3,15,119,134
13/05/2021,138,3,41,151,192
13/05/2021,836,3,33,182,215
13/05/2021,427,3,84,319,403
13/05/2021,163,3,19,107,126
13/05/2021,909,3,0,11,11
13/05/2021,354,3,1,1,2
13/05/2021,417,3,37,206,243
13/05/2021,252,3,35,97,132
13/05/2021,266,3,27,98,125
13/05/2021,726,3,22,113,135
13/05/2021,315,3,8,50,58
13/05/2021,649,3,20,80,100
13/05/2021,871,3,38,114,152
13/05/2021,169,3,20,131,151
13/05/2021,720,3,19,95,114
13/05/2021,548,3,32,77,109
13/05/2021,747,3,18,91,109
13/05/2021,297,3,52,262,314
13/05/2021,46,3,30,86,116
13/05/2021,145,3,27,142,169
13/05/2021,353,3,12,38,50
13/05/2021,200,3,26,69,95
13/05/2021,25,3,42,154,196
13/05/2021,792,3,27,82,109
13/05/2021,442,3,34,156,190
13/05/2021,677,3,17,73,90
13/05/2021,444,3,36,159,195
13/05/2021,922,3,0,2,2
13/05/2021,448,3,97,342,439
13/05/2021,591,3,27,98,125
13/05/2021,507,3,39,289,328
13/05/2021,581,3,43,96,139
13/05/2021,652,3,12,56,68
13/05/2021,119,3,49,169,218
13/05/2021,904,3,46,187,233
13/05/2021,231,3,31,160,191
13/05/2021,687,3,29,130,159
13/05/2021,809,3,20,110,130
13/05/2021,608,3,74,287,361
13/05/2021,245,3,105,381,486
13/05/2021,133,3,19,70,89
13/05/2021,555,3,66,175,241
14/05/2021,444,3,24,150,174
14/05/2021,809,3,15,74,89
14/05/2021,448,3,123,543,666
14/05/2021,25,3,29,121,150
14/05/2021,245,3,110,594,704
14/05/2021,904,3,54,265,319
14/05/2021,581,3,30,148,178
14/05/2021,555,3,64,249,313
14/05/2021,46,3,26,91,117
14/05/2021,145,3,35,156,191
14/05/2021,652,3,7,41,48
14/05/2021,792,3,42,101,143
14/05/2021,442,3,25,213,238
14/05/2021,119,3,69,292,361
14/05/2021,231,3,33,176,209
14/05/2021,133,3,22,86,108
14/05/2021,591,3,22,79,101
14/05/2021,200,3,17,63,80
14/05/2021,353,3,9,43,52
14/05/2021,608,3,92,528,620
14/05/2021,507,3,59,341,400
14/05/2021,677,3,14,81,95
14/05/2021,922,3,0,3,3
14/05/2021,687,3,32,156,188
14/05/2021,457,3,24,76,100
14/05/2021,655,3,39,199,238
14/05/2021,635,3,34,195,229
14/05/2021,463,3,100,341,441
14/05/2021,692,3,35,122,157
14/05/2021,663,3,28,142,170
14/05/2021,840,3,27,215,242
14/05/2021,453,3,27,167,194
14/05/2021,140,3,11,86,97
14/05/2021,877,3,3,34,37
14/05/2021,787,3,103,556,659
14/05/2021,521,3,17,56,73
14/05/2021,873,3,35,173,208
14/05/2021,118,3,70,244,314
14/05/2021,325,3,20,118,138
14/05/2021,539,3,43,173,216
14/05/2021,734,3,16,66,82
14/05/2021,925,3,1,1,2
14/05/2021,49,3,22,76,98
14/05/2021,799,3,30,64,94
14/05/2021,284,3,11,50,61
14/05/2021,230,3,42,164,206
14/05/2021,234,3,27,80,107
14/05/2021,6,3,36,143,179
14/05/2021,258,3,143,585,728
14/05/2021,364,3,100,254,354
14/05/2021,923,3,0,3,3
14/05/2021,938,3,0,3,3
14/05/2021,594,3,51,291,342
14/05/2021,755,3,37,293,330
14/05/2021,183,3,14,83,97
14/05/2021,475,3,55,221,276
14/05/2021,193,3,48,195,243
14/05/2021,617,3,20,68,88
14/05/2021,917,3,2,28,30
14/05/2021,262,3,37,107,144
14/05/2021,865,3,21,76,97
14/05/2021,106,3,58,321,379
14/05/2021,519,3,25,119,144
14/05/2021,848,3,58,262,320
14/05/2021,932,3,0,11,11
14/05/2021,451,3,138,573,711
14/05/2021,228,3,31,164,195
14/05/2021,699,3,24,96,120
14/05/2021,76,3,60,356,416
14/05/2021,220,3,25,107,132
14/05/2021,285,3,14,90,104
14/05/2021,385,3,33,151,184
14/05/2021,432,3,33,285,318
14/05/2021,750,3,46,235,281
14/05/2021,626,3,22,100,122
14/05/2021,805,3,21,95,116
14/05/2021,84,3,101,271,372
14/05/2021,294,3,51,216,267
14/05/2021,206,3,4,8,12
14/05/2021,857,3,55,262,317
14/05/2021,34,3,17,107,124
14/05/2021,143,3,84,338,422
14/05/2021,180,3,27,140,167
14/05/2021,886,3,0,23,23
14/05/2021,623,3,43,204,247
14/05/2021,108,3,16,78,94
14/05/2021,860,3,28,118,146
14/05/2021,429,3,33,233,266
14/05/2021,480,3,19,71,90
14/05/2021,767,3,107,419,526
14/05/2021,885,3,6,135,141
14/05/2021,588,3,24,87,111
14/05/2021,250,3,82,214,296
14/05/2021,33,3,58,255,313
14/05/2021,232,3,27,147,174
14/05/2021,392,3,25,99,124
14/05/2021,366,3,19,53,72
14/05/2021,177,3,9,45,54
14/05/2021,120,3,32,122,154
14/05/2021,854,3,89,324,413
14/05/2021,274,3,0,20,20
14/05/2021,835,3,43,168,211
14/05/2021,277,3,38,125,163
14/05/2021,837,3,48,299,347
14/05/2021,257,3,127,463,590
14/05/2021,32,3,28,100,128
14/05/2021,176,3,36,121,157
14/05/2021,389,3,50,231,281
14/05/2021,103,3,70,313,383
14/05/2021,709,3,60,200,260
14/05/2021,121,3,148,436,584
14/05/2021,855,3,34,194,228
14/05/2021,434,3,7,34,41
14/05/2021,505,3,12,73,85
14/05/2021,314,3,9,52,61
14/05/2021,831,3,36,162,198
14/05/2021,302,3,101,800,901
14/05/2021,727,3,40,161,201
14/05/2021,536,3,32,139,171
14/05/2021,387,3,52,131,183
14/05/2021,367,3,36,202,238
14/05/2021,693,3,18,76,94
14/05/2021,908,3,7,76,83
14/05/2021,926,3,0,9,9
14/05/2021,914,3,4,5,9
14/05/2021,818,3,102,290,392
14/05/2021,490,3,12,70,82
14/05/2021,158,3,23,106,129
14/05/2021,531,3,46,181,227
14/05/2021,96,3,43,188,231
14/05/2021,486,3,31,174,205
14/05/2021,791,3,28,223,251
14/05/2021,441,3,89,337,426
14/05/2021,643,3,28,152,180
14/05/2021,410,3,38,354,392
14/05/2021,757,3,79,256,335
14/05/2021,820,3,24,151,175
14/05/2021,327,3,74,307,381
14/05/2021,2,3,35,138,173
14/05/2021,830,3,169,522,691
14/05/2021,256,3,42,120,162
14/05/2021,339,3,41,163,204
14/05/2021,203,3,19,120,139
14/05/2021,921,3,0,8,8
14/05/2021,732,3,11,84,95
14/05/2021,53,3,47,153,200
14/05/2021,386,3,79,402,481
14/05/2021,70,3,58,351,409
14/05/2021,170,3,31,173,204
14/05/2021,711,3,27,100,127
14/05/2021,638,3,35,158,193
14/05/2021,614,3,15,84,99
14/05/2021,409,3,16,78,94
14/05/2021,717,3,21,110,131
14/05/2021,424,3,66,719,785
14/05/2021,11,3,21,95,116
14/05/2021,780,3,115,493,608
14/05/2021,705,3,9,47,56
14/05/2021,866,3,65,305,370
14/05/2021,829,3,48,135,183
14/05/2021,675,3,19,74,93
14/05/2021,383,3,84,458,542
14/05/2021,235,3,26,215,241
14/05/2021,752,3,67,321,388
14/05/2021,534,3,26,108,134
14/05/2021,658,3,23,120,143
14/05/2021,418,3,18,79,97
14/05/2021,60,3,8,45,53
14/05/2021,924,3,0,7,7
14/05/2021,900,3,0,8,8
14/05/2021,863,3,17,65,82
14/05/2021,632,3,8,25,33
14/05/2021,194,3,1,2,3
14/05/2021,918,3,0,9,9
14/05/2021,681,3,34,142,176
14/05/2021,88,3,23,79,102
14/05/2021,815,3,124,531,655
14/05/2021,172,3,29,177,206
14/05/2021,890,3,8,82,90
14/05/2021,334,3,93,283,376
14/05/2021,520,3,19,108,127
14/05/2021,723,3,31,181,212
14/05/2021,99,3,104,478,582
14/05/2021,466,3,21,133,154
14/05/2021,64,3,16,54,70
14/05/2021,485,3,21,119,140
14/05/2021,19,3,35,191,226
14/05/2021,868,3,101,331,432
14/05/2021,803,3,38,201,239
14/05/2021,101,3,54,285,339
14/05/2021,738,3,36,122,158
14/05/2021,460,3,19,113,132
14/05/2021,328,3,24,107,131
14/05/2021,261,3,158,625,783
14/05/2021,82,3,41,182,223
14/05/2021,359,3,27,102,129
14/05/2021,454,3,38,288,326
14/05/2021,288,3,13,94,107
14/05/2021,910,3,6,136,142
14/05/2021,843,3,16,80,96
14/05/2021,495,3,21,71,92
14/05/2021,892,3,11,30,41
14/05/2021,44,3,74,301,375
14/05/2021,595,3,37,115,152
14/05/2021,719,3,19,64,83
14/05/2021,532,3,150,634,784
14/05/2021,876,3,1,12,13
14/05/2021,874,3,19,119,138
14/05/2021,577,3,29,179,208
14/05/2021,401,3,15,95,110
14/05/2021,296,3,31,127,158
14/05/2021,920,3,0,5,5
14/05/2021,416,3,9,75,84
14/05/2021,281,3,30,155,185
14/05/2021,790,3,35,205,240
14/05/2021,882,3,0,41,41
14/05/2021,267,3,21,82,103
14/05/2021,707,3,51,187,238
14/05/2021,450,3,15,70,85
14/05/2021,491,3,56,323,379
14/05/2021,446,3,25,212,237
14/05/2021,784,3,77,384,461
14/05/2021,182,3,29,123,152
14/05/2021,522,3,51,228,279
14/05/2021,66,3,29,166,195
14/05/2021,239,3,50,354,404
14/05/2021,666,3,30,147,177
14/05/2021,23,3,18,66,84
14/05/2021,379,3,37,210,247
14/05/2021,896,3,177,549,726
14/05/2021,470,3,41,180,221
14/05/2021,849,3,34,202,236
14/05/2021,553,3,21,51,72
14/05/2021,50,3,22,81,103
14/05/2021,801,3,24,168,192
14/05/2021,819,3,53,191,244
14/05/2021,847,3,2,37,39
14/05/2021,573,3,38,187,225
14/05/2021,192,3,21,84,105
14/05/2021,654,3,28,158,186
14/05/2021,251,3,15,89,104
14/05/2021,247,3,76,432,508
14/05/2021,162,3,106,342,448
14/05/2021,253,3,16,71,87
14/05/2021,393,3,20,80,100
14/05/2021,399,3,56,306,362
14/05/2021,825,3,37,175,212
14/05/2021,462,3,23,175,198
14/05/2021,186,3,38,115,153
14/05/2021,56,3,41,225,266
14/05/2021,512,3,6,60,66
14/05/2021,683,3,28,133,161
14/05/2021,15,3,67,235,302
14/05/2021,269,3,18,66,84
14/05/2021,436,3,23,244,267
14/05/2021,597,3,11,73,84
14/05/2021,474,3,18,100,118
14/05/2021,350,3,17,100,117
14/05/2021,648,3,19,108,127
14/05/2021,332,3,24,104,128
14/05/2021,17,3,17,88,105
14/05/2021,864,3,20,96,116
14/05/2021,413,3,42,390,432
14/05/2021,589,3,17,82,99
14/05/2021,147,3,26,134,160
14/05/2021,776,3,34,165,199
14/05/2021,287,3,136,942,1078
14/05/2021,571,3,38,143,181
14/05/2021,42,3,21,84,105
14/05/2021,153,3,34,167,201
14/05/2021,888,3,2,34,36
14/05/2021,607,3,87,498,585
14/05/2021,198,3,29,168,197
14/05/2021,361,3,92,250,342
14/05/2021,561,3,13,57,70
14/05/2021,547,3,170,525,695
14/05/2021,794,3,99,330,429
14/05/2021,164,3,23,140,163
14/05/2021,567,3,54,192,246
14/05/2021,149,3,23,146,169
14/05/2021,587,3,11,20,31
14/05/2021,27,3,108,418,526
14/05/2021,746,3,26,117,143
14/05/2021,721,3,157,680,837
14/05/2021,673,3,22,144,166
14/05/2021,736,3,6,54,60
14/05/2021,90,3,22,101,123
14/05/2021,524,3,34,170,204
14/05/2021,931,3,0,1,1
14/05/2021,456,3,22,131,153
14/05/2021,811,3,17,89,106
14/05/2021,168,3,12,93,105
14/05/2021,159,3,41,181,222
14/05/2021,713,3,59,815,874
14/05/2021,229,3,50,258,308
14/05/2021,770,3,114,458,572
14/05/2021,628,3,26,71,97
14/05/2021,735,3,11,66,77
14/05/2021,155,3,62,264,326
14/05/2021,54,3,20,80,100
14/05/2021,528,3,24,73,97
14/05/2021,565,3,68,282,350
14/05/2021,458,3,25,197,222
14/05/2021,478,3,46,115,161
14/05/2021,788,3,100,546,646
14/05/2021,178,3,34,128,162
14/05/2021,786,3,50,228,278
14/05/2021,489,3,9,39,48
14/05/2021,237,3,90,447,537
14/05/2021,279,3,31,159,190
14/05/2021,318,3,42,216,258
14/05/2021,313,3,8,50,58
14/05/2021,329,3,74,311,385
14/05/2021,55,3,16,93,109
14/05/2021,459,3,32,168,200
14/05/2021,808,3,84,352,436
14/05/2021,844,3,16,97,113
14/05/2021,181,3,19,90,109
14/05/2021,698,3,38,228,266
14/05/2021,337,3,9,60,69
14/05/2021,508,3,50,248,298
14/05/2021,550,3,48,182,230
14/05/2021,319,3,7,50,57
14/05/2021,911,3,40,227,267
14/05/2021,814,3,21,86,107
14/05/2021,891,3,31,109,140
14/05/2021,299,3,59,266,325
14/05/2021,856,3,55,225,280
14/05/2021,716,3,20,89,109
14/05/2021,913,3,3,1,4
14/05/2021,724,3,152,457,609
14/05/2021,301,3,123,813,936
14/05/2021,98,3,81,351,432
14/05/2021,380,3,22,150,172
14/05/2021,400,3,11,71,82
14/05/2021,897,3,5,15,20
14/05/2021,777,3,32,89,121
14/05/2021,28,3,24,76,100
14/05/2021,423,3,66,702,768
14/05/2021,187,3,23,109,132
14/05/2021,895,3,19,113,132
14/05/2021,276,3,33,150,183
14/05/2021,305,3,32,171,203
14/05/2021,238,3,91,511,602
14/05/2021,785,3,91,453,544
14/05/2021,189,3,14,74,88
14/05/2021,286,3,34,178,212
14/05/2021,570,3,38,150,188
14/05/2021,696,3,37,137,174
14/05/2021,190,3,27,140,167
14/05/2021,420,3,115,429,544
14/05/2021,259,3,129,489,618
14/05/2021,593,3,92,437,529
14/05/2021,243,3,106,603,709
14/05/2021,526,3,29,90,119
14/05/2021,817,3,28,145,173
14/05/2021,131,3,63,259,322
14/05/2021,342,3,20,118,138
14/05/2021,151,3,15,86,101
14/05/2021,778,3,46,226,272
14/05/2021,271,3,19,71,90
14/05/2021,620,3,0,1,1
14/05/2021,184,3,18,90,108
14/05/2021,365,3,23,72,95
14/05/2021,689,3,42,139,181
14/05/2021,255,3,6,6,12
14/05/2021,939,3,0,4,4
14/05/2021,870,3,10,43,53
14/05/2021,340,3,46,181,227
14/05/2021,894,3,43,166,209
14/05/2021,656,3,10,96,106
14/05/2021,733,3,14,105,119
14/05/2021,355,3,10,55,65
14/05/2021,501,3,55,338,393
14/05/2021,697,3,41,214,255
14/05/2021,188,3,33,151,184
14/05/2021,636,3,20,93,113
14/05/2021,859,3,6,29,35
14/05/2021,610,3,76,435,511
14/05/2021,80,3,14,70,84
14/05/2021,499,3,22,119,141
14/05/2021,601,3,47,215,262
14/05/2021,97,3,76,278,354
14/05/2021,878,3,1,40,41
14/05/2021,514,3,6,58,64
14/05/2021,660,3,16,93,109
14/05/2021,265,3,40,120,160
14/05/2021,111,3,52,269,321
14/05/2021,1,3,35,139,174
14/05/2021,701,3,8,106,114
14/05/2021,391,3,51,216,267
14/05/2021,371,3,22,103,125
14/05/2021,823,3,40,126,166
14/05/2021,398,3,8,23,31
14/05/2021,586,3,73,451,524
14/05/2021,504,3,10,48,58
14/05/2021,795,3,19,178,197
14/05/2021,537,3,47,236,283
14/05/2021,492,3,14,64,78
14/05/2021,858,3,59,274,333
14/05/2021,883,3,6,155,161
14/05/2021,613,3,13,45,58
14/05/2021,558,3,17,80,97
14/05/2021,702,3,11,127,138
14/05/2021,175,3,20,77,97
14/05/2021,93,3,38,248,286
14/05/2021,889,3,0,8,8
14/05/2021,378,3,16,109,125
14/05/2021,903,3,0,1,1
14/05/2021,69,3,31,141,172
14/05/2021,406,3,65,228,293
14/05/2021,477,3,14,95,109
14/05/2021,535,3,30,130,160
14/05/2021,901,3,2,5,7
14/05/2021,272,3,30,145,175
14/05/2021,804,3,94,471,565
14/05/2021,934,3,0,23,23
14/05/2021,104,3,64,208,272
14/05/2021,899,3,53,309,362
14/05/2021,402,3,46,188,234
14/05/2021,83,3,134,561,695
14/05/2021,112,3,19,71,90
14/05/2021,264,3,33,112,145
14/05/2021,688,3,33,149,182
14/05/2021,479,3,16,65,81
14/05/2021,248,3,37,176,213
14/05/2021,408,3,48,430,478
14/05/2021,105,3,61,188,249
14/05/2021,125,3,32,111,143
14/05/2021,123,3,19,60,79
14/05/2021,798,3,85,289,374
14/05/2021,646,3,37,136,173
14/05/2021,935,3,0,2,2
14/05/2021,196,3,24,95,119
14/05/2021,585,3,86,291,377
14/05/2021,166,3,20,132,152
14/05/2021,497,3,72,318,390
14/05/2021,7,3,37,146,183
14/05/2021,774,3,22,84,106
14/05/2021,157,3,49,150,199
14/05/2021,298,3,130,958,1088
14/05/2021,759,3,12,81,93
14/05/2021,488,3,29,85,114
14/05/2021,18,3,28,131,159
14/05/2021,704,3,9,53,62
14/05/2021,879,3,3,45,48
14/05/2021,154,3,35,173,208
14/05/2021,47,3,32,106,138
14/05/2021,826,3,41,219,260
14/05/2021,236,3,35,185,220
14/05/2021,221,3,24,106,130
14/05/2021,751,3,4,16,20
14/05/2021,242,3,96,573,669
14/05/2021,765,3,25,140,165
14/05/2021,195,3,19,74,93
14/05/2021,95,3,68,331,399
14/05/2021,309,3,13,45,58
14/05/2021,59,3,23,108,131
14/05/2021,161,3,105,342,447
14/05/2021,443,3,25,223,248
14/05/2021,802,3,43,340,383
14/05/2021,37,3,25,66,91
14/05/2021,244,3,40,254,294
14/05/2021,473,3,23,89,112
14/05/2021,604,3,84,264,348
14/05/2021,144,3,29,160,189
14/05/2021,842,3,7,18,25
14/05/2021,850,3,109,356,465
14/05/2021,289,3,51,258,309
14/05/2021,124,3,17,54,71
14/05/2021,185,3,17,115,132
14/05/2021,30,3,51,164,215
14/05/2021,61,3,32,184,216
14/05/2021,846,3,4,52,56
14/05/2021,43,3,33,166,199
14/05/2021,217,3,57,385,442
14/05/2021,566,3,14,76,90
14/05/2021,712,3,27,105,132
14/05/2021,907,3,59,299,358
14/05/2021,637,3,54,331,385
14/05/2021,797,3,59,185,244
14/05/2021,114,3,38,150,188
14/05/2021,280,3,18,79,97
14/05/2021,311,3,36,161,197
14/05/2021,500,3,3,45,48
14/05/2021,465,3,24,231,255
14/05/2021,356,3,40,242,282
14/05/2021,293,3,72,556,628
14/05/2021,783,3,41,312,353
14/05/2021,79,3,44,126,170
14/05/2021,333,3,58,626,684
14/05/2021,360,3,34,178,212
14/05/2021,824,3,95,323,418
14/05/2021,720,3,20,91,111
14/05/2021,315,3,11,83,94
14/05/2021,747,3,21,84,105
14/05/2021,726,3,24,100,124
14/05/2021,548,3,25,66,91
14/05/2021,169,3,29,167,196
14/05/2021,297,3,78,668,746
14/05/2021,649,3,27,90,117
14/05/2021,871,3,40,220,260
14/05/2021,116,3,32,126,158
14/05/2021,606,3,61,190,251
14/05/2021,331,3,27,116,143
14/05/2021,81,3,13,71,84
14/05/2021,645,3,39,147,186
14/05/2021,388,3,39,228,267
14/05/2021,771,3,32,237,269
14/05/2021,351,3,92,342,434
14/05/2021,291,3,102,797,899
14/05/2021,773,3,17,76,93
14/05/2021,552,3,57,204,261
14/05/2021,657,3,57,228,285
14/05/2021,560,3,68,264,332
14/05/2021,437,3,33,218,251
14/05/2021,4,3,26,206,232
14/05/2021,152,3,30,143,173
14/05/2021,226,3,29,151,180
14/05/2021,57,3,33,213,246
14/05/2021,67,3,26,154,180
14/05/2021,525,3,33,156,189
14/05/2021,368,3,37,197,234
14/05/2021,211,3,60,406,466
14/05/2021,669,3,28,147,175
14/05/2021,498,3,20,67,87
14/05/2021,915,3,0,29,29
14/05/2021,806,3,45,225,270
14/05/2021,396,3,18,75,93
14/05/2021,781,3,79,370,449
14/05/2021,419,3,69,307,376
14/05/2021,207,3,20,118,138
14/05/2021,590,3,0,3,3
14/05/2021,867,3,33,110,143
14/05/2021,347,3,114,340,454
14/05/2021,779,3,23,66,89
14/05/2021,20,3,16,41,57
14/05/2021,629,3,22,136,158
14/05/2021,789,3,31,145,176
14/05/2021,224,3,33,153,186
14/05/2021,869,3,94,247,341
14/05/2021,282,3,31,157,188
14/05/2021,335,3,26,136,162
14/05/2021,65,3,33,190,223
14/05/2021,592,3,35,199,234
14/05/2021,254,3,20,72,92
14/05/2021,676,3,16,58,74
14/05/2021,130,3,84,307,391
14/05/2021,515,3,19,81,100
14/05/2021,363,3,97,257,354
14/05/2021,483,3,31,153,184
14/05/2021,664,3,40,187,227
14/05/2021,31,3,20,139,159
14/05/2021,346,3,12,73,85
14/05/2021,618,3,20,106,126
14/05/2021,160,3,4,9,13
14/05/2021,21,3,30,142,172
14/05/2021,880,3,0,25,25
14/05/2021,214,3,60,409,469
14/05/2021,225,3,29,140,169
14/05/2021,208,3,14,90,104
14/05/2021,725,3,44,137,181
14/05/2021,827,3,101,419,520
14/05/2021,845,3,21,87,108
14/05/2021,455,3,14,135,149
14/05/2021,741,3,12,74,86
14/05/2021,414,3,50,432,482
14/05/2021,343,3,14,88,102
14/05/2021,358,3,54,374,428
14/05/2021,179,3,17,79,96
14/05/2021,156,3,35,192,227
14/05/2021,562,3,14,48,62
14/05/2021,905,3,6,2,8
14/05/2021,641,3,22,133,155
14/05/2021,494,3,23,110,133
14/05/2021,653,3,8,46,54
14/05/2021,201,3,21,83,104
14/05/2021,621,3,25,127,152
14/05/2021,445,3,31,224,255
14/05/2021,828,3,56,161,217
14/05/2021,694,3,16,123,139
14/05/2021,517,3,20,84,104
14/05/2021,680,3,46,147,193
14/05/2021,651,3,27,102,129
14/05/2021,661,3,39,192,231
14/05/2021,425,3,38,312,350
14/05/2021,421,3,97,331,428
14/05/2021,580,3,44,185,229
14/05/2021,578,3,10,60,70
14/05/2021,260,3,158,631,789
14/05/2021,461,3,50,236,286
14/05/2021,469,3,23,211,234
14/05/2021,24,3,18,67,85
14/05/2021,583,3,30,164,194
14/05/2021,381,3,4,7,11
14/05/2021,685,3,30,143,173
14/05/2021,369,3,69,278,347
14/05/2021,731,3,19,81,100
14/05/2021,86,3,21,97,118
14/05/2021,216,3,23,117,140
14/05/2021,748,3,17,67,84
14/05/2021,624,3,9,54,63
14/05/2021,233,3,36,146,182
14/05/2021,440,3,49,310,359
14/05/2021,634,3,36,139,175
14/05/2021,487,3,24,113,137
14/05/2021,263,3,48,197,245
14/05/2021,841,3,7,208,215
14/05/2021,511,3,19,117,136
14/05/2021,703,3,9,95,104
14/05/2021,268,3,44,230,274
14/05/2021,8,3,50,239,289
14/05/2021,682,3,17,74,91
14/05/2021,546,3,55,210,265
14/05/2021,800,3,25,119,144
14/05/2021,730,3,12,71,83
14/05/2021,471,3,14,128,142
14/05/2021,303,3,69,429,498
14/05/2021,447,3,18,130,148
14/05/2021,22,3,29,131,160
14/05/2021,761,3,13,64,77
14/05/2021,134,3,75,270,345
14/05/2021,45,3,24,189,213
14/05/2021,582,3,125,593,718
14/05/2021,706,3,57,180,237
14/05/2021,412,3,10,135,145
14/05/2021,199,3,13,54,67
14/05/2021,341,3,138,394,532
14/05/2021,39,3,32,174,206
14/05/2021,543,3,164,512,676
14/05/2021,126,3,33,168,201
14/05/2021,102,3,66,283,349
14/05/2021,930,3,2,23,25
14/05/2021,743,3,11,79,90
14/05/2021,510,3,49,299,348
14/05/2021,326,3,10,41,51
14/05/2021,612,3,81,451,532
14/05/2021,426,3,15,138,153
14/05/2021,481,3,29,130,159
14/05/2021,275,3,34,188,222
14/05/2021,452,3,25,219,244
14/05/2021,52,3,39,169,208
14/05/2021,772,3,32,193,225
14/05/2021,861,3,72,161,233
14/05/2021,691,3,27,134,161
14/05/2021,127,3,21,131,152
14/05/2021,906,3,2,10,12
14/05/2021,227,3,26,204,230
14/05/2021,222,3,23,76,99
14/05/2021,742,3,28,105,133
14/05/2021,310,3,70,391,461
14/05/2021,136,3,77,281,358
14/05/2021,728,3,24,165,189
14/05/2021,584,3,98,449,547
14/05/2021,404,3,79,305,384
14/05/2021,686,3,19,114,133
14/05/2021,352,3,40,181,221
14/05/2021,110,3,17,95,112
14/05/2021,506,3,58,313,371
14/05/2021,439,3,19,118,137
14/05/2021,832,3,23,137,160
14/05/2021,647,3,30,98,128
14/05/2021,574,3,27,141,168
14/05/2021,598,3,112,560,672
14/05/2021,838,3,20,96,116
14/05/2021,484,3,24,112,136
14/05/2021,714,3,42,151,193
14/05/2021,382,3,0,1,1
14/05/2021,431,3,26,116,142
14/05/2021,362,3,99,253,352
14/05/2021,209,3,18,120,138
14/05/2021,394,3,18,100,118
14/05/2021,739,3,14,76,90
14/05/2021,881,3,0,20,20
14/05/2021,167,3,27,191,218
14/05/2021,142,3,12,64,76
14/05/2021,390,3,45,236,281
14/05/2021,467,3,20,179,199
14/05/2021,816,3,63,373,436
14/05/2021,529,3,35,116,151
14/05/2021,12,3,6,40,46
14/05/2021,173,3,15,75,90
14/05/2021,433,3,121,471,592
14/05/2021,862,3,43,181,224
14/05/2021,496,3,6,55,61
14/05/2021,527,3,30,105,135
14/05/2021,605,3,83,281,364
14/05/2021,640,3,22,134,156
14/05/2021,13,3,15,86,101
14/05/2021,36,3,21,133,154
14/05/2021,468,3,23,162,185
14/05/2021,599,3,114,529,643
14/05/2021,395,3,23,92,115
14/05/2021,503,3,43,260,303
14/05/2021,405,3,22,74,96
14/05/2021,336,3,136,405,541
14/05/2021,273,3,80,316,396
14/05/2021,377,3,33,114,147
14/05/2021,283,3,19,116,135
14/05/2021,538,3,30,146,176
14/05/2021,872,3,30,84,114
14/05/2021,563,3,23,108,131
14/05/2021,137,3,58,289,347
14/05/2021,758,3,29,135,164
14/05/2021,575,3,9,38,47
14/05/2021,373,3,23,100,123
14/05/2021,569,3,42,170,212
14/05/2021,551,3,58,221,279
14/05/2021,650,3,41,201,242
14/05/2021,839,3,29,151,180
14/05/2021,430,3,22,140,162
14/05/2021,113,3,14,68,82
14/05/2021,376,3,18,63,81
14/05/2021,665,3,24,124,148
14/05/2021,372,3,84,327,411
14/05/2021,674,3,28,146,174
14/05/2021,197,3,33,142,175
14/05/2021,554,3,34,171,205
14/05/2021,295,3,35,267,302
14/05/2021,85,3,58,111,169
14/05/2021,639,3,25,115,140
14/05/2021,627,3,19,91,110
14/05/2021,35,3,26,156,182
14/05/2021,307,3,37,188,225
14/05/2021,270,3,12,72,84
14/05/2021,659,3,21,109,130
14/05/2021,919,3,21,146,167
14/05/2021,684,3,28,145,173
14/05/2021,128,3,20,129,149
14/05/2021,417,3,42,416,458
14/05/2021,266,3,20,77,97
14/05/2021,354,3,3,1,4
14/05/2021,600,3,117,574,691
14/05/2021,163,3,15,126,141
14/05/2021,936,3,2,14,16
14/05/2021,213,3,72,442,514
14/05/2021,252,3,22,84,106
14/05/2021,138,3,65,281,346
14/05/2021,51,3,66,384,450
14/05/2021,875,3,8,67,75
14/05/2021,836,3,42,372,414
14/05/2021,427,3,121,538,659
14/05/2021,321,3,22,87,109
14/05/2021,909,3,0,16,16
14/05/2021,616,3,35,158,193
14/05/2021,344,3,28,130,158
14/05/2021,115,3,15,81,96
14/05/2021,542,3,40,152,192
14/05/2021,9,3,32,171,203
14/05/2021,662,3,54,234,288
14/05/2021,428,3,18,101,119
14/05/2021,68,3,31,200,231
14/05/2021,884,3,7,145,152
14/05/2021,756,3,45,332,377
14/05/2021,129,3,78,326,404
14/05/2021,135,3,77,282,359
14/05/2021,933,3,0,3,3
14/05/2021,793,3,29,181,210
14/05/2021,602,3,94,357,451
14/05/2021,449,3,25,194,219
14/05/2021,722,3,12,60,72
14/05/2021,671,3,45,306,351
14/05/2021,775,3,20,123,143
14/05/2021,41,3,26,138,164
14/05/2021,171,3,10,39,49
14/05/2021,745,3,15,120,135
14/05/2021,700,3,38,214,252
14/05/2021,852,3,78,288,366
14/05/2021,615,3,31,146,177
14/05/2021,753,3,49,251,300
14/05/2021,278,3,27,134,161
14/05/2021,710,3,30,107,137
14/05/2021,122,3,40,136,176
14/05/2021,89,3,32,173,205
14/05/2021,100,3,98,475,573
14/05/2021,370,3,34,196,230
14/05/2021,71,3,23,115,138
14/05/2021,26,3,37,131,168
14/05/2021,812,3,19,129,148
14/05/2021,148,3,16,93,109
14/05/2021,240,3,94,548,642
14/05/2021,317,3,58,241,299
14/05/2021,345,3,35,91,126
14/05/2021,576,3,7,40,47
14/05/2021,513,3,14,77,91
14/05/2021,810,3,23,150,173
14/05/2021,63,3,18,83,101
14/05/2021,146,3,93,409,502
14/05/2021,633,3,23,116,139
14/05/2021,556,3,68,290,358
14/05/2021,619,3,24,79,103
14/05/2021,384,3,39,139,178
14/05/2021,215,3,14,79,93
14/05/2021,887,3,4,35,39
14/05/2021,77,3,64,407,471
14/05/2021,75,3,67,393,460
14/05/2021,219,3,16,96,112
14/05/2021,323,3,12,58,70
14/05/2021,349,3,17,81,98
14/05/2021,564,3,35,162,197
14/05/2021,544,3,33,134,167
14/05/2021,438,3,21,103,124
14/05/2021,472,3,120,481,601
14/05/2021,579,3,9,81,90
14/05/2021,715,3,58,184,242
14/05/2021,322,3,26,88,114
14/05/2021,308,3,29,162,191
14/05/2021,764,3,12,45,57
14/05/2021,509,3,45,231,276
14/05/2021,603,3,76,260,336
14/05/2021,58,3,44,369,413
14/05/2021,403,3,46,184,230
14/05/2021,218,3,60,412,472
14/05/2021,435,3,20,94,114
14/05/2021,631,3,6,19,25
14/05/2021,533,3,29,115,144
14/05/2021,205,3,16,109,125
14/05/2021,374,3,28,85,113
14/05/2021,91,3,25,116,141
14/05/2021,749,3,25,181,206
14/05/2021,737,3,8,68,76
14/05/2021,246,3,104,583,687
14/05/2021,572,3,43,173,216
14/05/2021,87,3,50,225,275
14/05/2021,625,3,14,94,108
14/05/2021,916,3,1,0,1
14/05/2021,174,3,15,59,74
14/05/2021,679,3,47,185,232
14/05/2021,38,3,32,152,184
14/05/2021,107,3,107,489,596
14/05/2021,476,3,16,98,114
14/05/2021,357,3,40,274,314
14/05/2021,559,3,68,269,337
14/05/2021,5,3,35,141,176
14/05/2021,290,3,109,834,943
14/05/2021,821,3,46,178,224
14/05/2021,530,3,22,96,118
14/05/2021,668,3,13,51,64
14/05/2021,407,3,35,346,381
14/05/2021,316,3,22,180,202
14/05/2021,782,3,37,315,352
14/05/2021,754,3,37,231,268
14/05/2021,813,3,30,108,138
14/05/2021,622,3,103,411,514
14/05/2021,642,3,25,137,162
14/05/2021,518,3,11,78,89
14/05/2021,204,3,24,109,133
14/05/2021,292,3,108,805,913
14/05/2021,422,3,60,261,321
14/05/2021,3,3,35,149,184
14/05/2021,202,3,45,318,363
14/05/2021,760,3,28,159,187
14/05/2021,464,3,41,249,290
14/05/2021,72,3,70,417,487
14/05/2021,139,3,62,299,361
14/05/2021,92,3,31,125,156
14/05/2021,898,3,21,60,81
14/05/2021,670,3,185,612,797
14/05/2021,348,3,10,69,79
14/05/2021,853,3,14,59,73
14/05/2021,833,3,18,70,88
14/05/2021,249,3,120,630,750
14/05/2021,540,3,57,215,272
14/05/2021,851,3,23,154,177
14/05/2021,557,3,23,95,118
14/05/2021,397,3,18,72,90
14/05/2021,768,3,44,203,247
14/05/2021,48,3,24,89,113
14/05/2021,312,3,27,84,111
14/05/2021,300,3,106,789,895
14/05/2021,902,3,24,92,116
14/05/2021,212,3,72,436,508
14/05/2021,338,3,46,211,257
14/05/2021,807,3,26,91,117
14/05/2021,411,3,53,437,490
14/05/2021,78,3,131,522,653
14/05/2021,117,3,89,347,436
14/05/2021,210,3,38,174,212
14/05/2021,493,3,23,94,117
14/05/2021,304,3,47,191,238
14/05/2021,330,3,28,228,256
15/05/2021,902,3,22,122,144
15/05/2021,210,3,38,173,211
15/05/2021,304,3,50,237,287
15/05/2021,493,3,26,113,139
15/05/2021,78,3,129,574,703
15/05/2021,411,3,73,617,690
15/05/2021,117,3,97,458,555
15/05/2021,338,3,53,214,267
15/05/2021,212,3,90,586,676
15/05/2021,807,3,30,98,128
15/05/2021,330,3,32,330,362
15/05/2021,185,3,22,141,163
15/05/2021,289,3,68,597,665
15/05/2021,61,3,34,301,335
15/05/2021,30,3,55,182,237
15/05/2021,604,3,101,325,426
15/05/2021,842,3,11,18,29
15/05/2021,124,3,17,79,96
15/05/2021,144,3,27,226,253
15/05/2021,850,3,109,454,563
15/05/2021,296,3,36,165,201
15/05/2021,784,3,74,472,546
15/05/2021,920,3,1,2,3
15/05/2021,239,3,61,500,561
15/05/2021,882,3,0,26,26
15/05/2021,182,3,27,140,167
15/05/2021,401,3,19,120,139
15/05/2021,446,3,32,307,339
15/05/2021,66,3,33,289,322
15/05/2021,450,3,16,79,95
15/05/2021,491,3,51,448,499
15/05/2021,416,3,10,82,92
15/05/2021,267,3,20,115,135
15/05/2021,666,3,38,169,207
15/05/2021,281,3,36,149,185
15/05/2021,522,3,60,339,399
15/05/2021,707,3,53,232,285
15/05/2021,790,3,30,260,290
15/05/2021,176,3,29,195,224
15/05/2021,277,3,43,141,184
15/05/2021,505,3,13,71,84
15/05/2021,855,3,41,247,288
15/05/2021,103,3,87,415,502
15/05/2021,837,3,56,326,382
15/05/2021,32,3,26,135,161
15/05/2021,257,3,113,550,663
15/05/2021,831,3,40,157,197
15/05/2021,709,3,60,253,313
15/05/2021,314,3,10,92,102
15/05/2021,835,3,45,224,269
15/05/2021,121,3,144,493,637
15/05/2021,434,3,7,41,48
15/05/2021,389,3,61,333,394
15/05/2021,258,3,133,686,819
15/05/2021,234,3,31,122,153
15/05/2021,787,3,117,729,846
15/05/2021,539,3,51,201,252
15/05/2021,118,3,76,342,418
15/05/2021,49,3,29,132,161
15/05/2021,873,3,47,200,247
15/05/2021,6,3,33,144,177
15/05/2021,230,3,46,233,279
15/05/2021,284,3,12,74,86
15/05/2021,521,3,16,70,86
15/05/2021,364,3,119,353,472
15/05/2021,325,3,16,197,213
15/05/2021,799,3,20,50,70
15/05/2021,925,3,1,4,5
15/05/2021,734,3,22,82,104
15/05/2021,923,3,0,3,3
15/05/2021,938,3,0,4,4
15/05/2021,245,3,126,852,978
15/05/2021,677,3,17,92,109
15/05/2021,231,3,42,162,204
15/05/2021,46,3,28,97,125
15/05/2021,591,3,24,109,133
15/05/2021,608,3,95,742,837
15/05/2021,133,3,29,135,164
15/05/2021,687,3,33,215,248
15/05/2021,448,3,135,675,810
15/05/2021,444,3,30,180,210
15/05/2021,25,3,29,151,180
15/05/2021,145,3,31,202,233
15/05/2021,652,3,9,49,58
15/05/2021,200,3,15,78,93
15/05/2021,507,3,52,503,555
15/05/2021,442,3,33,277,310
15/05/2021,581,3,41,181,222
15/05/2021,904,3,69,323,392
15/05/2021,555,3,74,307,381
15/05/2021,119,3,78,414,492
15/05/2021,792,3,50,132,182
15/05/2021,353,3,14,72,86
15/05/2021,809,3,20,78,98
15/05/2021,922,3,0,4,4
15/05/2021,463,3,104,449,553
15/05/2021,877,3,3,35,38
15/05/2021,453,3,35,213,248
15/05/2021,635,3,37,281,318
15/05/2021,663,3,35,174,209
15/05/2021,140,3,22,116,138
15/05/2021,840,3,34,317,351
15/05/2021,655,3,52,249,301
15/05/2021,692,3,42,181,223
15/05/2021,457,3,26,146,172
15/05/2021,588,3,26,122,148
15/05/2021,429,3,42,351,393
15/05/2021,366,3,22,72,94
15/05/2021,108,3,24,126,150
15/05/2021,767,3,114,625,739
15/05/2021,885,3,4,135,139
15/05/2021,623,3,51,289,340
15/05/2021,177,3,10,69,79
15/05/2021,480,3,24,82,106
15/05/2021,232,3,39,188,227
15/05/2021,274,3,0,18,18
15/05/2021,120,3,40,168,208
15/05/2021,392,3,34,138,172
15/05/2021,250,3,100,276,376
15/05/2021,854,3,94,425,519
15/05/2021,860,3,30,145,175
15/05/2021,33,3,62,366,428
15/05/2021,865,3,27,122,149
15/05/2021,519,3,30,199,229
15/05/2021,228,3,39,315,354
15/05/2021,917,3,3,32,35
15/05/2021,617,3,17,99,116
15/05/2021,848,3,59,343,402
15/05/2021,183,3,19,117,136
15/05/2021,755,3,48,371,419
15/05/2021,451,3,152,719,871
15/05/2021,932,3,1,9,10
15/05/2021,193,3,51,266,317
15/05/2021,106,3,56,397,453
15/05/2021,262,3,63,149,212
15/05/2021,594,3,57,323,380
15/05/2021,475,3,61,291,352
15/05/2021,805,3,21,103,124
15/05/2021,34,3,22,136,158
15/05/2021,84,3,100,420,520
15/05/2021,626,3,30,113,143
15/05/2021,206,3,4,7,11
15/05/2021,180,3,36,136,172
15/05/2021,432,3,41,327,368
15/05/2021,857,3,57,363,420
15/05/2021,750,3,38,289,327
15/05/2021,143,3,92,483,575
15/05/2021,220,3,37,125,162
15/05/2021,699,3,28,187,215
15/05/2021,294,3,56,258,314
15/05/2021,285,3,16,118,134
15/05/2021,886,3,1,22,23
15/05/2021,385,3,42,175,217
15/05/2021,76,3,68,512,580
15/05/2021,874,3,24,153,177
15/05/2021,577,3,42,263,305
15/05/2021,719,3,21,78,99
15/05/2021,44,3,74,374,448
15/05/2021,532,3,141,749,890
15/05/2021,595,3,45,156,201
15/05/2021,876,3,1,11,12
15/05/2021,424,3,75,897,972
15/05/2021,409,3,40,99,139
15/05/2021,829,3,55,165,220
15/05/2021,614,3,24,106,130
15/05/2021,638,3,42,210,252
15/05/2021,70,3,64,496,560
15/05/2021,711,3,22,134,156
15/05/2021,780,3,127,668,795
15/05/2021,170,3,28,282,310
15/05/2021,11,3,22,129,151
15/05/2021,866,3,63,398,461
15/05/2021,717,3,28,144,172
15/05/2021,705,3,8,64,72
15/05/2021,727,3,42,198,240
15/05/2021,387,3,46,217,263
15/05/2021,367,3,41,302,343
15/05/2021,302,3,134,1493,1627
15/05/2021,536,3,41,174,215
15/05/2021,914,3,3,4,7
15/05/2021,693,3,27,97,124
15/05/2021,926,3,0,14,14
15/05/2021,908,3,15,162,177
15/05/2021,531,3,44,235,279
15/05/2021,441,3,94,449,543
15/05/2021,410,3,57,470,527
15/05/2021,921,3,0,6,6
15/05/2021,820,3,31,170,201
15/05/2021,2,3,33,147,180
15/05/2021,53,3,48,158,206
15/05/2021,339,3,37,152,189
15/05/2021,203,3,24,201,225
15/05/2021,791,3,36,303,339
15/05/2021,327,3,66,402,468
15/05/2021,256,3,50,205,255
15/05/2021,386,3,86,565,651
15/05/2021,818,3,86,379,465
15/05/2021,486,3,33,209,242
15/05/2021,732,3,14,107,121
15/05/2021,490,3,12,89,101
15/05/2021,96,3,47,304,351
15/05/2021,158,3,22,123,145
15/05/2021,757,3,80,291,371
15/05/2021,830,3,160,567,727
15/05/2021,643,3,38,200,238
15/05/2021,892,3,16,39,55
15/05/2021,910,3,4,131,135
15/05/2021,495,3,17,101,118
15/05/2021,288,3,14,121,135
15/05/2021,843,3,25,131,156
15/05/2021,261,3,147,729,876
15/05/2021,82,3,51,259,310
15/05/2021,328,3,22,154,176
15/05/2021,454,3,45,337,382
15/05/2021,359,3,33,171,204
15/05/2021,194,3,1,6,7
15/05/2021,235,3,34,316,350
15/05/2021,863,3,10,101,111
15/05/2021,658,3,18,169,187
15/05/2021,681,3,39,188,227
15/05/2021,60,3,6,62,68
15/05/2021,675,3,23,89,112
15/05/2021,383,3,87,655,742
15/05/2021,900,3,9,30,39
15/05/2021,534,3,25,145,170
15/05/2021,752,3,66,402,468
15/05/2021,418,3,40,134,174
15/05/2021,918,3,0,16,16
15/05/2021,632,3,7,42,49
15/05/2021,924,3,0,4,4
15/05/2021,460,3,23,210,233
15/05/2021,520,3,30,125,155
15/05/2021,88,3,24,115,139
15/05/2021,172,3,25,268,293
15/05/2021,815,3,132,672,804
15/05/2021,64,3,26,81,107
15/05/2021,99,3,100,589,689
15/05/2021,334,3,111,364,475
15/05/2021,803,3,38,229,267
15/05/2021,890,3,11,68,79
15/05/2021,485,3,25,154,179
15/05/2021,723,3,36,225,261
15/05/2021,466,3,31,174,205
15/05/2021,868,3,95,428,523
15/05/2021,738,3,34,176,210
15/05/2021,19,3,45,296,341
15/05/2021,101,3,58,410,468
15/05/2021,37,3,29,87,116
15/05/2021,95,3,68,413,481
15/05/2021,309,3,11,71,82
15/05/2021,443,3,30,266,296
15/05/2021,473,3,24,106,130
15/05/2021,244,3,47,387,434
15/05/2021,802,3,50,441,491
15/05/2021,161,3,101,438,539
15/05/2021,195,3,12,85,97
15/05/2021,59,3,31,185,216
15/05/2021,380,3,29,190,219
15/05/2021,189,3,18,128,146
15/05/2021,895,3,19,135,154
15/05/2021,696,3,51,159,210
15/05/2021,305,3,31,216,247
15/05/2021,400,3,7,89,96
15/05/2021,897,3,5,14,19
15/05/2021,777,3,34,156,190
15/05/2021,785,3,89,597,686
15/05/2021,238,3,110,732,842
15/05/2021,276,3,38,143,181
15/05/2021,187,3,36,156,192
15/05/2021,570,3,43,231,274
15/05/2021,286,3,32,274,306
15/05/2021,423,3,76,894,970
15/05/2021,28,3,30,106,136
15/05/2021,864,3,15,121,136
15/05/2021,332,3,33,131,164
15/05/2021,287,3,165,1669,1834
15/05/2021,361,3,111,344,455
15/05/2021,413,3,65,556,621
15/05/2021,648,3,26,131,157
15/05/2021,776,3,28,217,245
15/05/2021,147,3,20,200,220
15/05/2021,607,3,91,707,798
15/05/2021,42,3,20,108,128
15/05/2021,198,3,37,179,216
15/05/2021,153,3,35,219,254
15/05/2021,17,3,15,126,141
15/05/2021,888,3,3,39,42
15/05/2021,589,3,20,110,130
15/05/2021,571,3,41,223,264
15/05/2021,801,3,29,210,239
15/05/2021,819,3,55,272,327
15/05/2021,896,3,173,605,778
15/05/2021,553,3,31,51,82
15/05/2021,849,3,39,307,346
15/05/2021,23,3,18,84,102
15/05/2021,50,3,28,138,166
15/05/2021,847,3,3,43,46
15/05/2021,573,3,38,264,302
15/05/2021,470,3,43,206,249
15/05/2021,379,3,47,240,287
15/05/2021,251,3,20,108,128
15/05/2021,269,3,16,91,107
15/05/2021,474,3,27,147,174
15/05/2021,597,3,20,115,135
15/05/2021,186,3,62,162,224
15/05/2021,247,3,121,591,712
15/05/2021,162,3,108,435,543
15/05/2021,654,3,24,189,213
15/05/2021,683,3,39,190,229
15/05/2021,393,3,27,122,149
15/05/2021,56,3,51,353,404
15/05/2021,825,3,50,222,272
15/05/2021,15,3,85,316,401
15/05/2021,436,3,34,265,299
15/05/2021,462,3,26,205,231
15/05/2021,399,3,71,425,496
15/05/2021,512,3,7,86,93
15/05/2021,192,3,19,107,126
15/05/2021,350,3,20,106,126
15/05/2021,253,3,23,119,142
15/05/2021,724,3,148,517,665
15/05/2021,508,3,46,362,408
15/05/2021,550,3,53,216,269
15/05/2021,808,3,90,424,514
15/05/2021,301,3,142,1468,1610
15/05/2021,329,3,66,410,476
15/05/2021,337,3,12,70,82
15/05/2021,319,3,3,61,64
15/05/2021,913,3,0,3,3
15/05/2021,698,3,47,333,380
15/05/2021,313,3,11,91,102
15/05/2021,55,3,17,140,157
15/05/2021,856,3,65,283,348
15/05/2021,459,3,32,211,243
15/05/2021,716,3,22,116,138
15/05/2021,181,3,20,116,136
15/05/2021,299,3,59,407,466
15/05/2021,844,3,17,105,122
15/05/2021,98,3,79,459,538
15/05/2021,911,3,36,336,372
15/05/2021,814,3,27,101,128
15/05/2021,891,3,33,132,165
15/05/2021,673,3,36,176,212
15/05/2021,159,3,31,213,244
15/05/2021,713,3,70,1070,1140
15/05/2021,561,3,13,67,80
15/05/2021,149,3,35,193,228
15/05/2021,27,3,111,551,662
15/05/2021,587,3,16,43,59
15/05/2021,164,3,19,211,230
15/05/2021,524,3,37,219,256
15/05/2021,770,3,126,637,763
15/05/2021,168,3,18,135,153
15/05/2021,229,3,65,348,413
15/05/2021,547,3,167,580,747
15/05/2021,456,3,27,172,199
15/05/2021,811,3,11,114,125
15/05/2021,567,3,53,280,333
15/05/2021,90,3,21,142,163
15/05/2021,721,3,160,799,959
15/05/2021,794,3,106,441,547
15/05/2021,931,3,0,3,3
15/05/2021,736,3,6,62,68
15/05/2021,746,3,34,143,177
15/05/2021,155,3,69,401,470
15/05/2021,788,3,113,745,858
15/05/2021,178,3,30,195,225
15/05/2021,565,3,79,342,421
15/05/2021,458,3,30,213,243
15/05/2021,279,3,36,163,199
15/05/2021,318,3,61,301,362
15/05/2021,54,3,20,109,129
15/05/2021,237,3,98,617,715
15/05/2021,478,3,45,144,189
15/05/2021,628,3,33,110,143
15/05/2021,735,3,8,77,85
15/05/2021,786,3,48,299,347
15/05/2021,306,3,0,2,2
15/05/2021,528,3,29,82,111
15/05/2021,489,3,8,38,46
15/05/2021,18,3,31,200,231
15/05/2021,154,3,37,216,253
15/05/2021,879,3,1,43,44
15/05/2021,47,3,40,136,176
15/05/2021,751,3,4,29,33
15/05/2021,759,3,10,88,98
15/05/2021,221,3,36,131,167
15/05/2021,236,3,52,319,371
15/05/2021,242,3,112,811,923
15/05/2021,488,3,30,154,184
15/05/2021,704,3,7,77,84
15/05/2021,765,3,34,180,214
15/05/2021,826,3,51,304,355
15/05/2021,878,3,1,43,44
15/05/2021,514,3,9,83,92
15/05/2021,701,3,12,136,148
15/05/2021,660,3,22,108,130
15/05/2021,265,3,66,182,248
15/05/2021,1,3,33,143,176
15/05/2021,391,3,56,312,368
15/05/2021,111,3,65,367,432
15/05/2021,823,3,45,178,223
15/05/2021,371,3,29,153,182
15/05/2021,939,3,0,3,3
15/05/2021,620,3,0,3,3
15/05/2021,817,3,32,204,236
15/05/2021,526,3,31,88,119
15/05/2021,365,3,27,94,121
15/05/2021,593,3,90,484,574
15/05/2021,184,3,23,137,160
15/05/2021,151,3,22,125,147
15/05/2021,778,3,61,327,388
15/05/2021,271,3,21,104,125
15/05/2021,243,3,119,870,989
15/05/2021,420,3,118,584,702
15/05/2021,342,3,29,134,163
15/05/2021,190,3,28,158,186
15/05/2021,689,3,50,193,243
15/05/2021,259,3,113,572,685
15/05/2021,255,3,4,11,15
15/05/2021,131,3,63,348,411
15/05/2021,733,3,19,140,159
15/05/2021,501,3,53,488,541
15/05/2021,80,3,16,75,91
15/05/2021,859,3,11,56,67
15/05/2021,656,3,19,165,184
15/05/2021,636,3,18,120,138
15/05/2021,610,3,79,590,669
15/05/2021,870,3,12,60,72
15/05/2021,340,3,47,178,225
15/05/2021,894,3,47,241,288
15/05/2021,697,3,49,325,374
15/05/2021,188,3,33,210,243
15/05/2021,97,3,78,341,419
15/05/2021,499,3,15,144,159
15/05/2021,601,3,53,328,381
15/05/2021,355,3,18,75,93
15/05/2021,196,3,24,125,149
15/05/2021,774,3,24,111,135
15/05/2021,123,3,18,87,105
15/05/2021,125,3,37,153,190
15/05/2021,798,3,85,330,415
15/05/2021,935,3,0,3,3
15/05/2021,105,3,67,234,301
15/05/2021,497,3,52,449,501
15/05/2021,298,3,159,1657,1816
15/05/2021,166,3,17,200,217
15/05/2021,646,3,33,168,201
15/05/2021,157,3,60,184,244
15/05/2021,7,3,34,146,180
15/05/2021,585,3,87,333,420
15/05/2021,558,3,20,100,120
15/05/2021,795,3,25,215,240
15/05/2021,903,3,1,2,3
15/05/2021,702,3,16,159,175
15/05/2021,93,3,44,375,419
15/05/2021,586,3,88,602,690
15/05/2021,378,3,22,129,151
15/05/2021,889,3,0,15,15
15/05/2021,398,3,12,29,41
15/05/2021,537,3,61,322,383
15/05/2021,492,3,14,84,98
15/05/2021,406,3,89,317,406
15/05/2021,477,3,21,120,141
15/05/2021,613,3,20,65,85
15/05/2021,504,3,16,59,75
15/05/2021,858,3,64,354,418
15/05/2021,883,3,4,147,151
15/05/2021,69,3,39,175,214
15/05/2021,175,3,13,112,125
15/05/2021,899,3,65,422,487
15/05/2021,112,3,14,91,105
15/05/2021,535,3,32,170,202
15/05/2021,248,3,36,243,279
15/05/2021,804,3,105,653,758
15/05/2021,479,3,22,80,102
15/05/2021,104,3,64,259,323
15/05/2021,83,3,138,710,848
15/05/2021,272,3,36,242,278
15/05/2021,402,3,51,273,324
15/05/2021,264,3,57,160,217
15/05/2021,688,3,36,182,218
15/05/2021,934,3,0,22,22
15/05/2021,901,3,4,10,14
15/05/2021,408,3,71,631,702
15/05/2021,397,3,29,106,135
15/05/2021,300,3,115,1193,1308
15/05/2021,670,3,178,676,854
15/05/2021,898,3,26,77,103
15/05/2021,540,3,66,247,313
15/05/2021,348,3,19,85,104
15/05/2021,853,3,11,93,104
15/05/2021,249,3,138,888,1026
15/05/2021,557,3,26,125,151
15/05/2021,833,3,14,79,93
15/05/2021,48,3,31,145,176
15/05/2021,768,3,53,320,373
15/05/2021,312,3,23,118,141
15/05/2021,851,3,36,207,243
15/05/2021,503,3,40,377,417
15/05/2021,405,3,28,125,153
15/05/2021,599,3,123,671,794
15/05/2021,605,3,98,349,447
15/05/2021,283,3,24,150,174
15/05/2021,395,3,32,125,157
15/05/2021,640,3,34,177,211
15/05/2021,377,3,40,125,165
15/05/2021,468,3,25,202,227
15/05/2021,273,3,76,387,463
15/05/2021,13,3,15,113,128
15/05/2021,336,3,129,454,583
15/05/2021,36,3,29,172,201
15/05/2021,653,3,10,60,70
15/05/2021,494,3,28,159,187
15/05/2021,414,3,72,641,713
15/05/2021,741,3,13,77,90
15/05/2021,445,3,38,332,370
15/05/2021,358,3,75,495,570
15/05/2021,621,3,35,119,154
15/05/2021,905,3,3,3,6
15/05/2021,156,3,37,235,272
15/05/2021,179,3,15,119,134
15/05/2021,562,3,9,52,61
15/05/2021,343,3,16,112,128
15/05/2021,455,3,21,170,191
15/05/2021,201,3,18,106,124
15/05/2021,828,3,49,194,243
15/05/2021,641,3,35,190,225
15/05/2021,81,3,14,73,87
15/05/2021,606,3,70,243,313
15/05/2021,552,3,64,231,295
15/05/2021,645,3,35,182,217
15/05/2021,331,3,38,163,201
15/05/2021,388,3,56,335,391
15/05/2021,351,3,84,426,510
15/05/2021,771,3,44,325,369
15/05/2021,116,3,38,156,194
15/05/2021,291,3,133,1491,1624
15/05/2021,773,3,17,108,125
15/05/2021,217,3,72,509,581
15/05/2021,356,3,58,308,366
15/05/2021,797,3,60,191,251
15/05/2021,712,3,22,141,163
15/05/2021,465,3,38,261,299
15/05/2021,846,3,6,57,63
15/05/2021,566,3,15,95,110
15/05/2021,333,3,69,853,922
15/05/2021,43,3,29,220,249
15/05/2021,637,3,63,449,512
15/05/2021,311,3,38,199,237
15/05/2021,824,3,104,443,547
15/05/2021,907,3,70,390,460
15/05/2021,783,3,49,394,443
15/05/2021,293,3,91,1099,1190
15/05/2021,79,3,59,162,221
15/05/2021,500,3,6,67,73
15/05/2021,360,3,38,201,239
15/05/2021,114,3,55,182,237
15/05/2021,280,3,26,71,97
15/05/2021,169,3,25,262,287
15/05/2021,297,3,112,1314,1426
15/05/2021,315,3,18,103,121
15/05/2021,747,3,23,127,150
15/05/2021,548,3,19,107,126
15/05/2021,649,3,26,112,138
15/05/2021,720,3,19,112,131
15/05/2021,871,3,52,294,346
15/05/2021,726,3,21,125,146
15/05/2021,845,3,17,121,138
15/05/2021,94,3,0,1,1
15/05/2021,827,3,112,569,681
15/05/2021,483,3,33,185,218
15/05/2021,725,3,44,158,202
15/05/2021,346,3,16,89,105
15/05/2021,618,3,19,136,155
15/05/2021,31,3,29,195,224
15/05/2021,363,3,119,353,472
15/05/2021,214,3,80,548,628
15/05/2021,880,3,0,24,24
15/05/2021,225,3,36,168,204
15/05/2021,208,3,23,111,134
15/05/2021,160,3,3,13,16
15/05/2021,664,3,56,234,290
15/05/2021,21,3,31,214,245
15/05/2021,560,3,78,321,399
15/05/2021,368,3,45,274,319
15/05/2021,525,3,34,210,244
15/05/2021,4,3,37,275,312
15/05/2021,57,3,39,328,367
15/05/2021,806,3,63,348,411
15/05/2021,211,3,75,543,618
15/05/2021,226,3,41,199,240
15/05/2021,657,3,63,282,345
15/05/2021,669,3,36,190,226
15/05/2021,152,3,25,208,233
15/05/2021,437,3,41,330,371
15/05/2021,498,3,17,103,120
15/05/2021,67,3,31,233,264
15/05/2021,915,3,0,29,29
15/05/2021,65,3,33,303,336
15/05/2021,867,3,19,126,145
15/05/2021,515,3,16,106,122
15/05/2021,224,3,36,195,231
15/05/2021,130,3,77,342,419
15/05/2021,282,3,41,128,169
15/05/2021,335,3,31,128,159
15/05/2021,347,3,112,425,537
15/05/2021,254,3,26,122,148
15/05/2021,781,3,87,581,668
15/05/2021,20,3,18,48,66
15/05/2021,789,3,43,175,218
15/05/2021,592,3,38,224,262
15/05/2021,396,3,28,106,134
15/05/2021,869,3,112,338,450
15/05/2021,629,3,28,170,198
15/05/2021,207,3,28,163,191
15/05/2021,676,3,23,66,89
15/05/2021,419,3,86,373,459
15/05/2021,779,3,30,119,149
15/05/2021,590,3,2,3,5
15/05/2021,167,3,45,275,320
15/05/2021,862,3,49,217,266
15/05/2021,496,3,10,83,93
15/05/2021,394,3,27,139,166
15/05/2021,173,3,22,101,123
15/05/2021,527,3,33,98,131
15/05/2021,529,3,35,114,149
15/05/2021,467,3,27,202,229
15/05/2021,739,3,13,78,91
15/05/2021,142,3,15,78,93
15/05/2021,12,3,5,52,57
15/05/2021,209,3,25,153,178
15/05/2021,816,3,81,511,592
15/05/2021,390,3,59,355,414
15/05/2021,433,3,137,608,745
15/05/2021,881,3,0,18,18
15/05/2021,268,3,57,286,343
15/05/2021,303,3,89,586,675
15/05/2021,8,3,61,346,407
15/05/2021,800,3,29,152,181
15/05/2021,546,3,65,250,315
15/05/2021,447,3,24,136,160
15/05/2021,22,3,30,161,191
15/05/2021,682,3,23,87,110
15/05/2021,471,3,17,160,177
15/05/2021,730,3,20,110,130
15/05/2021,761,3,15,65,80
15/05/2021,421,3,92,359,451
15/05/2021,694,3,21,119,140
15/05/2021,578,3,9,56,65
15/05/2021,580,3,44,230,274
15/05/2021,469,3,26,252,278
15/05/2021,24,3,20,79,99
15/05/2021,517,3,29,118,147
15/05/2021,425,3,43,361,404
15/05/2021,661,3,54,247,301
15/05/2021,461,3,57,301,358
15/05/2021,680,3,67,201,268
15/05/2021,651,3,30,154,184
15/05/2021,260,3,151,731,882
15/05/2021,685,3,34,180,214
15/05/2021,703,3,16,115,131
15/05/2021,440,3,65,357,422
15/05/2021,86,3,19,133,152
15/05/2021,233,3,40,193,233
15/05/2021,634,3,30,165,195
15/05/2021,748,3,27,79,106
15/05/2021,583,3,38,213,251
15/05/2021,511,3,15,170,185
15/05/2021,487,3,32,120,152
15/05/2021,731,3,16,100,116
15/05/2021,624,3,11,59,70
15/05/2021,369,3,82,367,449
15/05/2021,381,3,7,10,17
15/05/2021,216,3,30,143,173
15/05/2021,841,3,8,199,207
15/05/2021,263,3,72,293,365
15/05/2021,110,3,14,135,149
15/05/2021,484,3,25,151,176
15/05/2021,714,3,47,228,275
15/05/2021,506,3,51,451,502
15/05/2021,728,3,35,240,275
15/05/2021,404,3,85,312,397
15/05/2021,832,3,23,143,166
15/05/2021,686,3,24,173,197
15/05/2021,838,3,16,128,144
15/05/2021,362,3,117,348,465
15/05/2021,439,3,22,197,219
15/05/2021,382,3,0,5,5
15/05/2021,352,3,48,202,250
15/05/2021,136,3,70,302,372
15/05/2021,598,3,123,708,831
15/05/2021,647,3,29,118,147
15/05/2021,431,3,32,197,229
15/05/2021,574,3,33,223,256
15/05/2021,584,3,96,494,590
15/05/2021,45,3,33,212,245
15/05/2021,39,3,29,231,260
15/05/2021,199,3,11,73,84
15/05/2021,930,3,1,23,24
15/05/2021,102,3,68,352,420
15/05/2021,341,3,131,456,587
15/05/2021,126,3,37,276,313
15/05/2021,510,3,47,428,475
15/05/2021,412,3,11,154,165
15/05/2021,134,3,68,295,363
15/05/2021,743,3,13,83,96
15/05/2021,582,3,125,687,812
15/05/2021,706,3,59,221,280
15/05/2021,543,3,161,561,722
15/05/2021,612,3,81,614,695
15/05/2021,227,3,37,370,407
15/05/2021,52,3,48,202,250
15/05/2021,772,3,43,239,282
15/05/2021,906,3,1,9,10
15/05/2021,426,3,18,156,174
15/05/2021,861,3,74,154,228
15/05/2021,691,3,34,168,202
15/05/2021,742,3,37,124,161
15/05/2021,127,3,22,164,186
15/05/2021,481,3,32,150,182
15/05/2021,310,3,81,512,593
15/05/2021,275,3,38,226,264
15/05/2021,326,3,12,61,73
15/05/2021,452,3,36,302,338
15/05/2021,222,3,36,106,142
15/05/2021,782,3,45,374,419
15/05/2021,642,3,35,179,214
15/05/2021,292,3,113,1083,1196
15/05/2021,92,3,37,161,198
15/05/2021,204,3,28,180,208
15/05/2021,754,3,44,344,388
15/05/2021,139,3,69,493,562
15/05/2021,760,3,29,219,248
15/05/2021,72,3,69,569,638
15/05/2021,3,3,31,146,177
15/05/2021,464,3,49,275,324
15/05/2021,422,3,67,445,512
15/05/2021,622,3,111,562,673
15/05/2021,202,3,54,392,446
15/05/2021,518,3,13,102,115
15/05/2021,813,3,33,120,153
15/05/2021,148,3,30,110,140
15/05/2021,63,3,28,137,165
15/05/2021,513,3,14,84,98
15/05/2021,317,3,65,304,369
15/05/2021,810,3,30,180,210
15/05/2021,345,3,36,135,171
15/05/2021,146,3,114,608,722
15/05/2021,240,3,111,791,902
15/05/2021,576,3,7,40,47
15/05/2021,812,3,24,168,192
15/05/2021,26,3,34,201,235
15/05/2021,909,3,1,15,16
15/05/2021,128,3,30,158,188
15/05/2021,417,3,65,590,655
15/05/2021,321,3,31,133,164
15/05/2021,354,3,4,3,7
15/05/2021,684,3,31,202,233
15/05/2021,875,3,10,71,81
15/05/2021,163,3,21,159,180
15/05/2021,836,3,62,524,586
15/05/2021,427,3,141,697,838
15/05/2021,51,3,84,509,593
15/05/2021,600,3,124,725,849
15/05/2021,213,3,81,590,671
15/05/2021,252,3,16,102,118
15/05/2021,266,3,22,111,133
15/05/2021,138,3,67,387,454
15/05/2021,936,3,3,16,19
15/05/2021,113,3,11,93,104
15/05/2021,538,3,38,181,219
15/05/2021,137,3,63,407,470
15/05/2021,758,3,31,217,248
15/05/2021,575,3,9,63,72
15/05/2021,551,3,77,263,340
15/05/2021,430,3,29,179,208
15/05/2021,563,3,26,138,164
15/05/2021,373,3,28,135,163
15/05/2021,839,3,32,139,171
15/05/2021,650,3,48,206,254
15/05/2021,872,3,35,126,161
15/05/2021,569,3,44,254,298
15/05/2021,639,3,29,120,149
15/05/2021,197,3,38,176,214
15/05/2021,85,3,48,125,173
15/05/2021,665,3,21,173,194
15/05/2021,674,3,37,186,223
15/05/2021,919,3,31,180,211
15/05/2021,295,3,62,706,768
15/05/2021,554,3,34,230,264
15/05/2021,627,3,25,105,130
15/05/2021,270,3,15,107,122
15/05/2021,307,3,37,251,288
15/05/2021,376,3,19,87,106
15/05/2021,35,3,37,211,248
15/05/2021,372,3,89,381,470
15/05/2021,659,3,16,162,178
15/05/2021,700,3,46,337,383
15/05/2021,615,3,34,235,269
15/05/2021,122,3,45,170,215
15/05/2021,852,3,75,345,420
15/05/2021,71,3,20,135,155
15/05/2021,171,3,11,54,65
15/05/2021,89,3,43,232,275
15/05/2021,370,3,38,297,335
15/05/2021,753,3,46,321,367
15/05/2021,100,3,97,596,693
15/05/2021,710,3,22,133,155
15/05/2021,278,3,38,124,162
15/05/2021,745,3,21,144,165
15/05/2021,542,3,56,186,242
15/05/2021,756,3,57,429,486
15/05/2021,115,3,13,98,111
15/05/2021,662,3,63,294,357
15/05/2021,884,3,5,141,146
15/05/2021,68,3,37,320,357
15/05/2021,344,3,30,216,246
15/05/2021,9,3,38,190,228
15/05/2021,616,3,39,185,224
15/05/2021,135,3,70,311,381
15/05/2021,129,3,80,434,514
15/05/2021,428,3,19,198,217
15/05/2021,933,3,0,3,3
15/05/2021,722,3,14,72,86
15/05/2021,775,3,27,154,181
15/05/2021,671,3,54,364,418
15/05/2021,449,3,36,213,249
15/05/2021,928,3,0,1,1
15/05/2021,602,3,120,446,566
15/05/2021,41,3,23,195,218
15/05/2021,793,3,37,181,218
15/05/2021,679,3,64,219,283
15/05/2021,530,3,25,115,140
15/05/2021,38,3,27,203,230
15/05/2021,316,3,28,273,301
15/05/2021,407,3,47,449,496
15/05/2021,107,3,106,615,721
15/05/2021,668,3,10,75,85
15/05/2021,821,3,44,237,281
15/05/2021,476,3,28,114,142
15/05/2021,174,3,15,92,107
15/05/2021,290,3,143,1542,1685
15/05/2021,357,3,60,356,416
15/05/2021,559,3,79,332,411
15/05/2021,5,3,32,142,174
15/05/2021,322,3,28,122,150
15/05/2021,438,3,19,134,153
15/05/2021,403,3,49,270,319
15/05/2021,472,3,136,638,774
15/05/2021,58,3,62,541,603
15/05/2021,715,3,58,216,274
15/05/2021,764,3,12,39,51
15/05/2021,603,3,89,326,415
15/05/2021,218,3,76,548,624
15/05/2021,308,3,31,210,241
15/05/2021,579,3,17,132,149
15/05/2021,509,3,38,339,377
15/05/2021,633,3,30,158,188
15/05/2021,323,3,17,76,93
15/05/2021,75,3,70,534,604
15/05/2021,544,3,38,155,193
15/05/2021,219,3,27,118,145
15/05/2021,384,3,34,203,237
15/05/2021,564,3,38,192,230
15/05/2021,619,3,30,120,150
15/05/2021,349,3,23,125,148
15/05/2021,77,3,67,530,597
15/05/2021,887,3,1,35,36
15/05/2021,215,3,19,92,111
15/05/2021,556,3,82,355,437
15/05/2021,533,3,35,140,175
15/05/2021,91,3,26,155,181
15/05/2021,625,3,19,134,153
15/05/2021,87,3,59,325,384
15/05/2021,246,3,123,851,974
15/05/2021,572,3,49,267,316
15/05/2021,737,3,12,76,88
15/05/2021,374,3,33,133,166
15/05/2021,749,3,31,280,311
15/05/2021,435,3,22,117,139
15/05/2021,631,3,7,32,39
15/05/2021,205,3,21,176,197
16/05/2021,87,3,56,174,230
16/05/2021,631,3,6,17,23
16/05/2021,572,3,31,134,165
16/05/2021,625,3,13,70,83
16/05/2021,246,3,78,357,435
16/05/2021,205,3,13,110,123
16/05/2021,374,3,16,67,83
16/05/2021,749,3,17,100,117
16/05/2021,737,3,8,49,57
16/05/2021,435,3,20,58,78
16/05/2021,91,3,21,102,123
16/05/2021,533,3,28,82,110
16/05/2021,858,3,59,212,271
16/05/2021,504,3,12,39,51
16/05/2021,406,3,40,133,173
16/05/2021,613,3,10,49,59
16/05/2021,586,3,57,254,311
16/05/2021,883,3,1,199,200
16/05/2021,93,3,26,152,178
16/05/2021,903,3,0,1,1
16/05/2021,398,3,11,16,27
16/05/2021,537,3,53,139,192
16/05/2021,492,3,15,48,63
16/05/2021,378,3,16,74,90
16/05/2021,702,3,11,66,77
16/05/2021,477,3,12,57,69
16/05/2021,889,3,0,8,8
16/05/2021,558,3,12,59,71
16/05/2021,795,3,24,131,155
16/05/2021,175,3,16,49,65
16/05/2021,69,3,31,110,141
16/05/2021,288,3,7,58,65
16/05/2021,910,3,1,191,192
16/05/2021,328,3,23,93,116
16/05/2021,843,3,11,64,75
16/05/2021,892,3,9,19,28
16/05/2021,454,3,28,123,151
16/05/2021,261,3,149,487,636
16/05/2021,495,3,20,58,78
16/05/2021,359,3,43,98,141
16/05/2021,82,3,37,145,182
16/05/2021,877,3,3,9,12
16/05/2021,453,3,23,132,155
16/05/2021,840,3,20,118,138
16/05/2021,663,3,27,114,141
16/05/2021,140,3,11,65,76
16/05/2021,463,3,72,272,344
16/05/2021,635,3,13,125,138
16/05/2021,692,3,25,79,104
16/05/2021,457,3,12,49,61
16/05/2021,655,3,33,160,193
16/05/2021,66,3,17,134,151
16/05/2021,784,3,55,263,318
16/05/2021,522,3,31,114,145
16/05/2021,707,3,49,166,215
16/05/2021,790,3,20,126,146
16/05/2021,446,3,15,115,130
16/05/2021,416,3,9,54,63
16/05/2021,239,3,39,198,237
16/05/2021,491,3,36,187,223
16/05/2021,882,3,0,14,14
16/05/2021,296,3,20,82,102
16/05/2021,182,3,12,72,84
16/05/2021,267,3,19,69,88
16/05/2021,450,3,11,43,54
16/05/2021,401,3,10,41,51
16/05/2021,281,3,32,157,189
16/05/2021,666,3,32,104,136
16/05/2021,807,3,24,65,89
16/05/2021,78,3,112,449,561
16/05/2021,304,3,40,144,184
16/05/2021,411,3,46,251,297
16/05/2021,902,3,36,84,120
16/05/2021,210,3,18,91,109
16/05/2021,212,3,59,245,304
16/05/2021,493,3,23,65,88
16/05/2021,338,3,26,154,180
16/05/2021,117,3,86,214,300
16/05/2021,330,3,24,139,163
16/05/2021,185,3,16,94,110
16/05/2021,61,3,19,138,157
16/05/2021,124,3,20,46,66
16/05/2021,604,3,59,160,219
16/05/2021,842,3,8,15,23
16/05/2021,30,3,40,129,169
16/05/2021,850,3,80,255,335
16/05/2021,289,3,28,153,181
16/05/2021,144,3,19,118,137
16/05/2021,145,3,32,116,148
16/05/2021,133,3,18,57,75
16/05/2021,608,3,85,342,427
16/05/2021,444,3,25,98,123
16/05/2021,353,3,11,40,51
16/05/2021,448,3,87,320,407
16/05/2021,809,3,11,64,75
16/05/2021,904,3,34,166,200
16/05/2021,25,3,26,99,125
16/05/2021,200,3,12,50,62
16/05/2021,591,3,34,74,108
16/05/2021,581,3,26,121,147
16/05/2021,677,3,12,57,69
16/05/2021,119,3,44,151,195
16/05/2021,231,3,41,154,195
16/05/2021,245,3,64,278,342
16/05/2021,652,3,6,30,36
16/05/2021,792,3,34,120,154
16/05/2021,687,3,31,122,153
16/05/2021,442,3,18,91,109
16/05/2021,555,3,57,201,258
16/05/2021,46,3,25,55,80
16/05/2021,507,3,42,216,258
16/05/2021,837,3,24,141,165
16/05/2021,835,3,38,140,178
16/05/2021,505,3,4,34,38
16/05/2021,831,3,22,114,136
16/05/2021,314,3,6,44,50
16/05/2021,389,3,53,165,218
16/05/2021,257,3,126,412,538
16/05/2021,121,3,147,429,576
16/05/2021,176,3,23,71,94
16/05/2021,434,3,9,25,34
16/05/2021,855,3,28,149,177
16/05/2021,32,3,22,65,87
16/05/2021,277,3,25,86,111
16/05/2021,709,3,60,173,233
16/05/2021,103,3,53,182,235
16/05/2021,234,3,18,51,69
16/05/2021,118,3,43,138,181
16/05/2021,799,3,7,30,37
16/05/2021,873,3,32,134,166
16/05/2021,230,3,30,121,151
16/05/2021,787,3,94,365,459
16/05/2021,49,3,14,52,66
16/05/2021,923,3,0,1,1
16/05/2021,364,3,89,216,305
16/05/2021,6,3,37,78,115
16/05/2021,539,3,44,110,154
16/05/2021,325,3,11,60,71
16/05/2021,521,3,19,55,74
16/05/2021,258,3,138,441,579
16/05/2021,284,3,9,41,50
16/05/2021,734,3,21,71,92
16/05/2021,925,3,0,2,2
16/05/2021,327,3,56,200,256
16/05/2021,386,3,65,269,334
16/05/2021,820,3,13,83,96
16/05/2021,531,3,23,123,146
16/05/2021,441,3,72,250,322
16/05/2021,339,3,29,130,159
16/05/2021,791,3,17,106,123
16/05/2021,643,3,24,115,139
16/05/2021,256,3,25,103,128
16/05/2021,757,3,47,149,196
16/05/2021,96,3,22,92,114
16/05/2021,410,3,32,193,225
16/05/2021,203,3,15,117,132
16/05/2021,486,3,18,108,126
16/05/2021,2,3,36,81,117
16/05/2021,818,3,77,227,304
16/05/2021,732,3,8,55,63
16/05/2021,158,3,24,72,96
16/05/2021,53,3,38,110,148
16/05/2021,830,3,157,480,637
16/05/2021,490,3,15,48,63
16/05/2021,921,3,0,3,3
16/05/2021,220,3,20,72,92
16/05/2021,432,3,24,106,130
16/05/2021,385,3,27,91,118
16/05/2021,886,3,0,4,4
16/05/2021,180,3,34,140,174
16/05/2021,294,3,38,166,204
16/05/2021,626,3,22,64,86
16/05/2021,857,3,37,125,162
16/05/2021,84,3,79,229,308
16/05/2021,750,3,38,180,218
16/05/2021,76,3,52,226,278
16/05/2021,34,3,21,70,91
16/05/2021,699,3,11,65,76
16/05/2021,143,3,44,223,267
16/05/2021,206,3,1,5,6
16/05/2021,805,3,17,57,74
16/05/2021,285,3,14,63,77
16/05/2021,232,3,37,95,132
16/05/2021,588,3,35,76,111
16/05/2021,120,3,37,103,140
16/05/2021,177,3,12,34,46
16/05/2021,854,3,64,252,316
16/05/2021,250,3,74,173,247
16/05/2021,623,3,31,150,181
16/05/2021,860,3,13,110,123
16/05/2021,429,3,27,139,166
16/05/2021,366,3,17,43,60
16/05/2021,885,3,1,195,196
16/05/2021,767,3,80,282,362
16/05/2021,392,3,22,83,105
16/05/2021,33,3,35,124,159
16/05/2021,274,3,0,60,60
16/05/2021,108,3,11,65,76
16/05/2021,480,3,15,46,61
16/05/2021,475,3,53,195,248
16/05/2021,617,3,15,55,70
16/05/2021,848,3,41,134,175
16/05/2021,193,3,32,141,173
16/05/2021,106,3,46,218,264
16/05/2021,917,3,2,76,78
16/05/2021,228,3,23,94,117
16/05/2021,451,3,88,355,443
16/05/2021,519,3,22,108,130
16/05/2021,183,3,12,73,85
16/05/2021,594,3,41,212,253
16/05/2021,262,3,42,72,114
16/05/2021,865,3,13,47,60
16/05/2021,755,3,52,215,267
16/05/2021,727,3,28,79,107
16/05/2021,536,3,23,91,114
16/05/2021,302,3,69,456,525
16/05/2021,387,3,32,80,112
16/05/2021,926,3,1,5,6
16/05/2021,367,3,28,122,150
16/05/2021,908,3,8,87,95
16/05/2021,693,3,19,71,90
16/05/2021,914,3,1,3,4
16/05/2021,719,3,19,48,67
16/05/2021,44,3,36,178,214
16/05/2021,532,3,134,498,632
16/05/2021,595,3,28,78,106
16/05/2021,577,3,15,131,146
16/05/2021,874,3,22,92,114
16/05/2021,876,3,0,4,4
16/05/2021,638,3,38,97,135
16/05/2021,705,3,8,28,36
16/05/2021,170,3,20,100,120
16/05/2021,11,3,18,73,91
16/05/2021,829,3,43,101,144
16/05/2021,780,3,88,323,411
16/05/2021,866,3,54,238,292
16/05/2021,711,3,16,76,92
16/05/2021,424,3,55,354,409
16/05/2021,717,3,12,78,90
16/05/2021,409,3,30,37,67
16/05/2021,614,3,18,58,76
16/05/2021,70,3,51,210,261
16/05/2021,125,3,39,82,121
16/05/2021,7,3,38,79,117
16/05/2021,497,3,32,185,217
16/05/2021,646,3,19,98,117
16/05/2021,585,3,60,188,248
16/05/2021,157,3,28,102,130
16/05/2021,196,3,15,64,79
16/05/2021,166,3,14,82,96
16/05/2021,798,3,60,186,246
16/05/2021,298,3,92,530,622
16/05/2021,774,3,15,88,103
16/05/2021,123,3,21,52,73
16/05/2021,105,3,37,129,166
16/05/2021,269,3,18,50,68
16/05/2021,15,3,42,125,167
16/05/2021,251,3,20,67,87
16/05/2021,512,3,3,23,26
16/05/2021,56,3,24,163,187
16/05/2021,654,3,18,101,119
16/05/2021,186,3,42,76,118
16/05/2021,393,3,22,70,92
16/05/2021,192,3,12,50,62
16/05/2021,253,3,10,56,66
16/05/2021,162,3,75,232,307
16/05/2021,597,3,13,68,81
16/05/2021,825,3,31,150,181
16/05/2021,683,3,28,96,124
16/05/2021,462,3,18,97,115
16/05/2021,474,3,18,73,91
16/05/2021,436,3,16,92,108
16/05/2021,399,3,57,201,258
16/05/2021,350,3,17,64,81
16/05/2021,247,3,81,244,325
16/05/2021,37,3,28,46,74
16/05/2021,244,3,29,168,197
16/05/2021,309,3,7,39,46
16/05/2021,161,3,74,233,307
16/05/2021,443,3,19,129,148
16/05/2021,802,3,38,198,236
16/05/2021,473,3,23,58,81
16/05/2021,95,3,59,248,307
16/05/2021,59,3,15,76,91
16/05/2021,195,3,10,41,51
16/05/2021,534,3,16,65,81
16/05/2021,863,3,17,61,78
16/05/2021,235,3,21,119,140
16/05/2021,418,3,26,42,68
16/05/2021,383,3,76,308,384
16/05/2021,60,3,5,22,27
16/05/2021,632,3,9,21,30
16/05/2021,681,3,46,106,152
16/05/2021,658,3,8,77,85
16/05/2021,900,3,10,19,29
16/05/2021,924,3,0,3,3
16/05/2021,752,3,57,248,305
16/05/2021,675,3,15,71,86
16/05/2021,194,3,0,1,1
16/05/2021,918,3,0,8,8
16/05/2021,172,3,19,93,112
16/05/2021,64,3,6,44,50
16/05/2021,803,3,25,120,145
16/05/2021,466,3,20,105,125
16/05/2021,99,3,64,297,361
16/05/2021,520,3,16,70,86
16/05/2021,890,3,7,28,35
16/05/2021,460,3,11,83,94
16/05/2021,334,3,66,187,253
16/05/2021,88,3,19,79,98
16/05/2021,815,3,103,363,466
16/05/2021,19,3,36,165,201
16/05/2021,868,3,99,302,401
16/05/2021,101,3,28,113,141
16/05/2021,738,3,19,71,90
16/05/2021,485,3,19,90,109
16/05/2021,723,3,17,90,107
16/05/2021,50,3,15,49,64
16/05/2021,849,3,21,150,171
16/05/2021,847,3,3,80,83
16/05/2021,470,3,21,122,143
16/05/2021,819,3,46,127,173
16/05/2021,379,3,34,143,177
16/05/2021,553,3,15,32,47
16/05/2021,573,3,34,137,171
16/05/2021,801,3,27,111,138
16/05/2021,23,3,15,30,45
16/05/2021,896,3,167,502,669
16/05/2021,276,3,36,156,192
16/05/2021,785,3,66,288,354
16/05/2021,423,3,52,336,388
16/05/2021,189,3,11,62,73
16/05/2021,400,3,10,37,47
16/05/2021,696,3,36,93,129
16/05/2021,777,3,26,91,117
16/05/2021,897,3,5,14,19
16/05/2021,305,3,28,133,161
16/05/2021,570,3,34,122,156
16/05/2021,895,3,18,63,81
16/05/2021,238,3,66,312,378
16/05/2021,187,3,18,80,98
16/05/2021,28,3,23,66,89
16/05/2021,380,3,22,123,145
16/05/2021,286,3,29,120,149
16/05/2021,607,3,77,312,389
16/05/2021,571,3,37,124,161
16/05/2021,147,3,19,99,118
16/05/2021,888,3,2,77,79
16/05/2021,153,3,29,131,160
16/05/2021,864,3,12,65,77
16/05/2021,332,3,19,91,110
16/05/2021,17,3,9,60,69
16/05/2021,776,3,15,103,118
16/05/2021,413,3,41,217,258
16/05/2021,361,3,87,212,299
16/05/2021,287,3,92,538,630
16/05/2021,42,3,18,68,86
16/05/2021,589,3,34,73,107
16/05/2021,648,3,22,73,95
16/05/2021,198,3,27,109,136
16/05/2021,859,3,5,13,18
16/05/2021,870,3,10,49,59
16/05/2021,733,3,11,61,72
16/05/2021,610,3,65,272,337
16/05/2021,97,3,45,181,226
16/05/2021,601,3,26,99,125
16/05/2021,80,3,8,37,45
16/05/2021,355,3,14,52,66
16/05/2021,499,3,8,67,75
16/05/2021,697,3,25,103,128
16/05/2021,656,3,15,67,82
16/05/2021,894,3,32,97,129
16/05/2021,188,3,30,117,147
16/05/2021,501,3,37,194,231
16/05/2021,636,3,10,59,69
16/05/2021,340,3,21,130,151
16/05/2021,155,3,29,161,190
16/05/2021,279,3,33,154,187
16/05/2021,528,3,23,52,75
16/05/2021,54,3,26,70,96
16/05/2021,628,3,19,61,80
16/05/2021,237,3,69,286,355
16/05/2021,735,3,6,52,58
16/05/2021,565,3,71,230,301
16/05/2021,788,3,93,371,464
16/05/2021,478,3,26,89,115
16/05/2021,458,3,29,112,141
16/05/2021,489,3,11,19,30
16/05/2021,178,3,20,73,93
16/05/2021,786,3,35,151,186
16/05/2021,306,3,0,1,1
16/05/2021,318,3,50,140,190
16/05/2021,808,3,53,206,259
16/05/2021,716,3,11,64,75
16/05/2021,319,3,3,42,45
16/05/2021,698,3,23,104,127
16/05/2021,55,3,11,78,89
16/05/2021,313,3,6,43,49
16/05/2021,856,3,46,145,191
16/05/2021,98,3,54,224,278
16/05/2021,724,3,147,447,594
16/05/2021,550,3,50,125,175
16/05/2021,844,3,11,57,68
16/05/2021,508,3,31,137,168
16/05/2021,299,3,43,165,208
16/05/2021,337,3,9,47,56
16/05/2021,329,3,55,207,262
16/05/2021,181,3,15,56,71
16/05/2021,459,3,33,122,155
16/05/2021,814,3,29,55,84
16/05/2021,911,3,25,148,173
16/05/2021,301,3,66,444,510
16/05/2021,891,3,30,89,119
16/05/2021,913,3,0,5,5
16/05/2021,561,3,12,39,51
16/05/2021,736,3,5,42,47
16/05/2021,794,3,72,260,332
16/05/2021,811,3,12,66,78
16/05/2021,746,3,31,86,117
16/05/2021,587,3,5,13,18
16/05/2021,547,3,164,488,652
16/05/2021,770,3,81,299,380
16/05/2021,456,3,23,92,115
16/05/2021,721,3,147,544,691
16/05/2021,159,3,25,110,135
16/05/2021,90,3,21,87,108
16/05/2021,164,3,16,79,95
16/05/2021,567,3,40,150,190
16/05/2021,673,3,27,106,133
16/05/2021,713,3,52,426,478
16/05/2021,27,3,96,261,357
16/05/2021,931,3,0,2,2
16/05/2021,229,3,53,144,197
16/05/2021,168,3,11,76,87
16/05/2021,149,3,23,106,129
16/05/2021,524,3,36,124,160
16/05/2021,937,3,0,1,1
16/05/2021,342,3,17,69,86
16/05/2021,131,3,42,147,189
16/05/2021,620,3,0,2,2
16/05/2021,817,3,29,123,152
16/05/2021,255,3,3,2,5
16/05/2021,689,3,35,93,128
16/05/2021,939,3,0,1,1
16/05/2021,778,3,31,143,174
16/05/2021,151,3,13,64,77
16/05/2021,243,3,76,363,439
16/05/2021,271,3,19,63,82
16/05/2021,365,3,19,55,74
16/05/2021,593,3,73,353,426
16/05/2021,526,3,24,56,80
16/05/2021,190,3,28,92,120
16/05/2021,184,3,11,74,85
16/05/2021,259,3,122,364,486
16/05/2021,420,3,94,268,362
16/05/2021,221,3,20,69,89
16/05/2021,236,3,31,100,131
16/05/2021,488,3,21,85,106
16/05/2021,47,3,35,73,108
16/05/2021,154,3,28,131,159
16/05/2021,751,3,1,4,5
16/05/2021,242,3,67,343,410
16/05/2021,704,3,12,27,39
16/05/2021,18,3,22,115,137
16/05/2021,765,3,22,126,148
16/05/2021,759,3,8,51,59
16/05/2021,826,3,44,137,181
16/05/2021,879,3,0,15,15
16/05/2021,878,3,0,12,12
16/05/2021,701,3,6,60,66
16/05/2021,823,3,28,90,118
16/05/2021,1,3,36,77,113
16/05/2021,371,3,27,75,102
16/05/2021,660,3,14,74,88
16/05/2021,265,3,42,95,137
16/05/2021,514,3,3,26,29
16/05/2021,391,3,54,161,215
16/05/2021,111,3,47,177,224
16/05/2021,77,3,61,251,312
16/05/2021,556,3,70,237,307
16/05/2021,544,3,32,90,122
16/05/2021,215,3,9,44,53
16/05/2021,564,3,37,113,150
16/05/2021,219,3,11,62,73
16/05/2021,75,3,58,246,304
16/05/2021,887,3,0,10,10
16/05/2021,384,3,22,85,107
16/05/2021,349,3,21,54,75
16/05/2021,323,3,15,46,61
16/05/2021,619,3,13,42,55
16/05/2021,633,3,16,52,68
16/05/2021,484,3,19,82,101
16/05/2021,598,3,107,385,492
16/05/2021,404,3,68,240,308
16/05/2021,714,3,35,136,171
16/05/2021,574,3,30,124,154
16/05/2021,686,3,17,77,94
16/05/2021,362,3,91,213,304
16/05/2021,647,3,25,76,101
16/05/2021,506,3,37,195,232
16/05/2021,382,3,1,0,1
16/05/2021,136,3,49,159,208
16/05/2021,728,3,24,119,143
16/05/2021,352,3,32,187,219
16/05/2021,838,3,14,64,78
16/05/2021,431,3,20,89,109
16/05/2021,832,3,18,74,92
16/05/2021,584,3,75,336,411
16/05/2021,110,3,12,52,64
16/05/2021,439,3,11,77,88
16/05/2021,297,3,38,347,385
16/05/2021,726,3,23,87,110
16/05/2021,747,3,21,69,90
16/05/2021,548,3,15,63,78
16/05/2021,871,3,43,166,209
16/05/2021,315,3,12,62,74
16/05/2021,169,3,20,90,110
16/05/2021,720,3,18,55,73
16/05/2021,649,3,30,75,105
16/05/2021,273,3,69,247,316
16/05/2021,13,3,16,71,87
16/05/2021,599,3,104,358,462
16/05/2021,405,3,13,46,59
16/05/2021,283,3,22,84,106
16/05/2021,36,3,22,94,116
16/05/2021,468,3,17,99,116
16/05/2021,605,3,62,191,253
16/05/2021,395,3,20,77,97
16/05/2021,503,3,29,150,179
16/05/2021,336,3,129,402,531
16/05/2021,377,3,37,87,124
16/05/2021,640,3,19,87,106
16/05/2021,934,3,0,9,9
16/05/2021,479,3,15,38,53
16/05/2021,264,3,41,79,120
16/05/2021,688,3,23,76,99
16/05/2021,112,3,18,63,81
16/05/2021,408,3,50,252,302
16/05/2021,104,3,36,139,175
16/05/2021,402,3,36,134,170
16/05/2021,901,3,3,8,11
16/05/2021,248,3,24,82,106
16/05/2021,804,3,74,309,383
16/05/2021,272,3,19,140,159
16/05/2021,83,3,122,381,503
16/05/2021,899,3,54,203,257
16/05/2021,535,3,21,69,90
16/05/2021,768,3,26,132,158
16/05/2021,557,3,14,67,81
16/05/2021,540,3,49,150,199
16/05/2021,397,3,18,63,81
16/05/2021,48,3,13,50,63
16/05/2021,851,3,23,108,131
16/05/2021,853,3,16,53,69
16/05/2021,898,3,22,49,71
16/05/2021,670,3,167,550,717
16/05/2021,300,3,74,441,515
16/05/2021,249,3,86,382,468
16/05/2021,348,3,7,43,50
16/05/2021,833,3,9,41,50
16/05/2021,312,3,23,80,103
16/05/2021,824,3,69,258,327
16/05/2021,797,3,45,145,190
16/05/2021,637,3,54,222,276
16/05/2021,280,3,21,63,84
16/05/2021,311,3,25,106,131
16/05/2021,79,3,26,89,115
16/05/2021,360,3,30,90,120
16/05/2021,465,3,18,97,115
16/05/2021,907,3,59,183,242
16/05/2021,566,3,10,38,48
16/05/2021,114,3,40,101,141
16/05/2021,333,3,49,311,360
16/05/2021,43,3,17,104,121
16/05/2021,712,3,16,72,88
16/05/2021,356,3,61,160,221
16/05/2021,500,3,3,25,28
16/05/2021,293,3,41,282,323
16/05/2021,217,3,47,206,253
16/05/2021,783,3,49,224,273
16/05/2021,846,3,4,87,91
16/05/2021,828,3,52,109,161
16/05/2021,653,3,5,35,40
16/05/2021,156,3,24,99,123
16/05/2021,414,3,48,260,308
16/05/2021,343,3,13,59,72
16/05/2021,179,3,16,51,67
16/05/2021,358,3,75,246,321
16/05/2021,494,3,18,80,98
16/05/2021,201,3,13,60,73
16/05/2021,905,3,5,1,6
16/05/2021,455,3,13,85,98
16/05/2021,562,3,5,31,36
16/05/2021,641,3,21,92,113
16/05/2021,741,3,10,56,66
16/05/2021,621,3,33,130,163
16/05/2021,445,3,25,133,158
16/05/2021,606,3,43,122,165
16/05/2021,331,3,38,76,114
16/05/2021,773,3,10,78,88
16/05/2021,552,3,49,136,185
16/05/2021,291,3,71,457,528
16/05/2021,81,3,6,33,39
16/05/2021,351,3,99,272,371
16/05/2021,645,3,18,96,114
16/05/2021,771,3,28,133,161
16/05/2021,116,3,21,74,95
16/05/2021,388,3,47,175,222
16/05/2021,233,3,45,111,156
16/05/2021,263,3,51,137,188
16/05/2021,86,3,21,76,97
16/05/2021,583,3,31,98,129
16/05/2021,381,3,1,2,3
16/05/2021,369,3,60,175,235
16/05/2021,748,3,20,66,86
16/05/2021,841,3,4,209,213
16/05/2021,634,3,25,109,134
16/05/2021,216,3,20,69,89
16/05/2021,703,3,10,54,64
16/05/2021,440,3,41,147,188
16/05/2021,685,3,21,79,100
16/05/2021,624,3,4,34,38
16/05/2021,731,3,16,69,85
16/05/2021,487,3,17,66,83
16/05/2021,511,3,10,75,85
16/05/2021,207,3,12,92,104
16/05/2021,20,3,21,33,54
16/05/2021,224,3,24,84,108
16/05/2021,419,3,51,179,230
16/05/2021,282,3,39,159,198
16/05/2021,515,3,17,54,71
16/05/2021,396,3,17,64,81
16/05/2021,335,3,26,87,113
16/05/2021,590,3,1,1,2
16/05/2021,781,3,43,241,284
16/05/2021,65,3,21,152,173
16/05/2021,592,3,28,150,178
16/05/2021,347,3,80,226,306
16/05/2021,629,3,22,94,116
16/05/2021,789,3,29,111,140
16/05/2021,676,3,16,61,77
16/05/2021,130,3,55,181,236
16/05/2021,869,3,85,208,293
16/05/2021,779,3,19,70,89
16/05/2021,867,3,33,67,100
16/05/2021,254,3,13,54,67
16/05/2021,483,3,25,108,133
16/05/2021,725,3,27,106,133
16/05/2021,827,3,91,272,363
16/05/2021,845,3,18,70,88
16/05/2021,21,3,24,120,144
16/05/2021,208,3,6,49,55
16/05/2021,214,3,50,215,265
16/05/2021,160,3,1,3,4
16/05/2021,346,3,11,39,50
16/05/2021,618,3,18,74,92
16/05/2021,225,3,25,111,136
16/05/2021,664,3,33,158,191
16/05/2021,31,3,20,106,126
16/05/2021,363,3,96,214,310
16/05/2021,880,3,0,10,10
16/05/2021,152,3,19,104,123
16/05/2021,226,3,38,101,139
16/05/2021,67,3,18,115,133
16/05/2021,669,3,22,77,99
16/05/2021,4,3,28,156,184
16/05/2021,211,3,49,216,265
16/05/2021,560,3,61,209,270
16/05/2021,525,3,31,123,154
16/05/2021,57,3,19,145,164
16/05/2021,806,3,52,173,225
16/05/2021,498,3,20,58,78
16/05/2021,657,3,42,143,185
16/05/2021,368,3,24,118,142
16/05/2021,437,3,21,133,154
16/05/2021,915,3,0,16,16
16/05/2021,425,3,26,129,155
16/05/2021,421,3,78,199,277
16/05/2021,517,3,23,71,94
16/05/2021,580,3,27,127,154
16/05/2021,24,3,15,25,40
16/05/2021,469,3,13,87,100
16/05/2021,651,3,16,61,77
16/05/2021,578,3,3,30,33
16/05/2021,260,3,150,491,641
16/05/2021,694,3,21,97,118
16/05/2021,661,3,32,161,193
16/05/2021,461,3,28,138,166
16/05/2021,680,3,47,113,160
16/05/2021,167,3,34,128,162
16/05/2021,527,3,29,53,82
16/05/2021,467,3,20,104,124
16/05/2021,209,3,16,99,115
16/05/2021,390,3,52,173,225
16/05/2021,739,3,8,57,65
16/05/2021,496,3,4,24,28
16/05/2021,142,3,13,35,48
16/05/2021,12,3,5,34,39
16/05/2021,881,3,0,59,59
16/05/2021,529,3,28,57,85
16/05/2021,862,3,48,121,169
16/05/2021,394,3,18,78,96
16/05/2021,173,3,19,63,82
16/05/2021,433,3,76,309,385
16/05/2021,816,3,77,244,321
16/05/2021,471,3,20,100,120
16/05/2021,303,3,60,248,308
16/05/2021,730,3,11,62,73
16/05/2021,8,3,30,105,135
16/05/2021,22,3,26,95,121
16/05/2021,682,3,6,43,49
16/05/2021,800,3,32,91,123
16/05/2021,447,3,21,66,87
16/05/2021,761,3,10,32,42
16/05/2021,268,3,32,156,188
16/05/2021,546,3,50,156,206
16/05/2021,764,3,8,27,35
16/05/2021,579,3,15,49,64
16/05/2021,308,3,29,124,153
16/05/2021,218,3,53,216,269
16/05/2021,603,3,60,169,229
16/05/2021,715,3,53,144,197
16/05/2021,322,3,29,84,113
16/05/2021,509,3,28,129,157
16/05/2021,438,3,12,75,87
16/05/2021,472,3,77,311,388
16/05/2021,58,3,39,218,257
16/05/2021,403,3,41,135,176
16/05/2021,376,3,15,28,43
16/05/2021,659,3,9,71,80
16/05/2021,627,3,19,54,73
16/05/2021,307,3,33,143,176
16/05/2021,85,3,57,62,119
16/05/2021,197,3,22,81,103
16/05/2021,372,3,64,214,278
16/05/2021,639,3,15,72,87
16/05/2021,665,3,13,80,93
16/05/2021,270,3,8,42,50
16/05/2021,674,3,22,75,97
16/05/2021,554,3,20,111,131
16/05/2021,295,3,29,164,193
16/05/2021,35,3,22,119,141
16/05/2021,919,3,22,120,142
16/05/2021,92,3,29,93,122
16/05/2021,622,3,84,259,343
16/05/2021,139,3,41,148,189
16/05/2021,760,3,23,102,125
16/05/2021,518,3,8,44,52
16/05/2021,202,3,55,225,280
16/05/2021,813,3,26,68,94
16/05/2021,204,3,17,107,124
16/05/2021,754,3,21,171,192
16/05/2021,3,3,36,77,113
16/05/2021,422,3,36,114,150
16/05/2021,782,3,41,199,240
16/05/2021,642,3,22,92,114
16/05/2021,292,3,73,487,560
16/05/2021,464,3,34,140,174
16/05/2021,72,3,51,265,316
16/05/2021,45,3,20,72,92
16/05/2021,39,3,17,104,121
16/05/2021,582,3,112,458,570
16/05/2021,102,3,48,173,221
16/05/2021,743,3,16,64,80
16/05/2021,134,3,47,155,202
16/05/2021,199,3,7,44,51
16/05/2021,543,3,153,472,625
16/05/2021,412,3,5,70,75
16/05/2021,706,3,56,164,220
16/05/2021,341,3,133,397,530
16/05/2021,126,3,26,152,178
16/05/2021,510,3,31,164,195
16/05/2021,930,3,0,8,8
16/05/2021,481,3,19,90,109
16/05/2021,691,3,28,113,141
16/05/2021,222,3,20,65,85
16/05/2021,452,3,13,112,125
16/05/2021,612,3,69,288,357
16/05/2021,772,3,30,141,171
16/05/2021,52,3,39,141,180
16/05/2021,426,3,19,85,104
16/05/2021,310,3,75,263,338
16/05/2021,906,3,4,4,8
16/05/2021,127,3,10,69,79
16/05/2021,861,3,70,147,217
16/05/2021,275,3,19,97,116
16/05/2021,326,3,12,48,60
16/05/2021,742,3,24,80,104
16/05/2021,227,3,23,109,132
16/05/2021,839,3,19,90,109
16/05/2021,137,3,39,150,189
16/05/2021,373,3,25,73,98
16/05/2021,538,3,31,109,140
16/05/2021,551,3,50,146,196
16/05/2021,430,3,21,115,136
16/05/2021,758,3,24,116,140
16/05/2021,569,3,39,148,187
16/05/2021,872,3,26,72,98
16/05/2021,113,3,7,37,44
16/05/2021,650,3,25,128,153
16/05/2021,563,3,19,69,88
16/05/2021,575,3,11,31,42
16/05/2021,240,3,66,330,396
16/05/2021,317,3,57,203,260
16/05/2021,63,3,11,64,75
16/05/2021,810,3,30,107,137
16/05/2021,345,3,27,77,104
16/05/2021,26,3,19,80,99
16/05/2021,513,3,3,38,41
16/05/2021,146,3,55,247,302
16/05/2021,812,3,14,105,119
16/05/2021,148,3,19,69,88
16/05/2021,576,3,2,28,30
16/05/2021,836,3,38,222,260
16/05/2021,163,3,16,69,85
16/05/2021,909,3,1,6,7
16/05/2021,213,3,54,227,281
16/05/2021,427,3,85,341,426
16/05/2021,684,3,30,119,149
16/05/2021,51,3,80,250,330
16/05/2021,128,3,11,68,79
16/05/2021,875,3,15,57,72
16/05/2021,138,3,42,135,177
16/05/2021,417,3,43,240,283
16/05/2021,266,3,14,63,77
16/05/2021,321,3,9,69,78
16/05/2021,354,3,4,2,6
16/05/2021,936,3,1,7,8
16/05/2021,252,3,13,64,77
16/05/2021,600,3,98,403,501
16/05/2021,290,3,74,475,549
16/05/2021,668,3,12,49,61
16/05/2021,476,3,14,70,84
16/05/2021,679,3,51,141,192
16/05/2021,821,3,37,132,169
16/05/2021,357,3,62,181,243
16/05/2021,107,3,71,297,368
16/05/2021,174,3,16,41,57
16/05/2021,5,3,36,76,112
16/05/2021,530,3,20,65,85
16/05/2021,38,3,19,93,112
16/05/2021,316,3,17,90,107
16/05/2021,407,3,33,186,219
16/05/2021,559,3,61,219,280
16/05/2021,756,3,49,245,294
16/05/2021,662,3,37,180,217
16/05/2021,616,3,31,108,139
16/05/2021,428,3,11,71,82
16/05/2021,135,3,50,164,214
16/05/2021,344,3,22,110,132
16/05/2021,115,3,6,44,50
16/05/2021,9,3,28,96,124
16/05/2021,542,3,50,114,164
16/05/2021,129,3,48,157,205
16/05/2021,68,3,23,157,180
16/05/2021,884,3,1,194,195
16/05/2021,122,3,40,108,148
16/05/2021,745,3,20,91,111
16/05/2021,615,3,23,129,152
16/05/2021,278,3,36,145,181
16/05/2021,100,3,65,302,367
16/05/2021,710,3,15,67,82
16/05/2021,370,3,26,119,145
16/05/2021,171,3,12,28,40
16/05/2021,700,3,23,109,132
16/05/2021,89,3,41,145,186
16/05/2021,753,3,38,158,196
16/05/2021,852,3,69,191,260
16/05/2021,71,3,17,72,89
16/05/2021,671,3,39,181,220
16/05/2021,41,3,10,90,100
16/05/2021,775,3,10,70,80
16/05/2021,793,3,22,99,121
16/05/2021,722,3,13,32,45
16/05/2021,449,3,25,116,141
16/05/2021,602,3,72,249,321
17/05/2021,775,3,53,201,254
17/05/2021,449,3,47,231,278
17/05/2021,671,3,43,227,270
17/05/2021,793,3,63,287,350
17/05/2021,602,3,162,554,716
17/05/2021,41,3,51,252,303
17/05/2021,722,3,19,132,151
17/05/2021,221,3,37,179,216
17/05/2021,488,3,81,195,276
17/05/2021,154,3,70,274,344
17/05/2021,759,3,25,116,141
17/05/2021,704,3,23,91,114
17/05/2021,751,3,1,6,7
17/05/2021,18,3,63,241,304
17/05/2021,826,3,105,375,480
17/05/2021,236,3,43,186,229
17/05/2021,765,3,72,221,293
17/05/2021,879,3,0,26,26
17/05/2021,242,3,89,471,560
17/05/2021,47,3,62,184,246
17/05/2021,536,3,46,111,157
17/05/2021,908,3,37,206,243
17/05/2021,302,3,70,421,491
17/05/2021,693,3,32,168,200
17/05/2021,387,3,69,166,235
17/05/2021,926,3,8,24,32
17/05/2021,727,3,41,180,221
17/05/2021,367,3,62,358,420
17/05/2021,914,3,2,6,8
17/05/2021,185,3,38,183,221
17/05/2021,124,3,61,152,213
17/05/2021,842,3,9,21,30
17/05/2021,289,3,43,135,178
17/05/2021,30,3,108,252,360
17/05/2021,604,3,115,401,516
17/05/2021,850,3,157,542,699
17/05/2021,61,3,46,303,349
17/05/2021,144,3,61,290,351
17/05/2021,843,3,29,139,168
17/05/2021,261,3,309,1057,1366
17/05/2021,328,3,54,225,279
17/05/2021,454,3,75,278,353
17/05/2021,288,3,25,65,90
17/05/2021,910,3,3,48,51
17/05/2021,892,3,7,10,17
17/05/2021,495,3,34,132,166
17/05/2021,82,3,101,351,452
17/05/2021,359,3,78,289,367
17/05/2021,91,3,63,230,293
17/05/2021,625,3,45,161,206
17/05/2021,246,3,100,526,626
17/05/2021,572,3,73,255,328
17/05/2021,435,3,46,127,173
17/05/2021,533,3,79,227,306
17/05/2021,87,3,137,452,589
17/05/2021,205,3,45,192,237
17/05/2021,749,3,29,176,205
17/05/2021,374,3,45,140,185
17/05/2021,737,3,23,114,137
17/05/2021,631,3,15,70,85
17/05/2021,492,3,32,125,157
17/05/2021,69,3,65,255,320
17/05/2021,795,3,64,288,352
17/05/2021,558,3,45,153,198
17/05/2021,702,3,42,211,253
17/05/2021,586,3,75,335,410
17/05/2021,477,3,40,129,169
17/05/2021,883,3,5,51,56
17/05/2021,537,3,97,336,433
17/05/2021,175,3,40,189,229
17/05/2021,93,3,55,313,368
17/05/2021,406,3,85,309,394
17/05/2021,903,3,1,2,3
17/05/2021,398,3,11,23,34
17/05/2021,889,3,0,14,14
17/05/2021,858,3,123,453,576
17/05/2021,378,3,30,211,241
17/05/2021,613,3,23,119,142
17/05/2021,504,3,18,77,95
17/05/2021,493,3,41,153,194
17/05/2021,902,3,68,237,305
17/05/2021,330,3,43,259,302
17/05/2021,117,3,139,339,478
17/05/2021,304,3,104,305,409
17/05/2021,807,3,49,182,231
17/05/2021,212,3,60,327,387
17/05/2021,338,3,72,306,378
17/05/2021,210,3,36,151,187
17/05/2021,78,3,254,858,1112
17/05/2021,411,3,92,584,676
17/05/2021,840,3,33,205,238
17/05/2021,453,3,48,280,328
17/05/2021,463,3,127,555,682
17/05/2021,692,3,72,234,306
17/05/2021,877,3,1,13,14
17/05/2021,635,3,45,276,321
17/05/2021,140,3,35,177,212
17/05/2021,663,3,67,205,272
17/05/2021,655,3,84,303,387
17/05/2021,457,3,37,141,178
17/05/2021,281,3,55,233,288
17/05/2021,666,3,82,299,381
17/05/2021,882,3,1,17,18
17/05/2021,446,3,30,197,227
17/05/2021,450,3,51,201,252
17/05/2021,401,3,27,115,142
17/05/2021,239,3,54,242,296
17/05/2021,920,3,0,1,1
17/05/2021,707,3,125,299,424
17/05/2021,522,3,43,157,200
17/05/2021,784,3,200,779,979
17/05/2021,296,3,39,75,114
17/05/2021,267,3,57,189,246
17/05/2021,66,3,43,296,339
17/05/2021,790,3,57,265,322
17/05/2021,182,3,41,158,199
17/05/2021,416,3,25,121,146
17/05/2021,491,3,67,413,480
17/05/2021,594,3,121,487,608
17/05/2021,755,3,84,450,534
17/05/2021,848,3,68,211,279
17/05/2021,865,3,22,57,79
17/05/2021,932,3,0,2,2
17/05/2021,262,3,37,73,110
17/05/2021,228,3,34,112,146
17/05/2021,475,3,124,410,534
17/05/2021,519,3,64,229,293
17/05/2021,917,3,3,27,30
17/05/2021,106,3,95,406,501
17/05/2021,193,3,61,263,324
17/05/2021,183,3,34,138,172
17/05/2021,617,3,51,164,215
17/05/2021,451,3,138,644,782
17/05/2021,539,3,110,340,450
17/05/2021,230,3,56,209,265
17/05/2021,787,3,275,1033,1308
17/05/2021,364,3,107,238,345
17/05/2021,284,3,31,103,134
17/05/2021,923,3,0,2,2
17/05/2021,734,3,40,108,148
17/05/2021,873,3,84,325,409
17/05/2021,938,3,0,3,3
17/05/2021,925,3,0,1,1
17/05/2021,118,3,73,212,285
17/05/2021,49,3,25,71,96
17/05/2021,258,3,273,999,1272
17/05/2021,521,3,37,123,160
17/05/2021,234,3,19,82,101
17/05/2021,325,3,27,218,245
17/05/2021,799,3,16,62,78
17/05/2021,6,3,45,143,188
17/05/2021,200,3,30,154,184
17/05/2021,231,3,59,249,308
17/05/2021,652,3,21,76,97
17/05/2021,25,3,78,252,330
17/05/2021,904,3,68,268,336
17/05/2021,507,3,70,468,538
17/05/2021,591,3,70,218,288
17/05/2021,581,3,77,283,360
17/05/2021,687,3,78,303,381
17/05/2021,119,3,71,206,277
17/05/2021,608,3,192,866,1058
17/05/2021,245,3,25,116,141
17/05/2021,792,3,85,219,304
17/05/2021,145,3,75,261,336
17/05/2021,922,3,0,5,5
17/05/2021,133,3,22,73,95
17/05/2021,442,3,48,188,236
17/05/2021,46,3,48,191,239
17/05/2021,677,3,31,131,162
17/05/2021,809,3,30,141,171
17/05/2021,448,3,141,641,782
17/05/2021,444,3,53,236,289
17/05/2021,555,3,139,467,606
17/05/2021,353,3,23,88,111
17/05/2021,314,3,30,103,133
17/05/2021,831,3,58,241,299
17/05/2021,855,3,62,315,377
17/05/2021,121,3,257,828,1085
17/05/2021,709,3,133,344,477
17/05/2021,32,3,62,166,228
17/05/2021,434,3,9,25,34
17/05/2021,505,3,19,89,108
17/05/2021,257,3,264,915,1179
17/05/2021,103,3,124,404,528
17/05/2021,277,3,71,234,305
17/05/2021,176,3,64,258,322
17/05/2021,835,3,104,316,420
17/05/2021,837,3,56,257,313
17/05/2021,389,3,120,426,546
17/05/2021,232,3,51,210,261
17/05/2021,860,3,50,196,246
17/05/2021,366,3,45,105,150
17/05/2021,274,3,0,9,9
17/05/2021,33,3,55,179,234
17/05/2021,480,3,37,97,134
17/05/2021,623,3,77,296,373
17/05/2021,854,3,107,534,641
17/05/2021,429,3,55,292,347
17/05/2021,588,3,64,219,283
17/05/2021,177,3,25,128,153
17/05/2021,885,3,3,55,58
17/05/2021,767,3,149,516,665
17/05/2021,120,3,70,254,324
17/05/2021,250,3,93,202,295
17/05/2021,392,3,47,182,229
17/05/2021,108,3,38,120,158
17/05/2021,830,3,295,939,1234
17/05/2021,531,3,59,262,321
17/05/2021,757,3,98,338,436
17/05/2021,820,3,54,211,265
17/05/2021,410,3,69,407,476
17/05/2021,386,3,192,702,894
17/05/2021,486,3,66,276,342
17/05/2021,96,3,42,141,183
17/05/2021,643,3,58,275,333
17/05/2021,339,3,63,278,341
17/05/2021,158,3,35,150,185
17/05/2021,2,3,44,144,188
17/05/2021,921,3,0,12,12
17/05/2021,732,3,29,132,161
17/05/2021,441,3,118,521,639
17/05/2021,327,3,176,555,731
17/05/2021,791,3,52,256,308
17/05/2021,256,3,86,224,310
17/05/2021,818,3,71,319,390
17/05/2021,53,3,99,222,321
17/05/2021,203,3,55,219,274
17/05/2021,490,3,28,106,134
17/05/2021,206,3,2,9,11
17/05/2021,432,3,59,240,299
17/05/2021,805,3,49,159,208
17/05/2021,34,3,46,150,196
17/05/2021,857,3,53,180,233
17/05/2021,294,3,86,297,383
17/05/2021,626,3,44,157,201
17/05/2021,84,3,174,599,773
17/05/2021,220,3,36,185,221
17/05/2021,285,3,41,145,186
17/05/2021,699,3,44,179,223
17/05/2021,385,3,58,220,278
17/05/2021,750,3,61,347,408
17/05/2021,180,3,52,208,260
17/05/2021,143,3,97,416,513
17/05/2021,76,3,122,571,693
17/05/2021,886,3,0,6,6
17/05/2021,184,3,38,156,194
17/05/2021,151,3,34,142,176
17/05/2021,190,3,75,256,331
17/05/2021,259,3,204,694,898
17/05/2021,255,3,8,8,16
17/05/2021,939,3,0,3,3
17/05/2021,526,3,36,148,184
17/05/2021,420,3,148,382,530
17/05/2021,689,3,90,248,338
17/05/2021,593,3,198,727,925
17/05/2021,342,3,37,215,252
17/05/2021,365,3,41,118,159
17/05/2021,271,3,56,163,219
17/05/2021,817,3,74,287,361
17/05/2021,243,3,104,520,624
17/05/2021,131,3,57,217,274
17/05/2021,620,3,0,2,2
17/05/2021,778,3,89,304,393
17/05/2021,101,3,50,189,239
17/05/2021,485,3,62,232,294
17/05/2021,460,3,39,201,240
17/05/2021,19,3,88,345,433
17/05/2021,172,3,45,311,356
17/05/2021,334,3,132,441,573
17/05/2021,466,3,51,241,292
17/05/2021,803,3,60,224,284
17/05/2021,723,3,51,208,259
17/05/2021,868,3,181,658,839
17/05/2021,520,3,35,170,205
17/05/2021,64,3,24,142,166
17/05/2021,99,3,146,573,719
17/05/2021,88,3,63,202,265
17/05/2021,815,3,196,714,910
17/05/2021,738,3,61,201,262
17/05/2021,890,3,23,163,186
17/05/2021,105,3,90,252,342
17/05/2021,157,3,50,236,286
17/05/2021,497,3,59,412,471
17/05/2021,774,3,42,199,241
17/05/2021,298,3,86,522,608
17/05/2021,166,3,20,215,235
17/05/2021,646,3,49,200,249
17/05/2021,196,3,35,149,184
17/05/2021,123,3,65,169,234
17/05/2021,7,3,46,144,190
17/05/2021,585,3,124,394,518
17/05/2021,125,3,56,181,237
17/05/2021,798,3,123,385,508
17/05/2021,577,3,44,298,342
17/05/2021,595,3,37,128,165
17/05/2021,874,3,48,227,275
17/05/2021,719,3,35,135,170
17/05/2021,44,3,89,369,458
17/05/2021,532,3,288,1106,1394
17/05/2021,876,3,0,3,3
17/05/2021,11,3,58,195,253
17/05/2021,780,3,147,528,675
17/05/2021,424,3,64,461,525
17/05/2021,829,3,77,380,457
17/05/2021,170,3,44,317,361
17/05/2021,711,3,43,157,200
17/05/2021,409,3,22,59,81
17/05/2021,705,3,18,69,87
17/05/2021,717,3,46,193,239
17/05/2021,614,3,50,137,187
17/05/2021,638,3,86,309,395
17/05/2021,70,3,114,514,628
17/05/2021,866,3,111,429,540
17/05/2021,418,3,24,53,77
17/05/2021,235,3,35,248,283
17/05/2021,918,3,0,14,14
17/05/2021,194,3,0,1,1
17/05/2021,752,3,112,434,546
17/05/2021,900,3,3,4,7
17/05/2021,681,3,82,280,362
17/05/2021,658,3,34,208,242
17/05/2021,632,3,16,77,93
17/05/2021,675,3,49,177,226
17/05/2021,534,3,53,163,216
17/05/2021,383,3,178,720,898
17/05/2021,863,3,60,190,250
17/05/2021,60,3,18,65,83
17/05/2021,924,3,0,4,4
17/05/2021,251,3,26,174,200
17/05/2021,597,3,40,176,216
17/05/2021,247,3,71,331,402
17/05/2021,654,3,48,206,254
17/05/2021,350,3,42,165,207
17/05/2021,462,3,55,235,290
17/05/2021,192,3,27,124,151
17/05/2021,15,3,86,299,385
17/05/2021,436,3,45,211,256
17/05/2021,253,3,28,123,151
17/05/2021,683,3,45,207,252
17/05/2021,474,3,47,172,219
17/05/2021,512,3,16,87,103
17/05/2021,56,3,55,358,413
17/05/2021,393,3,34,155,189
17/05/2021,399,3,123,458,581
17/05/2021,825,3,80,281,361
17/05/2021,269,3,54,154,208
17/05/2021,162,3,166,591,757
17/05/2021,186,3,36,82,118
17/05/2021,195,3,29,102,131
17/05/2021,161,3,169,601,770
17/05/2021,473,3,37,160,197
17/05/2021,309,3,17,73,90
17/05/2021,37,3,59,125,184
17/05/2021,443,3,50,251,301
17/05/2021,59,3,40,157,197
17/05/2021,244,3,45,224,269
17/05/2021,95,3,114,454,568
17/05/2021,802,3,145,631,776
17/05/2021,164,3,34,245,279
17/05/2021,931,3,0,2,2
17/05/2021,561,3,40,127,167
17/05/2021,746,3,39,217,256
17/05/2021,673,3,52,260,312
17/05/2021,159,3,63,292,355
17/05/2021,770,3,153,536,689
17/05/2021,736,3,15,90,105
17/05/2021,547,3,301,950,1251
17/05/2021,27,3,154,380,534
17/05/2021,721,3,295,1161,1456
17/05/2021,168,3,40,181,221
17/05/2021,937,3,0,1,1
17/05/2021,524,3,92,318,410
17/05/2021,794,3,122,544,666
17/05/2021,90,3,33,164,197
17/05/2021,713,3,55,498,553
17/05/2021,149,3,61,257,318
17/05/2021,587,3,15,46,61
17/05/2021,567,3,81,278,359
17/05/2021,456,3,52,239,291
17/05/2021,811,3,30,149,179
17/05/2021,229,3,96,342,438
17/05/2021,361,3,104,235,339
17/05/2021,413,3,86,500,586
17/05/2021,571,3,67,221,288
17/05/2021,17,3,31,158,189
17/05/2021,147,3,59,273,332
17/05/2021,864,3,27,146,173
17/05/2021,589,3,59,209,268
17/05/2021,198,3,84,294,378
17/05/2021,648,3,46,181,227
17/05/2021,888,3,3,29,32
17/05/2021,607,3,174,813,987
17/05/2021,332,3,62,220,282
17/05/2021,776,3,61,257,318
17/05/2021,153,3,72,279,351
17/05/2021,42,3,52,157,209
17/05/2021,287,3,96,539,635
17/05/2021,819,3,99,287,386
17/05/2021,50,3,27,69,96
17/05/2021,896,3,309,971,1280
17/05/2021,23,3,13,55,68
17/05/2021,553,3,25,50,75
17/05/2021,573,3,62,245,307
17/05/2021,849,3,49,338,387
17/05/2021,801,3,53,256,309
17/05/2021,379,3,53,276,329
17/05/2021,470,3,66,296,362
17/05/2021,847,3,4,33,37
17/05/2021,570,3,57,206,263
17/05/2021,696,3,55,268,323
17/05/2021,286,3,14,80,94
17/05/2021,238,3,87,440,527
17/05/2021,187,3,25,96,121
17/05/2021,423,3,60,437,497
17/05/2021,189,3,47,156,203
17/05/2021,785,3,232,883,1115
17/05/2021,777,3,86,212,298
17/05/2021,305,3,65,289,354
17/05/2021,28,3,42,146,188
17/05/2021,400,3,24,109,133
17/05/2021,276,3,62,236,298
17/05/2021,897,3,17,44,61
17/05/2021,895,3,54,201,255
17/05/2021,380,3,53,268,321
17/05/2021,698,3,39,138,177
17/05/2021,98,3,114,435,549
17/05/2021,891,3,50,245,295
17/05/2021,911,3,42,322,364
17/05/2021,913,3,5,8,13
17/05/2021,337,3,19,111,130
17/05/2021,856,3,107,363,470
17/05/2021,55,3,33,159,192
17/05/2021,319,3,18,90,108
17/05/2021,329,3,188,584,772
17/05/2021,299,3,23,121,144
17/05/2021,508,3,61,339,400
17/05/2021,313,3,30,109,139
17/05/2021,844,3,36,132,168
17/05/2021,808,3,121,408,529
17/05/2021,724,3,263,865,1128
17/05/2021,301,3,81,399,480
17/05/2021,814,3,56,178,234
17/05/2021,181,3,48,150,198
17/05/2021,459,3,65,281,346
17/05/2021,550,3,119,368,487
17/05/2021,716,3,43,164,207
17/05/2021,355,3,33,145,178
17/05/2021,894,3,51,161,212
17/05/2021,340,3,72,292,364
17/05/2021,97,3,119,370,489
17/05/2021,188,3,77,295,372
17/05/2021,656,3,31,153,184
17/05/2021,697,3,39,141,180
17/05/2021,859,3,7,24,31
17/05/2021,601,3,42,140,182
17/05/2021,80,3,25,119,144
17/05/2021,501,3,74,448,522
17/05/2021,636,3,31,141,172
17/05/2021,499,3,33,165,198
17/05/2021,733,3,38,171,209
17/05/2021,610,3,147,688,835
17/05/2021,870,3,31,100,131
17/05/2021,306,3,0,2,2
17/05/2021,279,3,58,239,297
17/05/2021,489,3,8,37,45
17/05/2021,178,3,72,254,326
17/05/2021,786,3,121,450,571
17/05/2021,528,3,36,158,194
17/05/2021,458,3,63,261,324
17/05/2021,155,3,71,357,428
17/05/2021,788,3,270,1044,1314
17/05/2021,565,3,150,526,676
17/05/2021,478,3,57,188,245
17/05/2021,735,3,18,105,123
17/05/2021,318,3,110,396,506
17/05/2021,628,3,65,136,201
17/05/2021,54,3,73,160,233
17/05/2021,237,3,92,445,537
17/05/2021,89,3,102,361,463
17/05/2021,71,3,42,214,256
17/05/2021,278,3,55,194,249
17/05/2021,370,3,59,347,406
17/05/2021,100,3,151,585,736
17/05/2021,122,3,72,250,322
17/05/2021,171,3,13,29,42
17/05/2021,615,3,67,259,326
17/05/2021,710,3,43,165,208
17/05/2021,700,3,38,149,187
17/05/2021,745,3,38,228,266
17/05/2021,753,3,63,310,373
17/05/2021,852,3,117,286,403
17/05/2021,580,3,35,191,226
17/05/2021,24,3,15,53,68
17/05/2021,421,3,107,245,352
17/05/2021,461,3,71,256,327
17/05/2021,578,3,14,62,76
17/05/2021,651,3,49,170,219
17/05/2021,517,3,40,165,205
17/05/2021,469,3,45,182,227
17/05/2021,260,3,308,1079,1387
17/05/2021,661,3,93,306,399
17/05/2021,680,3,46,121,167
17/05/2021,425,3,66,283,349
17/05/2021,694,3,43,193,236
17/05/2021,312,3,67,208,275
17/05/2021,557,3,52,177,229
17/05/2021,397,3,32,135,167
17/05/2021,833,3,25,122,147
17/05/2021,249,3,106,544,650
17/05/2021,300,3,74,456,530
17/05/2021,898,3,48,117,165
17/05/2021,853,3,45,160,205
17/05/2021,540,3,132,426,558
17/05/2021,851,3,62,256,318
17/05/2021,348,3,28,148,176
17/05/2021,48,3,24,74,98
17/05/2021,670,3,328,1092,1420
17/05/2021,768,3,66,327,393
17/05/2021,484,3,63,222,285
17/05/2021,714,3,88,286,374
17/05/2021,574,3,73,268,341
17/05/2021,598,3,203,874,1077
17/05/2021,362,3,110,237,347
17/05/2021,832,3,57,228,285
17/05/2021,584,3,205,777,982
17/05/2021,728,3,56,287,343
17/05/2021,110,3,33,157,190
17/05/2021,439,3,33,174,207
17/05/2021,431,3,52,211,263
17/05/2021,647,3,52,210,262
17/05/2021,838,3,36,149,185
17/05/2021,506,3,68,434,502
17/05/2021,404,3,188,551,739
17/05/2021,352,3,79,296,375
17/05/2021,686,3,34,176,210
17/05/2021,136,3,94,332,426
17/05/2021,823,3,49,141,190
17/05/2021,265,3,39,100,139
17/05/2021,1,3,45,142,187
17/05/2021,371,3,63,215,278
17/05/2021,701,3,32,181,213
17/05/2021,391,3,129,411,540
17/05/2021,878,3,0,10,10
17/05/2021,111,3,108,406,514
17/05/2021,514,3,19,91,110
17/05/2021,660,3,41,168,209
17/05/2021,219,3,37,158,195
17/05/2021,323,3,38,107,145
17/05/2021,77,3,126,625,751
17/05/2021,75,3,127,619,746
17/05/2021,544,3,107,264,371
17/05/2021,556,3,155,536,691
17/05/2021,887,3,0,13,13
17/05/2021,349,3,32,165,197
17/05/2021,215,3,27,131,158
17/05/2021,564,3,98,323,421
17/05/2021,384,3,79,269,348
17/05/2021,633,3,26,135,161
17/05/2021,619,3,50,128,178
17/05/2021,408,3,103,575,678
17/05/2021,272,3,72,275,347
17/05/2021,901,3,2,14,16
17/05/2021,248,3,38,106,144
17/05/2021,535,3,47,185,232
17/05/2021,688,3,51,197,248
17/05/2021,83,3,239,942,1181
17/05/2021,899,3,134,551,685
17/05/2021,804,3,98,483,581
17/05/2021,112,3,46,126,172
17/05/2021,934,3,0,19,19
17/05/2021,264,3,35,77,112
17/05/2021,104,3,80,238,318
17/05/2021,402,3,107,366,473
17/05/2021,479,3,38,109,147
17/05/2021,649,3,63,136,199
17/05/2021,548,3,53,185,238
17/05/2021,169,3,39,244,283
17/05/2021,297,3,59,348,407
17/05/2021,871,3,96,362,458
17/05/2021,747,3,57,203,260
17/05/2021,720,3,35,153,188
17/05/2021,315,3,10,77,87
17/05/2021,726,3,44,195,239
17/05/2021,283,3,53,192,245
17/05/2021,599,3,206,854,1060
17/05/2021,395,3,41,175,216
17/05/2021,503,3,57,361,418
17/05/2021,336,3,226,748,974
17/05/2021,377,3,82,237,319
17/05/2021,468,3,33,208,241
17/05/2021,13,3,43,157,200
17/05/2021,605,3,125,454,579
17/05/2021,36,3,39,224,263
17/05/2021,405,3,25,64,89
17/05/2021,640,3,39,206,245
17/05/2021,273,3,59,335,394
17/05/2021,657,3,101,346,447
17/05/2021,57,3,52,325,377
17/05/2021,211,3,57,287,344
17/05/2021,437,3,50,266,316
17/05/2021,560,3,144,470,614
17/05/2021,368,3,69,348,417
17/05/2021,152,3,62,275,337
17/05/2021,669,3,43,190,233
17/05/2021,4,3,34,150,184
17/05/2021,498,3,37,124,161
17/05/2021,226,3,52,240,292
17/05/2021,67,3,48,272,320
17/05/2021,525,3,87,339,426
17/05/2021,806,3,109,437,546
17/05/2021,915,3,0,28,28
17/05/2021,771,3,56,280,336
17/05/2021,81,3,18,112,130
17/05/2021,116,3,40,170,210
17/05/2021,773,3,34,178,212
17/05/2021,351,3,175,622,797
17/05/2021,388,3,116,447,563
17/05/2021,606,3,76,308,384
17/05/2021,552,3,128,403,531
17/05/2021,645,3,42,180,222
17/05/2021,331,3,54,187,241
17/05/2021,291,3,65,426,491
17/05/2021,783,3,91,484,575
17/05/2021,43,3,64,280,344
17/05/2021,293,3,50,312,362
17/05/2021,465,3,34,212,246
17/05/2021,333,3,48,400,448
17/05/2021,907,3,119,442,561
17/05/2021,280,3,25,63,88
17/05/2021,797,3,116,277,393
17/05/2021,824,3,120,530,650
17/05/2021,566,3,36,155,191
17/05/2021,114,3,70,224,294
17/05/2021,79,3,42,182,224
17/05/2021,356,3,144,546,690
17/05/2021,500,3,13,62,75
17/05/2021,712,3,45,163,208
17/05/2021,311,3,68,256,324
17/05/2021,217,3,52,272,324
17/05/2021,637,3,136,585,721
17/05/2021,360,3,47,235,282
17/05/2021,846,3,5,34,39
17/05/2021,562,3,24,62,86
17/05/2021,455,3,28,148,176
17/05/2021,641,3,42,219,261
17/05/2021,828,3,97,214,311
17/05/2021,494,3,40,169,209
17/05/2021,358,3,186,751,937
17/05/2021,621,3,50,180,230
17/05/2021,343,3,23,188,211
17/05/2021,653,3,17,79,96
17/05/2021,445,3,46,262,308
17/05/2021,414,3,98,581,679
17/05/2021,905,3,1,4,5
17/05/2021,201,3,34,186,220
17/05/2021,156,3,53,258,311
17/05/2021,179,3,45,204,249
17/05/2021,741,3,22,121,143
17/05/2021,664,3,84,291,375
17/05/2021,225,3,63,198,261
17/05/2021,21,3,67,281,348
17/05/2021,346,3,31,162,193
17/05/2021,845,3,60,195,255
17/05/2021,725,3,49,201,250
17/05/2021,160,3,2,25,27
17/05/2021,618,3,51,233,284
17/05/2021,31,3,46,238,284
17/05/2021,363,3,116,240,356
17/05/2021,208,3,25,139,164
17/05/2021,94,3,0,1,1
17/05/2021,827,3,154,389,543
17/05/2021,483,3,71,288,359
17/05/2021,214,3,59,288,347
17/05/2021,880,3,0,21,21
17/05/2021,381,3,2,1,3
17/05/2021,369,3,131,477,608
17/05/2021,685,3,50,203,253
17/05/2021,634,3,53,265,318
17/05/2021,511,3,20,131,151
17/05/2021,86,3,29,121,150
17/05/2021,583,3,29,151,180
17/05/2021,841,3,7,65,72
17/05/2021,487,3,50,172,222
17/05/2021,216,3,41,201,242
17/05/2021,624,3,14,85,99
17/05/2021,263,3,48,146,194
17/05/2021,703,3,26,158,184
17/05/2021,233,3,83,309,392
17/05/2021,748,3,54,137,191
17/05/2021,440,3,55,288,343
17/05/2021,731,3,40,160,200
17/05/2021,629,3,46,221,267
17/05/2021,515,3,30,121,151
17/05/2021,592,3,86,304,390
17/05/2021,347,3,161,557,718
17/05/2021,781,3,82,425,507
17/05/2021,396,3,30,139,169
17/05/2021,419,3,90,349,439
17/05/2021,207,3,33,200,233
17/05/2021,20,3,66,108,174
17/05/2021,676,3,47,117,164
17/05/2021,867,3,53,166,219
17/05/2021,335,3,47,208,255
17/05/2021,789,3,70,225,295
17/05/2021,869,3,102,228,330
17/05/2021,254,3,29,124,153
17/05/2021,65,3,44,321,365
17/05/2021,224,3,37,118,155
17/05/2021,779,3,65,152,217
17/05/2021,130,3,122,382,504
17/05/2021,282,3,64,211,275
17/05/2021,590,3,1,0,1
17/05/2021,9,3,66,201,267
17/05/2021,616,3,89,303,392
17/05/2021,756,3,85,486,571
17/05/2021,428,3,36,178,214
17/05/2021,68,3,55,338,393
17/05/2021,129,3,79,233,312
17/05/2021,115,3,24,102,126
17/05/2021,884,3,3,48,51
17/05/2021,933,3,0,2,2
17/05/2021,344,3,62,218,280
17/05/2021,542,3,79,279,358
17/05/2021,662,3,91,351,442
17/05/2021,135,3,97,354,451
17/05/2021,310,3,213,769,982
17/05/2021,772,3,85,369,454
17/05/2021,906,3,8,12,20
17/05/2021,861,3,112,307,419
17/05/2021,742,3,46,207,253
17/05/2021,222,3,41,177,218
17/05/2021,275,3,57,232,289
17/05/2021,452,3,53,245,298
17/05/2021,691,3,53,204,257
17/05/2021,481,3,61,221,282
17/05/2021,52,3,76,310,386
17/05/2021,127,3,52,190,242
17/05/2021,326,3,36,120,156
17/05/2021,426,3,34,144,178
17/05/2021,227,3,39,129,168
17/05/2021,612,3,152,671,823
17/05/2021,579,3,34,143,177
17/05/2021,509,3,54,312,366
17/05/2021,603,3,118,417,535
17/05/2021,322,3,70,207,277
17/05/2021,218,3,56,288,344
17/05/2021,308,3,61,259,320
17/05/2021,403,3,109,376,485
17/05/2021,58,3,84,463,547
17/05/2021,715,3,104,371,475
17/05/2021,472,3,143,606,749
17/05/2021,764,3,20,87,107
17/05/2021,438,3,41,163,204
17/05/2021,816,3,166,638,804
17/05/2021,142,3,48,95,143
17/05/2021,527,3,47,177,224
17/05/2021,496,3,19,87,106
17/05/2021,739,3,23,118,141
17/05/2021,390,3,119,454,573
17/05/2021,433,3,128,582,710
17/05/2021,209,3,17,108,125
17/05/2021,173,3,53,182,235
17/05/2021,394,3,45,184,229
17/05/2021,881,3,0,6,6
17/05/2021,12,3,17,85,102
17/05/2021,862,3,75,303,378
17/05/2021,529,3,60,222,282
17/05/2021,467,3,54,224,278
17/05/2021,167,3,88,335,423
17/05/2021,22,3,43,244,287
17/05/2021,471,3,36,208,244
17/05/2021,303,3,62,320,382
17/05/2021,761,3,34,126,160
17/05/2021,546,3,131,437,568
17/05/2021,8,3,45,148,193
17/05/2021,730,3,25,159,184
17/05/2021,682,3,23,108,131
17/05/2021,800,3,73,228,301
17/05/2021,447,3,38,127,165
17/05/2021,268,3,101,333,434
17/05/2021,743,3,25,176,201
17/05/2021,582,3,242,972,1214
17/05/2021,412,3,15,157,172
17/05/2021,930,3,0,12,12
17/05/2021,102,3,109,376,485
17/05/2021,510,3,62,421,483
17/05/2021,706,3,129,336,465
17/05/2021,39,3,64,289,353
17/05/2021,199,3,24,126,150
17/05/2021,134,3,92,317,409
17/05/2021,543,3,288,927,1215
17/05/2021,45,3,44,153,197
17/05/2021,341,3,233,783,1016
17/05/2021,126,3,80,329,409
17/05/2021,554,3,48,236,284
17/05/2021,307,3,89,320,409
17/05/2021,270,3,30,123,153
17/05/2021,659,3,33,195,228
17/05/2021,376,3,13,54,67
17/05/2021,674,3,40,187,227
17/05/2021,35,3,53,280,333
17/05/2021,372,3,145,487,632
17/05/2021,919,3,78,301,379
17/05/2021,665,3,45,221,266
17/05/2021,627,3,37,125,162
17/05/2021,85,3,215,771,986
17/05/2021,295,3,27,163,190
17/05/2021,197,3,36,199,235
17/05/2021,639,3,47,173,220
17/05/2021,518,3,20,133,153
17/05/2021,72,3,132,595,727
17/05/2021,92,3,65,214,279
17/05/2021,782,3,77,407,484
17/05/2021,754,3,56,393,449
17/05/2021,422,3,56,170,226
17/05/2021,760,3,55,313,368
17/05/2021,813,3,53,197,250
17/05/2021,204,3,56,217,273
17/05/2021,622,3,142,383,525
17/05/2021,642,3,45,220,265
17/05/2021,3,3,48,140,188
17/05/2021,464,3,52,273,325
17/05/2021,292,3,87,494,581
17/05/2021,202,3,91,472,563
17/05/2021,139,3,62,201,263
17/05/2021,357,3,150,579,729
17/05/2021,530,3,39,114,153
17/05/2021,407,3,66,395,461
17/05/2021,38,3,68,270,338
17/05/2021,174,3,34,162,196
17/05/2021,290,3,70,456,526
17/05/2021,559,3,148,495,643
17/05/2021,916,3,0,1,1
17/05/2021,668,3,24,125,149
17/05/2021,476,3,41,157,198
17/05/2021,821,3,93,299,392
17/05/2021,679,3,49,156,205
17/05/2021,316,3,46,208,254
17/05/2021,5,3,44,142,186
17/05/2021,107,3,161,603,764
17/05/2021,576,3,7,46,53
17/05/2021,317,3,131,439,570
17/05/2021,240,3,88,449,537
17/05/2021,26,3,62,258,320
17/05/2021,146,3,113,457,570
17/05/2021,63,3,38,129,167
17/05/2021,345,3,65,148,213
17/05/2021,513,3,25,107,132
17/05/2021,812,3,41,227,268
17/05/2021,148,3,34,158,192
17/05/2021,810,3,42,208,250
17/05/2021,650,3,65,291,356
17/05/2021,563,3,59,210,269
17/05/2021,538,3,60,274,334
17/05/2021,551,3,103,404,507
17/05/2021,430,3,59,234,293
17/05/2021,872,3,59,122,181
17/05/2021,839,3,51,199,250
17/05/2021,575,3,18,103,121
17/05/2021,137,3,60,218,278
17/05/2021,569,3,78,265,343
17/05/2021,758,3,70,273,343
17/05/2021,373,3,72,218,290
17/05/2021,113,3,25,110,135
17/05/2021,600,3,185,797,982
17/05/2021,321,3,40,141,181
17/05/2021,163,3,47,189,236
17/05/2021,128,3,50,190,240
17/05/2021,909,3,1,5,6
17/05/2021,684,3,73,306,379
17/05/2021,51,3,196,758,954
17/05/2021,138,3,65,195,260
17/05/2021,417,3,88,541,629
17/05/2021,427,3,156,686,842
17/05/2021,213,3,63,308,371
17/05/2021,875,3,30,170,200
17/05/2021,266,3,47,163,210
17/05/2021,836,3,72,452,524
17/05/2021,936,3,5,23,28
17/05/2021,252,3,47,155,202
17/05/2021,354,3,6,6,12
18/05/2021,417,3,101,589,690
18/05/2021,51,3,219,823,1042
18/05/2021,354,3,4,7,11
18/05/2021,252,3,46,148,194
18/05/2021,213,3,75,325,400
18/05/2021,427,3,201,751,952
18/05/2021,163,3,59,225,284
18/05/2021,684,3,99,339,438
18/05/2021,936,3,10,32,42
18/05/2021,875,3,28,188,216
18/05/2021,266,3,38,172,210
18/05/2021,836,3,82,487,569
18/05/2021,138,3,55,193,248
18/05/2021,128,3,53,184,237
18/05/2021,321,3,35,162,197
18/05/2021,600,3,223,906,1129
18/05/2021,909,3,2,5,7
18/05/2021,188,3,106,340,446
18/05/2021,340,3,78,325,403
18/05/2021,636,3,35,155,190
18/05/2021,870,3,26,90,116
18/05/2021,601,3,57,130,187
18/05/2021,499,3,43,174,217
18/05/2021,656,3,35,134,169
18/05/2021,894,3,68,159,227
18/05/2021,859,3,6,22,28
18/05/2021,501,3,95,505,600
18/05/2021,610,3,168,758,926
18/05/2021,697,3,54,129,183
18/05/2021,733,3,40,157,197
18/05/2021,97,3,137,440,577
18/05/2021,355,3,41,170,211
18/05/2021,80,3,26,121,147
18/05/2021,177,3,36,135,171
18/05/2021,366,3,51,111,162
18/05/2021,429,3,77,316,393
18/05/2021,108,3,38,134,172
18/05/2021,588,3,88,236,324
18/05/2021,33,3,53,177,230
18/05/2021,120,3,82,307,389
18/05/2021,860,3,53,209,262
18/05/2021,480,3,43,110,153
18/05/2021,274,3,0,22,22
18/05/2021,623,3,97,305,402
18/05/2021,854,3,141,588,729
18/05/2021,392,3,44,187,231
18/05/2021,232,3,82,226,308
18/05/2021,767,3,157,544,701
18/05/2021,885,3,1,55,56
18/05/2021,250,3,99,201,300
18/05/2021,398,3,7,30,37
18/05/2021,378,3,35,238,273
18/05/2021,586,3,77,359,436
18/05/2021,883,3,3,47,50
18/05/2021,858,3,140,470,610
18/05/2021,69,3,97,273,370
18/05/2021,492,3,30,99,129
18/05/2021,795,3,88,287,375
18/05/2021,613,3,18,112,130
18/05/2021,477,3,48,160,208
18/05/2021,406,3,117,389,506
18/05/2021,537,3,137,385,522
18/05/2021,702,3,59,228,287
18/05/2021,504,3,23,93,116
18/05/2021,558,3,57,159,216
18/05/2021,93,3,75,333,408
18/05/2021,175,3,59,207,266
18/05/2021,889,3,1,10,11
18/05/2021,903,3,1,1,2
18/05/2021,302,3,71,444,515
18/05/2021,693,3,51,145,196
18/05/2021,536,3,52,117,169
18/05/2021,367,3,75,394,469
18/05/2021,727,3,48,186,234
18/05/2021,387,3,72,185,257
18/05/2021,908,3,30,231,261
18/05/2021,926,3,11,43,54
18/05/2021,914,3,2,5,7
18/05/2021,671,3,51,244,295
18/05/2021,775,3,45,177,222
18/05/2021,722,3,25,143,168
18/05/2021,41,3,51,248,299
18/05/2021,793,3,71,304,375
18/05/2021,449,3,53,240,293
18/05/2021,928,3,0,3,3
18/05/2021,602,3,184,617,801
18/05/2021,759,3,42,128,170
18/05/2021,242,3,102,522,624
18/05/2021,154,3,77,295,372
18/05/2021,879,3,1,23,24
18/05/2021,704,3,24,89,113
18/05/2021,488,3,83,226,309
18/05/2021,18,3,77,278,355
18/05/2021,47,3,64,214,278
18/05/2021,751,3,0,7,7
18/05/2021,826,3,105,444,549
18/05/2021,221,3,66,180,246
18/05/2021,236,3,40,174,214
18/05/2021,765,3,83,282,365
18/05/2021,246,3,105,581,686
18/05/2021,533,3,85,240,325
18/05/2021,435,3,38,146,184
18/05/2021,749,3,38,200,238
18/05/2021,737,3,36,116,152
18/05/2021,374,3,39,161,200
18/05/2021,631,3,17,73,90
18/05/2021,205,3,51,212,263
18/05/2021,91,3,67,235,302
18/05/2021,572,3,80,257,337
18/05/2021,625,3,47,163,210
18/05/2021,87,3,148,532,680
18/05/2021,289,3,42,152,194
18/05/2021,124,3,63,180,243
18/05/2021,842,3,11,22,33
18/05/2021,185,3,49,181,230
18/05/2021,144,3,66,277,343
18/05/2021,61,3,46,297,343
18/05/2021,604,3,134,449,583
18/05/2021,30,3,121,303,424
18/05/2021,850,3,184,630,814
18/05/2021,328,3,79,258,337
18/05/2021,261,3,358,1222,1580
18/05/2021,454,3,75,284,359
18/05/2021,82,3,109,345,454
18/05/2021,910,3,1,49,50
18/05/2021,843,3,35,139,174
18/05/2021,359,3,96,336,432
18/05/2021,892,3,2,9,11
18/05/2021,495,3,31,119,150
18/05/2021,288,3,29,71,100
18/05/2021,277,3,76,240,316
18/05/2021,314,3,26,102,128
18/05/2021,434,3,14,25,39
18/05/2021,257,3,292,1001,1293
18/05/2021,709,3,163,430,593
18/05/2021,837,3,73,287,360
18/05/2021,32,3,63,194,257
18/05/2021,103,3,153,457,610
18/05/2021,505,3,28,94,122
18/05/2021,835,3,112,350,462
18/05/2021,831,3,72,285,357
18/05/2021,855,3,78,339,417
18/05/2021,389,3,124,498,622
18/05/2021,121,3,282,929,1211
18/05/2021,176,3,93,298,391
18/05/2021,882,3,0,17,17
18/05/2021,296,3,41,97,138
18/05/2021,401,3,33,117,150
18/05/2021,450,3,63,225,288
18/05/2021,784,3,231,962,1193
18/05/2021,66,3,43,288,331
18/05/2021,491,3,86,478,564
18/05/2021,182,3,57,189,246
18/05/2021,416,3,39,117,156
18/05/2021,790,3,71,270,341
18/05/2021,267,3,54,214,268
18/05/2021,522,3,62,149,211
18/05/2021,239,3,61,254,315
18/05/2021,666,3,102,302,404
18/05/2021,446,3,40,217,257
18/05/2021,707,3,145,341,486
18/05/2021,920,3,0,1,1
18/05/2021,281,3,61,213,274
18/05/2021,117,3,152,359,511
18/05/2021,493,3,46,148,194
18/05/2021,304,3,113,349,462
18/05/2021,210,3,42,154,196
18/05/2021,212,3,68,342,410
18/05/2021,411,3,108,627,735
18/05/2021,78,3,286,1009,1295
18/05/2021,330,3,54,286,340
18/05/2021,338,3,78,344,422
18/05/2021,807,3,53,196,249
18/05/2021,902,3,91,255,346
18/05/2021,463,3,166,644,810
18/05/2021,655,3,103,361,464
18/05/2021,692,3,95,283,378
18/05/2021,877,3,1,14,15
18/05/2021,140,3,38,191,229
18/05/2021,457,3,39,141,180
18/05/2021,635,3,64,321,385
18/05/2021,840,3,39,227,266
18/05/2021,663,3,82,255,337
18/05/2021,453,3,69,298,367
18/05/2021,25,3,86,272,358
18/05/2021,507,3,95,509,604
18/05/2021,46,3,59,189,248
18/05/2021,687,3,110,342,452
18/05/2021,608,3,218,949,1167
18/05/2021,245,3,27,131,158
18/05/2021,119,3,68,203,271
18/05/2021,145,3,74,281,355
18/05/2021,444,3,77,255,332
18/05/2021,353,3,29,108,137
18/05/2021,809,3,47,155,202
18/05/2021,904,3,82,263,345
18/05/2021,231,3,61,228,289
18/05/2021,792,3,108,271,379
18/05/2021,442,3,59,192,251
18/05/2021,200,3,38,151,189
18/05/2021,591,3,86,233,319
18/05/2021,652,3,17,76,93
18/05/2021,677,3,45,149,194
18/05/2021,448,3,180,703,883
18/05/2021,555,3,171,505,676
18/05/2021,133,3,24,75,99
18/05/2021,581,3,102,305,407
18/05/2021,922,3,0,4,4
18/05/2021,755,3,97,476,573
18/05/2021,183,3,45,141,186
18/05/2021,848,3,63,200,263
18/05/2021,475,3,147,432,579
18/05/2021,106,3,132,436,568
18/05/2021,865,3,23,62,85
18/05/2021,228,3,38,127,165
18/05/2021,451,3,163,620,783
18/05/2021,932,3,1,4,5
18/05/2021,262,3,35,80,115
18/05/2021,917,3,2,21,23
18/05/2021,519,3,74,281,355
18/05/2021,617,3,50,178,228
18/05/2021,193,3,83,269,352
18/05/2021,594,3,151,545,696
18/05/2021,284,3,34,82,116
18/05/2021,734,3,46,111,157
18/05/2021,799,3,23,61,84
18/05/2021,118,3,71,206,277
18/05/2021,234,3,27,91,118
18/05/2021,873,3,117,345,462
18/05/2021,49,3,24,76,100
18/05/2021,6,3,30,153,183
18/05/2021,521,3,34,128,162
18/05/2021,539,3,123,359,482
18/05/2021,787,3,299,1207,1506
18/05/2021,230,3,67,198,265
18/05/2021,925,3,0,1,1
18/05/2021,923,3,0,1,1
18/05/2021,325,3,37,219,256
18/05/2021,938,3,0,2,2
18/05/2021,364,3,109,241,350
18/05/2021,258,3,320,1149,1469
18/05/2021,329,3,208,720,928
18/05/2021,808,3,156,493,649
18/05/2021,814,3,58,170,228
18/05/2021,313,3,28,101,129
18/05/2021,301,3,92,429,521
18/05/2021,98,3,127,470,597
18/05/2021,891,3,65,225,290
18/05/2021,319,3,19,107,126
18/05/2021,856,3,116,391,507
18/05/2021,508,3,84,376,460
18/05/2021,55,3,29,141,170
18/05/2021,550,3,132,380,512
18/05/2021,911,3,54,377,431
18/05/2021,181,3,62,165,227
18/05/2021,299,3,24,120,144
18/05/2021,698,3,54,132,186
18/05/2021,337,3,30,110,140
18/05/2021,724,3,280,954,1234
18/05/2021,716,3,38,176,214
18/05/2021,913,3,5,14,19
18/05/2021,844,3,46,140,186
18/05/2021,459,3,88,306,394
18/05/2021,829,3,82,451,533
18/05/2021,409,3,24,53,77
18/05/2021,424,3,85,469,554
18/05/2021,638,3,114,321,435
18/05/2021,780,3,163,567,730
18/05/2021,866,3,152,475,627
18/05/2021,711,3,41,172,213
18/05/2021,705,3,17,72,89
18/05/2021,11,3,55,218,273
18/05/2021,170,3,55,299,354
18/05/2021,70,3,120,568,688
18/05/2021,614,3,42,157,199
18/05/2021,717,3,46,198,244
18/05/2021,365,3,48,123,171
18/05/2021,689,3,110,292,402
18/05/2021,342,3,47,253,300
18/05/2021,151,3,39,154,193
18/05/2021,243,3,113,586,699
18/05/2021,131,3,59,206,265
18/05/2021,190,3,107,290,397
18/05/2021,620,3,0,1,1
18/05/2021,817,3,104,331,435
18/05/2021,271,3,53,195,248
18/05/2021,593,3,228,803,1031
18/05/2021,420,3,164,379,543
18/05/2021,526,3,38,141,179
18/05/2021,184,3,45,163,208
18/05/2021,259,3,217,714,931
18/05/2021,778,3,118,372,490
18/05/2021,255,3,8,11,19
18/05/2021,939,3,0,3,3
18/05/2021,410,3,70,439,509
18/05/2021,2,3,30,156,186
18/05/2021,339,3,82,312,394
18/05/2021,818,3,80,291,371
18/05/2021,830,3,317,1046,1363
18/05/2021,791,3,58,273,331
18/05/2021,158,3,39,159,198
18/05/2021,757,3,122,368,490
18/05/2021,486,3,77,295,372
18/05/2021,732,3,29,118,147
18/05/2021,490,3,30,89,119
18/05/2021,820,3,49,214,263
18/05/2021,531,3,81,315,396
18/05/2021,96,3,59,124,183
18/05/2021,327,3,194,685,879
18/05/2021,386,3,197,851,1048
18/05/2021,203,3,68,250,318
18/05/2021,53,3,94,274,368
18/05/2021,643,3,71,283,354
18/05/2021,256,3,100,285,385
18/05/2021,441,3,154,589,743
18/05/2021,921,3,0,6,6
18/05/2021,886,3,1,9,10
18/05/2021,805,3,45,181,226
18/05/2021,76,3,141,630,771
18/05/2021,206,3,2,7,9
18/05/2021,84,3,194,685,879
18/05/2021,220,3,66,183,249
18/05/2021,699,3,44,176,220
18/05/2021,626,3,36,178,214
18/05/2021,180,3,50,170,220
18/05/2021,750,3,75,379,454
18/05/2021,285,3,44,144,188
18/05/2021,857,3,53,175,228
18/05/2021,294,3,125,327,452
18/05/2021,385,3,58,247,305
18/05/2021,432,3,57,256,313
18/05/2021,34,3,47,169,216
18/05/2021,143,3,115,489,604
18/05/2021,876,3,0,3,3
18/05/2021,44,3,113,410,523
18/05/2021,577,3,46,296,342
18/05/2021,719,3,39,153,192
18/05/2021,874,3,65,250,315
18/05/2021,532,3,337,1212,1549
18/05/2021,595,3,45,140,185
18/05/2021,815,3,226,837,1063
18/05/2021,520,3,55,202,257
18/05/2021,64,3,28,142,170
18/05/2021,101,3,66,165,231
18/05/2021,19,3,110,383,493
18/05/2021,460,3,46,198,244
18/05/2021,172,3,60,311,371
18/05/2021,485,3,68,222,290
18/05/2021,803,3,82,222,304
18/05/2021,723,3,73,256,329
18/05/2021,890,3,41,192,233
18/05/2021,868,3,225,773,998
18/05/2021,334,3,148,486,634
18/05/2021,738,3,84,227,311
18/05/2021,88,3,77,225,302
18/05/2021,99,3,185,652,837
18/05/2021,466,3,65,238,303
18/05/2021,646,3,56,228,284
18/05/2021,774,3,47,222,269
18/05/2021,298,3,93,563,656
18/05/2021,798,3,138,402,540
18/05/2021,105,3,99,281,380
18/05/2021,166,3,25,197,222
18/05/2021,157,3,64,272,336
18/05/2021,123,3,69,203,272
18/05/2021,585,3,145,442,587
18/05/2021,497,3,83,477,560
18/05/2021,196,3,49,163,212
18/05/2021,125,3,64,219,283
18/05/2021,7,3,31,153,184
18/05/2021,187,3,37,102,139
18/05/2021,785,3,274,1089,1363
18/05/2021,286,3,27,85,112
18/05/2021,189,3,44,152,196
18/05/2021,28,3,45,147,192
18/05/2021,276,3,57,197,254
18/05/2021,895,3,56,195,251
18/05/2021,897,3,23,77,100
18/05/2021,777,3,90,251,341
18/05/2021,696,3,76,266,342
18/05/2021,238,3,97,496,593
18/05/2021,400,3,27,101,128
18/05/2021,380,3,70,306,376
18/05/2021,570,3,60,213,273
18/05/2021,305,3,72,313,385
18/05/2021,423,3,78,437,515
18/05/2021,473,3,43,178,221
18/05/2021,95,3,160,483,643
18/05/2021,802,3,165,746,911
18/05/2021,244,3,41,192,233
18/05/2021,309,3,21,94,115
18/05/2021,161,3,196,686,882
18/05/2021,59,3,39,175,214
18/05/2021,443,3,48,250,298
18/05/2021,195,3,37,93,130
18/05/2021,37,3,46,146,192
18/05/2021,863,3,75,212,287
18/05/2021,658,3,39,199,238
18/05/2021,675,3,51,189,240
18/05/2021,418,3,28,41,69
18/05/2021,60,3,17,67,84
18/05/2021,383,3,192,706,898
18/05/2021,681,3,89,312,401
18/05/2021,900,3,13,10,23
18/05/2021,924,3,0,3,3
18/05/2021,752,3,155,466,621
18/05/2021,632,3,14,84,98
18/05/2021,918,3,1,9,10
18/05/2021,534,3,54,191,245
18/05/2021,235,3,45,273,318
18/05/2021,56,3,55,363,418
18/05/2021,399,3,164,527,691
18/05/2021,654,3,54,203,257
18/05/2021,269,3,49,175,224
18/05/2021,436,3,42,225,267
18/05/2021,251,3,28,182,210
18/05/2021,350,3,49,186,235
18/05/2021,162,3,199,686,885
18/05/2021,683,3,50,234,284
18/05/2021,512,3,25,86,111
18/05/2021,253,3,33,128,161
18/05/2021,393,3,24,159,183
18/05/2021,825,3,100,348,448
18/05/2021,247,3,78,328,406
18/05/2021,192,3,42,115,157
18/05/2021,186,3,36,92,128
18/05/2021,462,3,55,256,311
18/05/2021,474,3,35,168,203
18/05/2021,15,3,119,380,499
18/05/2021,597,3,39,184,223
18/05/2021,470,3,65,323,388
18/05/2021,379,3,61,292,353
18/05/2021,849,3,47,316,363
18/05/2021,23,3,16,68,84
18/05/2021,573,3,67,233,300
18/05/2021,896,3,329,1081,1410
18/05/2021,50,3,26,76,102
18/05/2021,553,3,45,55,100
18/05/2021,847,3,3,28,31
18/05/2021,801,3,78,253,331
18/05/2021,819,3,98,269,367
18/05/2021,746,3,39,245,284
18/05/2021,524,3,124,347,471
18/05/2021,736,3,34,97,131
18/05/2021,159,3,78,398,476
18/05/2021,168,3,41,191,232
18/05/2021,547,3,324,1063,1387
18/05/2021,149,3,71,260,331
18/05/2021,811,3,29,154,183
18/05/2021,794,3,169,596,765
18/05/2021,456,3,69,250,319
18/05/2021,673,3,58,286,344
18/05/2021,937,3,0,1,1
18/05/2021,721,3,341,1268,1609
18/05/2021,27,3,168,383,551
18/05/2021,561,3,50,135,185
18/05/2021,931,3,0,6,6
18/05/2021,229,3,130,368,498
18/05/2021,770,3,171,578,749
18/05/2021,164,3,41,244,285
18/05/2021,713,3,65,518,583
18/05/2021,587,3,10,57,67
18/05/2021,567,3,83,270,353
18/05/2021,90,3,38,145,183
18/05/2021,648,3,51,193,244
18/05/2021,864,3,38,154,192
18/05/2021,361,3,109,239,348
18/05/2021,413,3,93,548,641
18/05/2021,776,3,62,257,319
18/05/2021,153,3,75,311,386
18/05/2021,332,3,57,218,275
18/05/2021,888,3,2,22,24
18/05/2021,287,3,104,570,674
18/05/2021,571,3,67,214,281
18/05/2021,42,3,51,187,238
18/05/2021,589,3,78,223,301
18/05/2021,147,3,70,273,343
18/05/2021,607,3,197,900,1097
18/05/2021,198,3,109,308,417
18/05/2021,17,3,25,144,169
18/05/2021,872,3,69,165,234
18/05/2021,575,3,24,105,129
18/05/2021,538,3,98,293,391
18/05/2021,650,3,79,330,409
18/05/2021,839,3,64,216,280
18/05/2021,563,3,69,210,279
18/05/2021,113,3,31,104,135
18/05/2021,569,3,79,263,342
18/05/2021,551,3,131,423,554
18/05/2021,758,3,83,300,383
18/05/2021,373,3,88,240,328
18/05/2021,430,3,65,238,303
18/05/2021,137,3,56,210,266
18/05/2021,827,3,176,400,576
18/05/2021,346,3,40,169,209
18/05/2021,160,3,7,25,32
18/05/2021,483,3,79,285,364
18/05/2021,618,3,71,272,343
18/05/2021,208,3,25,123,148
18/05/2021,664,3,111,368,479
18/05/2021,225,3,81,245,326
18/05/2021,31,3,56,230,286
18/05/2021,845,3,62,210,272
18/05/2021,363,3,121,239,360
18/05/2021,725,3,67,239,306
18/05/2021,21,3,87,314,401
18/05/2021,880,3,0,19,19
18/05/2021,214,3,68,306,374
18/05/2021,323,3,44,156,200
18/05/2021,633,3,32,132,164
18/05/2021,77,3,144,611,755
18/05/2021,564,3,113,335,448
18/05/2021,75,3,149,664,813
18/05/2021,887,3,1,14,15
18/05/2021,544,3,118,272,390
18/05/2021,556,3,198,582,780
18/05/2021,384,3,111,309,420
18/05/2021,619,3,56,168,224
18/05/2021,215,3,33,171,204
18/05/2021,219,3,41,188,229
18/05/2021,349,3,25,173,198
18/05/2021,469,3,49,182,231
18/05/2021,421,3,131,241,372
18/05/2021,24,3,17,65,82
18/05/2021,260,3,358,1247,1605
18/05/2021,580,3,53,233,286
18/05/2021,680,3,41,133,174
18/05/2021,694,3,58,210,268
18/05/2021,461,3,75,261,336
18/05/2021,517,3,41,171,212
18/05/2021,661,3,120,374,494
18/05/2021,578,3,19,75,94
18/05/2021,425,3,65,296,361
18/05/2021,651,3,60,216,276
18/05/2021,478,3,69,208,277
18/05/2021,237,3,95,502,597
18/05/2021,786,3,140,603,743
18/05/2021,735,3,38,124,162
18/05/2021,306,3,0,2,2
18/05/2021,279,3,64,224,288
18/05/2021,788,3,296,1207,1503
18/05/2021,318,3,134,390,524
18/05/2021,155,3,92,422,514
18/05/2021,565,3,190,570,760
18/05/2021,528,3,42,152,194
18/05/2021,178,3,100,293,393
18/05/2021,54,3,70,197,267
18/05/2021,628,3,70,188,258
18/05/2021,458,3,79,274,353
18/05/2021,489,3,8,29,37
18/05/2021,100,3,187,662,849
18/05/2021,278,3,51,159,210
18/05/2021,370,3,70,375,445
18/05/2021,710,3,44,187,231
18/05/2021,615,3,80,305,385
18/05/2021,89,3,109,435,544
18/05/2021,745,3,41,247,288
18/05/2021,852,3,133,278,411
18/05/2021,753,3,87,332,419
18/05/2021,71,3,56,250,306
18/05/2021,122,3,84,298,382
18/05/2021,171,3,19,25,44
18/05/2021,700,3,53,130,183
18/05/2021,391,3,136,480,616
18/05/2021,111,3,133,438,571
18/05/2021,514,3,29,77,106
18/05/2021,823,3,68,174,242
18/05/2021,371,3,68,251,319
18/05/2021,1,3,30,155,185
18/05/2021,701,3,49,196,245
18/05/2021,265,3,37,108,145
18/05/2021,878,3,1,14,15
18/05/2021,660,3,42,159,201
18/05/2021,768,3,73,352,425
18/05/2021,348,3,36,160,196
18/05/2021,851,3,68,270,338
18/05/2021,540,3,150,439,589
18/05/2021,670,3,357,1202,1559
18/05/2021,48,3,23,79,102
18/05/2021,312,3,65,208,273
18/05/2021,300,3,78,483,561
18/05/2021,249,3,115,598,713
18/05/2021,557,3,61,180,241
18/05/2021,898,3,53,128,181
18/05/2021,853,3,53,174,227
18/05/2021,833,3,27,126,153
18/05/2021,397,3,22,142,164
18/05/2021,439,3,42,185,227
18/05/2021,110,3,39,142,181
18/05/2021,506,3,94,500,594
18/05/2021,728,3,64,322,386
18/05/2021,584,3,248,889,1137
18/05/2021,686,3,37,205,242
18/05/2021,136,3,103,345,448
18/05/2021,647,3,59,211,270
18/05/2021,484,3,72,206,278
18/05/2021,832,3,60,245,305
18/05/2021,598,3,231,929,1160
18/05/2021,838,3,43,170,213
18/05/2021,404,3,200,673,873
18/05/2021,431,3,60,210,270
18/05/2021,362,3,114,244,358
18/05/2021,574,3,81,258,339
18/05/2021,714,3,91,307,398
18/05/2021,352,3,87,297,384
18/05/2021,905,3,0,2,2
18/05/2021,201,3,49,183,232
18/05/2021,358,3,213,831,1044
18/05/2021,828,3,114,244,358
18/05/2021,156,3,76,300,376
18/05/2021,455,3,30,143,173
18/05/2021,641,3,54,219,273
18/05/2021,562,3,36,68,104
18/05/2021,343,3,38,213,251
18/05/2021,414,3,114,618,732
18/05/2021,179,3,64,217,281
18/05/2021,494,3,49,186,235
18/05/2021,445,3,62,279,341
18/05/2021,741,3,37,128,165
18/05/2021,653,3,15,79,94
18/05/2021,621,3,46,152,198
18/05/2021,503,3,82,391,473
18/05/2021,377,3,102,276,378
18/05/2021,405,3,23,71,94
18/05/2021,395,3,34,171,205
18/05/2021,599,3,239,969,1208
18/05/2021,640,3,51,194,245
18/05/2021,605,3,141,485,626
18/05/2021,468,3,34,209,243
18/05/2021,36,3,49,218,267
18/05/2021,13,3,54,190,244
18/05/2021,273,3,68,322,390
18/05/2021,336,3,241,797,1038
18/05/2021,283,3,59,203,262
18/05/2021,408,3,114,636,750
18/05/2021,934,3,0,18,18
18/05/2021,83,3,280,1058,1338
18/05/2021,104,3,92,288,380
18/05/2021,248,3,41,104,145
18/05/2021,901,3,4,12,16
18/05/2021,112,3,49,165,214
18/05/2021,479,3,38,112,150
18/05/2021,264,3,36,69,105
18/05/2021,688,3,59,209,268
18/05/2021,272,3,87,308,395
18/05/2021,402,3,112,337,449
18/05/2021,535,3,55,186,241
18/05/2021,899,3,128,528,656
18/05/2021,804,3,100,535,635
18/05/2021,297,3,66,369,435
18/05/2021,720,3,36,177,213
18/05/2021,548,3,53,171,224
18/05/2021,315,3,10,90,100
18/05/2021,649,3,58,143,201
18/05/2021,726,3,63,218,281
18/05/2021,169,3,53,260,313
18/05/2021,871,3,117,378,495
18/05/2021,747,3,64,201,265
18/05/2021,846,3,3,31,34
18/05/2021,360,3,48,257,305
18/05/2021,311,3,67,267,334
18/05/2021,500,3,25,56,81
18/05/2021,356,3,169,658,827
18/05/2021,783,3,111,565,676
18/05/2021,43,3,63,270,333
18/05/2021,566,3,46,153,199
18/05/2021,333,3,57,417,474
18/05/2021,907,3,158,496,654
18/05/2021,465,3,36,223,259
18/05/2021,712,3,40,183,223
18/05/2021,824,3,165,597,762
18/05/2021,637,3,132,580,712
18/05/2021,217,3,62,288,350
18/05/2021,797,3,111,311,422
18/05/2021,114,3,89,274,363
18/05/2021,293,3,49,338,387
18/05/2021,280,3,33,61,94
18/05/2021,79,3,60,220,280
18/05/2021,4,3,45,174,219
18/05/2021,498,3,35,116,151
18/05/2021,67,3,47,265,312
18/05/2021,211,3,69,304,373
18/05/2021,57,3,47,320,367
18/05/2021,152,3,62,256,318
18/05/2021,560,3,178,518,696
18/05/2021,806,3,124,509,633
18/05/2021,226,3,83,254,337
18/05/2021,915,3,0,27,27
18/05/2021,669,3,43,197,240
18/05/2021,437,3,64,288,352
18/05/2021,368,3,87,393,480
18/05/2021,657,3,109,360,469
18/05/2021,525,3,126,417,543
18/05/2021,81,3,17,113,130
18/05/2021,351,3,219,747,966
18/05/2021,388,3,125,512,637
18/05/2021,291,3,69,450,519
18/05/2021,771,3,64,309,373
18/05/2021,606,3,77,335,412
18/05/2021,773,3,36,185,221
18/05/2021,552,3,149,416,565
18/05/2021,331,3,75,217,292
18/05/2021,645,3,53,204,257
18/05/2021,116,3,42,182,224
18/05/2021,317,3,156,461,617
18/05/2021,812,3,54,242,296
18/05/2021,576,3,11,53,64
18/05/2021,26,3,88,292,380
18/05/2021,63,3,34,140,174
18/05/2021,240,3,97,507,604
18/05/2021,148,3,50,192,242
18/05/2021,345,3,77,193,270
18/05/2021,146,3,127,493,620
18/05/2021,513,3,36,118,154
18/05/2021,810,3,56,229,285
18/05/2021,730,3,39,183,222
18/05/2021,471,3,52,223,275
18/05/2021,8,3,56,125,181
18/05/2021,268,3,107,376,483
18/05/2021,546,3,154,453,607
18/05/2021,682,3,18,115,133
18/05/2021,800,3,79,280,359
18/05/2021,22,3,70,276,346
18/05/2021,447,3,46,140,186
18/05/2021,761,3,33,119,152
18/05/2021,303,3,68,329,397
18/05/2021,135,3,111,373,484
18/05/2021,662,3,118,428,546
18/05/2021,129,3,70,224,294
18/05/2021,933,3,0,1,1
18/05/2021,756,3,99,506,605
18/05/2021,884,3,1,47,48
18/05/2021,616,3,114,334,448
18/05/2021,68,3,50,337,387
18/05/2021,428,3,37,166,203
18/05/2021,542,3,97,339,436
18/05/2021,9,3,77,167,244
18/05/2021,115,3,29,135,164
18/05/2021,344,3,70,261,331
18/05/2021,216,3,51,240,291
18/05/2021,369,3,154,524,678
18/05/2021,624,3,22,100,122
18/05/2021,233,3,97,360,457
18/05/2021,703,3,41,167,208
18/05/2021,263,3,50,160,210
18/05/2021,841,3,5,71,76
18/05/2021,381,3,2,3,5
18/05/2021,86,3,39,130,169
18/05/2021,487,3,50,196,246
18/05/2021,634,3,62,306,368
18/05/2021,731,3,47,155,202
18/05/2021,748,3,49,127,176
18/05/2021,440,3,66,316,382
18/05/2021,685,3,59,205,264
18/05/2021,511,3,22,159,181
18/05/2021,583,3,26,158,184
18/05/2021,676,3,43,115,158
18/05/2021,347,3,191,623,814
18/05/2021,867,3,62,160,222
18/05/2021,254,3,36,128,164
18/05/2021,629,3,57,225,282
18/05/2021,789,3,100,273,373
18/05/2021,396,3,30,136,166
18/05/2021,869,3,102,237,339
18/05/2021,515,3,37,97,134
18/05/2021,779,3,65,198,263
18/05/2021,65,3,43,323,366
18/05/2021,224,3,42,136,178
18/05/2021,592,3,102,333,435
18/05/2021,419,3,123,382,505
18/05/2021,207,3,32,167,199
18/05/2021,20,3,73,113,186
18/05/2021,282,3,54,178,232
18/05/2021,781,3,96,488,584
18/05/2021,335,3,65,251,316
18/05/2021,130,3,129,403,532
18/05/2021,529,3,72,235,307
18/05/2021,12,3,25,75,100
18/05/2021,433,3,175,631,806
18/05/2021,816,3,175,590,765
18/05/2021,209,3,12,118,130
18/05/2021,467,3,57,246,303
18/05/2021,881,3,0,7,7
18/05/2021,142,3,51,106,157
18/05/2021,167,3,105,331,436
18/05/2021,739,3,38,132,170
18/05/2021,173,3,69,190,259
18/05/2021,862,3,97,347,444
18/05/2021,394,3,40,180,220
18/05/2021,527,3,57,195,252
18/05/2021,496,3,28,91,119
18/05/2021,390,3,135,533,668
18/05/2021,861,3,114,323,437
18/05/2021,52,3,103,308,411
18/05/2021,742,3,67,199,266
18/05/2021,691,3,50,200,250
18/05/2021,452,3,64,249,313
18/05/2021,612,3,171,717,888
18/05/2021,481,3,68,223,291
18/05/2021,772,3,123,388,511
18/05/2021,127,3,53,179,232
18/05/2021,326,3,35,104,139
18/05/2021,426,3,37,148,185
18/05/2021,222,3,61,169,230
18/05/2021,275,3,76,307,383
18/05/2021,227,3,43,139,182
18/05/2021,310,3,227,916,1143
18/05/2021,906,3,11,18,29
18/05/2021,58,3,94,525,619
18/05/2021,579,3,38,143,181
18/05/2021,322,3,77,256,333
18/05/2021,308,3,67,287,354
18/05/2021,403,3,112,348,460
18/05/2021,438,3,43,152,195
18/05/2021,603,3,130,456,586
18/05/2021,218,3,67,304,371
18/05/2021,509,3,74,359,433
18/05/2021,764,3,21,87,108
18/05/2021,715,3,140,399,539
18/05/2021,472,3,189,661,850
18/05/2021,559,3,186,543,729
18/05/2021,821,3,101,336,437
18/05/2021,476,3,49,184,233
18/05/2021,357,3,178,683,861
18/05/2021,174,3,47,164,211
18/05/2021,407,3,72,429,501
18/05/2021,38,3,65,257,322
18/05/2021,107,3,186,651,837
18/05/2021,530,3,58,156,214
18/05/2021,916,3,1,0,1
18/05/2021,316,3,52,244,296
18/05/2021,5,3,30,155,185
18/05/2021,290,3,75,484,559
18/05/2021,679,3,48,170,218
18/05/2021,668,3,30,126,156
18/05/2021,659,3,38,189,227
18/05/2021,307,3,99,368,467
18/05/2021,372,3,166,529,695
18/05/2021,919,3,105,326,431
18/05/2021,639,3,50,199,249
18/05/2021,554,3,56,229,285
18/05/2021,295,3,25,166,191
18/05/2021,627,3,37,150,187
18/05/2021,376,3,16,66,82
18/05/2021,674,3,41,194,235
18/05/2021,35,3,73,293,366
18/05/2021,197,3,50,204,254
18/05/2021,85,3,254,874,1128
18/05/2021,270,3,32,165,197
18/05/2021,665,3,48,216,264
18/05/2021,134,3,102,334,436
18/05/2021,199,3,34,132,166
18/05/2021,706,3,167,446,613
18/05/2021,126,3,94,370,464
18/05/2021,45,3,43,167,210
18/05/2021,543,3,311,1031,1342
18/05/2021,743,3,30,201,231
18/05/2021,412,3,17,146,163
18/05/2021,341,3,255,862,1117
18/05/2021,102,3,146,449,595
18/05/2021,930,3,1,9,10
18/05/2021,582,3,276,1033,1309
18/05/2021,510,3,80,468,548
18/05/2021,39,3,60,278,338
18/05/2021,518,3,28,129,157
18/05/2021,622,3,160,377,537
18/05/2021,760,3,69,338,407
18/05/2021,72,3,154,667,821
18/05/2021,202,3,101,490,591
18/05/2021,92,3,57,231,288
18/05/2021,204,3,62,231,293
18/05/2021,464,3,62,287,349
18/05/2021,292,3,95,521,616
18/05/2021,813,3,56,203,259
18/05/2021,3,3,33,156,189
18/05/2021,782,3,95,372,467
18/05/2021,422,3,61,156,217
18/05/2021,642,3,56,222,278
18/05/2021,139,3,63,185,248
18/05/2021,754,3,60,370,430
19/05/2021,813,3,62,228,290
19/05/2021,464,3,63,312,375
19/05/2021,518,3,17,70,87
19/05/2021,72,3,156,704,860
19/05/2021,622,3,162,431,593
19/05/2021,204,3,57,250,307
19/05/2021,202,3,117,537,654
19/05/2021,92,3,63,245,308
19/05/2021,292,3,106,534,640
19/05/2021,642,3,67,269,336
19/05/2021,139,3,65,222,287
19/05/2021,754,3,56,404,460
19/05/2021,3,3,32,158,190
19/05/2021,422,3,67,163,230
19/05/2021,760,3,74,351,425
19/05/2021,782,3,114,424,538
19/05/2021,721,3,352,1226,1578
19/05/2021,567,3,92,271,363
19/05/2021,770,3,186,626,812
19/05/2021,811,3,34,173,207
19/05/2021,229,3,135,384,519
19/05/2021,168,3,45,199,244
19/05/2021,524,3,115,359,474
19/05/2021,456,3,58,266,324
19/05/2021,149,3,84,291,375
19/05/2021,159,3,80,406,486
19/05/2021,90,3,33,137,170
19/05/2021,547,3,308,1128,1436
19/05/2021,587,3,9,54,63
19/05/2021,164,3,46,266,312
19/05/2021,746,3,46,223,269
19/05/2021,713,3,63,555,618
19/05/2021,736,3,23,86,109
19/05/2021,931,3,0,2,2
19/05/2021,27,3,172,424,596
19/05/2021,794,3,166,589,755
19/05/2021,937,3,0,1,1
19/05/2021,561,3,49,172,221
19/05/2021,673,3,57,282,339
19/05/2021,442,3,53,200,253
19/05/2021,792,3,106,288,394
19/05/2021,809,3,52,155,207
19/05/2021,133,3,19,79,98
19/05/2021,687,3,102,341,443
19/05/2021,200,3,32,144,176
19/05/2021,608,3,232,1002,1234
19/05/2021,25,3,79,310,389
19/05/2021,555,3,189,522,711
19/05/2021,591,3,90,230,320
19/05/2021,245,3,29,118,147
19/05/2021,677,3,35,127,162
19/05/2021,119,3,70,225,295
19/05/2021,353,3,28,100,128
19/05/2021,444,3,68,300,368
19/05/2021,581,3,113,350,463
19/05/2021,46,3,60,193,253
19/05/2021,448,3,180,723,903
19/05/2021,507,3,94,529,623
19/05/2021,652,3,24,87,111
19/05/2021,904,3,78,283,361
19/05/2021,231,3,76,279,355
19/05/2021,922,3,0,3,3
19/05/2021,145,3,92,318,410
19/05/2021,826,3,110,478,588
19/05/2021,759,3,32,115,147
19/05/2021,236,3,44,166,210
19/05/2021,765,3,76,342,418
19/05/2021,154,3,97,336,433
19/05/2021,18,3,72,291,363
19/05/2021,879,3,1,18,19
19/05/2021,488,3,91,221,312
19/05/2021,221,3,69,212,281
19/05/2021,47,3,73,197,270
19/05/2021,242,3,103,523,626
19/05/2021,704,3,32,102,134
19/05/2021,751,3,0,5,5
19/05/2021,232,3,81,222,303
19/05/2021,623,3,111,372,483
19/05/2021,177,3,40,136,176
19/05/2021,429,3,57,339,396
19/05/2021,885,3,1,51,52
19/05/2021,392,3,46,216,262
19/05/2021,480,3,40,136,176
19/05/2021,33,3,58,214,272
19/05/2021,860,3,61,236,297
19/05/2021,108,3,46,140,186
19/05/2021,274,3,2,19,21
19/05/2021,250,3,92,220,312
19/05/2021,767,3,179,606,785
19/05/2021,588,3,89,236,325
19/05/2021,120,3,101,308,409
19/05/2021,366,3,58,121,179
19/05/2021,854,3,144,587,731
19/05/2021,138,3,61,222,283
19/05/2021,321,3,40,158,198
19/05/2021,266,3,31,165,196
19/05/2021,213,3,92,382,474
19/05/2021,163,3,62,230,292
19/05/2021,909,3,1,9,10
19/05/2021,252,3,48,166,214
19/05/2021,354,3,6,9,15
19/05/2021,600,3,240,940,1180
19/05/2021,684,3,92,336,428
19/05/2021,128,3,51,201,252
19/05/2021,836,3,102,485,587
19/05/2021,936,3,16,41,57
19/05/2021,427,3,205,794,999
19/05/2021,875,3,39,167,206
19/05/2021,417,3,119,609,728
19/05/2021,51,3,224,886,1110
19/05/2021,859,3,6,23,29
19/05/2021,697,3,61,159,220
19/05/2021,636,3,40,193,233
19/05/2021,656,3,37,183,220
19/05/2021,499,3,48,201,249
19/05/2021,355,3,38,151,189
19/05/2021,894,3,61,172,233
19/05/2021,601,3,59,151,210
19/05/2021,97,3,143,497,640
19/05/2021,870,3,31,105,136
19/05/2021,733,3,37,157,194
19/05/2021,340,3,80,338,418
19/05/2021,501,3,94,513,607
19/05/2021,80,3,33,130,163
19/05/2021,188,3,100,336,436
19/05/2021,610,3,171,789,960
19/05/2021,793,3,63,338,401
19/05/2021,671,3,57,298,355
19/05/2021,602,3,202,694,896
19/05/2021,928,3,0,3,3
19/05/2021,722,3,29,135,164
19/05/2021,449,3,52,265,317
19/05/2021,41,3,53,253,306
19/05/2021,775,3,41,189,230
19/05/2021,613,3,16,106,122
19/05/2021,398,3,12,31,43
19/05/2021,586,3,86,413,499
19/05/2021,175,3,65,223,288
19/05/2021,537,3,138,374,512
19/05/2021,858,3,151,484,635
19/05/2021,93,3,56,360,416
19/05/2021,558,3,56,195,251
19/05/2021,477,3,54,179,233
19/05/2021,795,3,85,289,374
19/05/2021,406,3,105,389,494
19/05/2021,378,3,45,233,278
19/05/2021,702,3,63,239,302
19/05/2021,504,3,27,110,137
19/05/2021,69,3,92,267,359
19/05/2021,492,3,25,108,133
19/05/2021,889,3,1,10,11
19/05/2021,883,3,1,44,45
19/05/2021,903,3,1,3,4
19/05/2021,387,3,81,207,288
19/05/2021,536,3,51,120,171
19/05/2021,367,3,85,428,513
19/05/2021,727,3,51,188,239
19/05/2021,926,3,14,69,83
19/05/2021,914,3,2,4,6
19/05/2021,693,3,57,179,236
19/05/2021,302,3,74,445,519
19/05/2021,908,3,38,231,269
19/05/2021,463,3,166,646,812
19/05/2021,140,3,36,195,231
19/05/2021,663,3,76,340,416
19/05/2021,692,3,112,328,440
19/05/2021,877,3,1,20,21
19/05/2021,453,3,82,288,370
19/05/2021,457,3,35,142,177
19/05/2021,840,3,31,216,247
19/05/2021,635,3,58,316,374
19/05/2021,655,3,105,436,541
19/05/2021,82,3,115,372,487
19/05/2021,910,3,1,45,46
19/05/2021,495,3,29,141,170
19/05/2021,288,3,33,74,107
19/05/2021,843,3,47,142,189
19/05/2021,892,3,3,7,10
19/05/2021,359,3,113,335,448
19/05/2021,454,3,71,324,395
19/05/2021,261,3,375,1277,1652
19/05/2021,328,3,72,269,341
19/05/2021,533,3,86,263,349
19/05/2021,435,3,36,136,172
19/05/2021,572,3,87,266,353
19/05/2021,246,3,108,565,673
19/05/2021,205,3,43,231,274
19/05/2021,91,3,67,266,333
19/05/2021,87,3,137,537,674
19/05/2021,737,3,29,107,136
19/05/2021,749,3,31,197,228
19/05/2021,625,3,43,224,267
19/05/2021,374,3,45,150,195
19/05/2021,631,3,20,71,91
19/05/2021,604,3,143,474,617
19/05/2021,289,3,49,140,189
19/05/2021,30,3,122,315,437
19/05/2021,842,3,10,20,30
19/05/2021,850,3,199,677,876
19/05/2021,61,3,51,359,410
19/05/2021,124,3,58,214,272
19/05/2021,144,3,77,298,375
19/05/2021,185,3,45,165,210
19/05/2021,493,3,41,177,218
19/05/2021,330,3,49,267,316
19/05/2021,338,3,78,355,433
19/05/2021,902,3,92,253,345
19/05/2021,807,3,58,211,269
19/05/2021,212,3,78,392,470
19/05/2021,117,3,155,382,537
19/05/2021,78,3,263,1054,1317
19/05/2021,411,3,127,639,766
19/05/2021,304,3,130,368,498
19/05/2021,210,3,48,171,219
19/05/2021,837,3,71,324,395
19/05/2021,855,3,89,330,419
19/05/2021,709,3,171,499,670
19/05/2021,257,3,314,987,1301
19/05/2021,835,3,130,358,488
19/05/2021,277,3,75,264,339
19/05/2021,103,3,157,465,622
19/05/2021,831,3,67,297,364
19/05/2021,176,3,101,329,430
19/05/2021,121,3,265,958,1223
19/05/2021,314,3,20,136,156
19/05/2021,32,3,76,225,301
19/05/2021,505,3,23,107,130
19/05/2021,389,3,125,530,655
19/05/2021,434,3,5,31,36
19/05/2021,267,3,47,221,268
19/05/2021,784,3,254,1049,1303
19/05/2021,882,3,1,13,14
19/05/2021,401,3,32,160,192
19/05/2021,416,3,31,113,144
19/05/2021,450,3,62,248,310
19/05/2021,707,3,151,391,542
19/05/2021,66,3,47,335,382
19/05/2021,239,3,61,246,307
19/05/2021,920,3,0,1,1
19/05/2021,666,3,108,320,428
19/05/2021,491,3,87,487,574
19/05/2021,182,3,49,160,209
19/05/2021,790,3,71,297,368
19/05/2021,446,3,32,208,240
19/05/2021,281,3,66,280,346
19/05/2021,522,3,69,162,231
19/05/2021,296,3,45,94,139
19/05/2021,379,3,68,326,394
19/05/2021,849,3,46,351,397
19/05/2021,819,3,95,290,385
19/05/2021,847,3,2,26,28
19/05/2021,573,3,67,237,304
19/05/2021,470,3,57,282,339
19/05/2021,553,3,43,58,101
19/05/2021,23,3,25,74,99
19/05/2021,50,3,21,83,104
19/05/2021,896,3,318,1137,1455
19/05/2021,801,3,67,296,363
19/05/2021,385,3,60,265,325
19/05/2021,180,3,55,242,297
19/05/2021,886,3,2,13,15
19/05/2021,76,3,149,652,801
19/05/2021,699,3,39,183,222
19/05/2021,857,3,56,206,262
19/05/2021,143,3,126,547,673
19/05/2021,206,3,2,7,9
19/05/2021,34,3,44,166,210
19/05/2021,750,3,61,359,420
19/05/2021,432,3,58,287,345
19/05/2021,285,3,37,194,231
19/05/2021,805,3,45,208,253
19/05/2021,84,3,190,641,831
19/05/2021,294,3,112,335,447
19/05/2021,626,3,42,170,212
19/05/2021,220,3,62,195,257
19/05/2021,301,3,93,443,536
19/05/2021,181,3,58,158,216
19/05/2021,814,3,64,153,217
19/05/2021,856,3,131,409,540
19/05/2021,911,3,53,378,431
19/05/2021,891,3,66,220,286
19/05/2021,55,3,28,159,187
19/05/2021,808,3,158,563,721
19/05/2021,508,3,76,381,457
19/05/2021,98,3,130,543,673
19/05/2021,319,3,18,118,136
19/05/2021,459,3,78,321,399
19/05/2021,313,3,20,119,139
19/05/2021,550,3,145,397,542
19/05/2021,329,3,218,804,1022
19/05/2021,724,3,270,1016,1286
19/05/2021,716,3,42,179,221
19/05/2021,913,3,7,18,25
19/05/2021,844,3,39,167,206
19/05/2021,698,3,58,150,208
19/05/2021,337,3,26,102,128
19/05/2021,299,3,32,128,160
19/05/2021,932,3,2,7,9
19/05/2021,617,3,54,196,250
19/05/2021,106,3,120,523,643
19/05/2021,228,3,48,130,178
19/05/2021,451,3,152,558,710
19/05/2021,519,3,69,319,388
19/05/2021,755,3,108,542,650
19/05/2021,865,3,20,69,89
19/05/2021,475,3,150,445,595
19/05/2021,848,3,68,232,300
19/05/2021,917,3,1,17,18
19/05/2021,594,3,137,519,656
19/05/2021,183,3,51,132,183
19/05/2021,193,3,92,279,371
19/05/2021,262,3,39,84,123
19/05/2021,118,3,72,232,304
19/05/2021,938,3,0,1,1
19/05/2021,799,3,20,73,93
19/05/2021,258,3,342,1221,1563
19/05/2021,787,3,304,1205,1509
19/05/2021,923,3,0,2,2
19/05/2021,325,3,43,247,290
19/05/2021,6,3,29,155,184
19/05/2021,539,3,138,382,520
19/05/2021,364,3,105,279,384
19/05/2021,230,3,70,224,294
19/05/2021,234,3,27,85,112
19/05/2021,873,3,129,402,531
19/05/2021,521,3,39,146,185
19/05/2021,49,3,21,81,102
19/05/2021,284,3,23,114,137
19/05/2021,925,3,0,3,3
19/05/2021,734,3,39,103,142
19/05/2021,531,3,73,277,350
19/05/2021,410,3,89,446,535
19/05/2021,256,3,111,317,428
19/05/2021,53,3,95,292,387
19/05/2021,830,3,303,1118,1421
19/05/2021,96,3,65,154,219
19/05/2021,757,3,127,395,522
19/05/2021,203,3,59,265,324
19/05/2021,643,3,73,315,388
19/05/2021,2,3,30,157,187
19/05/2021,486,3,77,330,407
19/05/2021,820,3,47,228,275
19/05/2021,732,3,24,121,145
19/05/2021,158,3,34,167,201
19/05/2021,791,3,60,274,334
19/05/2021,441,3,153,578,731
19/05/2021,339,3,87,335,422
19/05/2021,386,3,222,916,1138
19/05/2021,327,3,201,729,930
19/05/2021,490,3,29,108,137
19/05/2021,921,3,0,4,4
19/05/2021,818,3,71,293,364
19/05/2021,170,3,65,336,401
19/05/2021,829,3,91,458,549
19/05/2021,424,3,93,518,611
19/05/2021,70,3,130,592,722
19/05/2021,717,3,43,202,245
19/05/2021,711,3,43,169,212
19/05/2021,409,3,26,59,85
19/05/2021,614,3,39,152,191
19/05/2021,705,3,20,89,109
19/05/2021,638,3,112,366,478
19/05/2021,866,3,138,515,653
19/05/2021,780,3,182,620,802
19/05/2021,11,3,49,228,277
19/05/2021,365,3,58,155,213
19/05/2021,151,3,51,161,212
19/05/2021,271,3,50,197,247
19/05/2021,526,3,33,110,143
19/05/2021,255,3,10,10,20
19/05/2021,778,3,105,342,447
19/05/2021,184,3,43,160,203
19/05/2021,420,3,162,409,571
19/05/2021,190,3,93,300,393
19/05/2021,342,3,51,256,307
19/05/2021,817,3,96,339,435
19/05/2021,593,3,229,830,1059
19/05/2021,620,3,0,1,1
19/05/2021,939,3,0,2,2
19/05/2021,243,3,112,571,683
19/05/2021,131,3,56,231,287
19/05/2021,259,3,248,740,988
19/05/2021,689,3,126,325,451
19/05/2021,436,3,48,220,268
19/05/2021,512,3,20,97,117
19/05/2021,462,3,55,282,337
19/05/2021,683,3,46,253,299
19/05/2021,350,3,57,219,276
19/05/2021,247,3,86,377,463
19/05/2021,56,3,59,400,459
19/05/2021,399,3,169,520,689
19/05/2021,192,3,52,142,194
19/05/2021,825,3,102,435,537
19/05/2021,251,3,32,154,186
19/05/2021,186,3,40,94,134
19/05/2021,15,3,107,378,485
19/05/2021,393,3,28,173,201
19/05/2021,474,3,41,204,245
19/05/2021,269,3,43,188,231
19/05/2021,597,3,35,195,230
19/05/2021,253,3,43,133,176
19/05/2021,654,3,56,206,262
19/05/2021,162,3,207,744,951
19/05/2021,798,3,148,443,591
19/05/2021,585,3,157,465,622
19/05/2021,497,3,79,471,550
19/05/2021,125,3,75,210,285
19/05/2021,7,3,29,152,181
19/05/2021,123,3,59,232,291
19/05/2021,774,3,52,241,293
19/05/2021,196,3,67,190,257
19/05/2021,105,3,108,334,442
19/05/2021,298,3,104,560,664
19/05/2021,166,3,28,204,232
19/05/2021,646,3,55,232,287
19/05/2021,157,3,65,277,342
19/05/2021,941,3,0,1,1
19/05/2021,532,3,348,1202,1550
19/05/2021,876,3,0,5,5
19/05/2021,577,3,47,317,364
19/05/2021,595,3,46,129,175
19/05/2021,719,3,44,176,220
19/05/2021,874,3,67,256,323
19/05/2021,44,3,111,410,521
19/05/2021,172,3,68,345,413
19/05/2021,99,3,175,738,913
19/05/2021,868,3,245,811,1056
19/05/2021,803,3,79,218,297
19/05/2021,890,3,53,186,239
19/05/2021,88,3,74,266,340
19/05/2021,64,3,33,163,196
19/05/2021,485,3,61,283,344
19/05/2021,19,3,105,426,531
19/05/2021,520,3,67,220,287
19/05/2021,815,3,237,926,1163
19/05/2021,334,3,161,505,666
19/05/2021,738,3,96,264,360
19/05/2021,101,3,77,199,276
19/05/2021,723,3,70,295,365
19/05/2021,460,3,39,202,241
19/05/2021,466,3,73,233,306
19/05/2021,60,3,21,78,99
19/05/2021,235,3,41,247,288
19/05/2021,924,3,1,6,7
19/05/2021,632,3,19,81,100
19/05/2021,383,3,216,808,1024
19/05/2021,681,3,105,295,400
19/05/2021,418,3,28,60,88
19/05/2021,658,3,35,203,238
19/05/2021,675,3,57,216,273
19/05/2021,900,3,9,16,25
19/05/2021,918,3,1,25,26
19/05/2021,752,3,133,515,648
19/05/2021,534,3,57,204,261
19/05/2021,863,3,72,242,314
19/05/2021,238,3,100,507,607
19/05/2021,895,3,54,210,264
19/05/2021,276,3,64,268,332
19/05/2021,400,3,32,130,162
19/05/2021,570,3,65,212,277
19/05/2021,696,3,81,292,373
19/05/2021,28,3,46,176,222
19/05/2021,286,3,29,88,117
19/05/2021,785,3,299,1222,1521
19/05/2021,777,3,104,261,365
19/05/2021,305,3,93,341,434
19/05/2021,380,3,80,319,399
19/05/2021,187,3,35,97,132
19/05/2021,897,3,24,116,140
19/05/2021,423,3,91,484,575
19/05/2021,189,3,42,154,196
19/05/2021,95,3,144,540,684
19/05/2021,244,3,45,173,218
19/05/2021,195,3,45,113,158
19/05/2021,37,3,48,157,205
19/05/2021,802,3,186,811,997
19/05/2021,443,3,52,270,322
19/05/2021,473,3,39,174,213
19/05/2021,161,3,205,765,970
19/05/2021,309,3,16,112,128
19/05/2021,59,3,42,176,218
19/05/2021,743,3,35,171,206
19/05/2021,45,3,39,164,203
19/05/2021,582,3,279,974,1253
19/05/2021,543,3,297,1108,1405
19/05/2021,126,3,89,388,477
19/05/2021,706,3,177,505,682
19/05/2021,102,3,146,520,666
19/05/2021,510,3,79,468,547
19/05/2021,341,3,240,884,1124
19/05/2021,412,3,28,167,195
19/05/2021,134,3,112,368,480
19/05/2021,39,3,70,295,365
19/05/2021,930,3,1,8,9
19/05/2021,199,3,30,125,155
19/05/2021,846,3,1,30,31
19/05/2021,217,3,70,343,413
19/05/2021,79,3,58,219,277
19/05/2021,712,3,43,178,221
19/05/2021,333,3,58,446,504
19/05/2021,356,3,177,696,873
19/05/2021,637,3,135,606,741
19/05/2021,907,3,165,505,670
19/05/2021,500,3,16,63,79
19/05/2021,114,3,103,274,377
19/05/2021,280,3,22,91,113
19/05/2021,293,3,62,346,408
19/05/2021,824,3,165,586,751
19/05/2021,783,3,115,647,762
19/05/2021,360,3,48,263,311
19/05/2021,566,3,45,172,217
19/05/2021,465,3,41,221,262
19/05/2021,797,3,106,337,443
19/05/2021,311,3,74,283,357
19/05/2021,43,3,70,289,359
19/05/2021,615,3,74,331,405
19/05/2021,370,3,83,420,503
19/05/2021,171,3,7,38,45
19/05/2021,278,3,55,229,284
19/05/2021,89,3,102,406,508
19/05/2021,700,3,60,154,214
19/05/2021,71,3,53,277,330
19/05/2021,753,3,74,389,463
19/05/2021,852,3,133,279,412
19/05/2021,745,3,46,231,277
19/05/2021,122,3,100,297,397
19/05/2021,100,3,175,755,930
19/05/2021,710,3,47,178,225
19/05/2021,225,3,77,331,408
19/05/2021,346,3,37,171,208
19/05/2021,827,3,180,450,630
19/05/2021,214,3,77,363,440
19/05/2021,664,3,119,457,576
19/05/2021,31,3,60,254,314
19/05/2021,363,3,109,276,385
19/05/2021,21,3,76,324,400
19/05/2021,160,3,3,27,30
19/05/2021,845,3,70,249,319
19/05/2021,483,3,77,352,429
19/05/2021,880,3,0,17,17
19/05/2021,618,3,76,314,390
19/05/2021,725,3,64,251,315
19/05/2021,208,3,27,128,155
19/05/2021,147,3,76,288,364
19/05/2021,332,3,60,241,301
19/05/2021,287,3,119,578,697
19/05/2021,648,3,52,228,280
19/05/2021,153,3,99,362,461
19/05/2021,42,3,45,196,241
19/05/2021,589,3,74,207,281
19/05/2021,776,3,59,260,319
19/05/2021,864,3,42,167,209
19/05/2021,361,3,100,272,372
19/05/2021,17,3,36,188,224
19/05/2021,888,3,1,20,21
19/05/2021,413,3,110,560,670
19/05/2021,571,3,67,205,272
19/05/2021,198,3,118,347,465
19/05/2021,607,3,204,942,1146
19/05/2021,650,3,70,348,418
19/05/2021,569,3,88,257,345
19/05/2021,839,3,60,257,317
19/05/2021,575,3,21,94,115
19/05/2021,538,3,93,285,378
19/05/2021,758,3,80,322,402
19/05/2021,373,3,88,272,360
19/05/2021,430,3,61,235,296
19/05/2021,137,3,53,242,295
19/05/2021,563,3,72,240,312
19/05/2021,551,3,137,472,609
19/05/2021,872,3,79,167,246
19/05/2021,113,3,40,127,167
19/05/2021,788,3,314,1286,1600
19/05/2021,528,3,50,163,213
19/05/2021,565,3,204,572,776
19/05/2021,786,3,163,677,840
19/05/2021,237,3,95,503,598
19/05/2021,735,3,24,91,115
19/05/2021,478,3,76,203,279
19/05/2021,54,3,62,189,251
19/05/2021,318,3,130,451,581
19/05/2021,628,3,72,190,262
19/05/2021,489,3,11,25,36
19/05/2021,458,3,82,294,376
19/05/2021,155,3,100,438,538
19/05/2021,279,3,76,301,377
19/05/2021,178,3,104,305,409
19/05/2021,306,3,0,2,2
19/05/2021,323,3,37,161,198
19/05/2021,633,3,30,154,184
19/05/2021,219,3,47,215,262
19/05/2021,384,3,119,334,453
19/05/2021,349,3,34,183,217
19/05/2021,75,3,158,698,856
19/05/2021,887,3,1,13,14
19/05/2021,556,3,209,596,805
19/05/2021,544,3,121,299,420
19/05/2021,77,3,138,602,740
19/05/2021,215,3,39,184,223
19/05/2021,564,3,120,365,485
19/05/2021,619,3,66,190,256
19/05/2021,680,3,44,138,182
19/05/2021,24,3,26,67,93
19/05/2021,260,3,378,1280,1658
19/05/2021,661,3,123,455,578
19/05/2021,580,3,52,221,273
19/05/2021,425,3,66,320,386
19/05/2021,578,3,21,87,108
19/05/2021,421,3,135,274,409
19/05/2021,517,3,48,184,232
19/05/2021,469,3,48,184,232
19/05/2021,694,3,57,234,291
19/05/2021,651,3,75,241,316
19/05/2021,461,3,80,295,375
19/05/2021,649,3,55,142,197
19/05/2021,315,3,13,69,82
19/05/2021,726,3,57,229,286
19/05/2021,297,3,78,377,455
19/05/2021,169,3,58,283,341
19/05/2021,720,3,47,204,251
19/05/2021,548,3,69,175,244
19/05/2021,871,3,129,419,548
19/05/2021,747,3,70,246,316
19/05/2021,431,3,59,201,260
19/05/2021,136,3,112,378,490
19/05/2021,110,3,48,186,234
19/05/2021,598,3,240,1042,1282
19/05/2021,832,3,54,277,331
19/05/2021,404,3,197,696,893
19/05/2021,506,3,93,506,599
19/05/2021,484,3,62,252,314
19/05/2021,439,3,36,174,210
19/05/2021,352,3,87,353,440
19/05/2021,584,3,236,850,1086
19/05/2021,574,3,87,268,355
19/05/2021,714,3,112,324,436
19/05/2021,838,3,49,209,258
19/05/2021,728,3,69,316,385
19/05/2021,647,3,63,228,291
19/05/2021,686,3,33,219,252
19/05/2021,362,3,104,275,379
19/05/2021,382,3,0,2,2
19/05/2021,391,3,138,501,639
19/05/2021,371,3,67,269,336
19/05/2021,823,3,64,173,237
19/05/2021,878,3,1,15,16
19/05/2021,265,3,44,106,150
19/05/2021,660,3,44,165,209
19/05/2021,111,3,146,464,610
19/05/2021,514,3,21,92,113
19/05/2021,1,3,29,156,185
19/05/2021,701,3,51,224,275
19/05/2021,898,3,58,145,203
19/05/2021,48,3,19,80,99
19/05/2021,833,3,36,140,176
19/05/2021,300,3,81,511,592
19/05/2021,851,3,93,303,396
19/05/2021,312,3,82,226,308
19/05/2021,768,3,84,391,475
19/05/2021,540,3,157,470,627
19/05/2021,348,3,32,161,193
19/05/2021,249,3,118,597,715
19/05/2021,557,3,66,218,284
19/05/2021,853,3,57,214,271
19/05/2021,397,3,31,146,177
19/05/2021,670,3,341,1250,1591
19/05/2021,264,3,38,82,120
19/05/2021,248,3,39,112,151
19/05/2021,535,3,57,186,243
19/05/2021,688,3,65,211,276
19/05/2021,112,3,44,166,210
19/05/2021,899,3,154,645,799
19/05/2021,804,3,108,533,641
19/05/2021,83,3,292,1145,1437
19/05/2021,934,3,0,16,16
19/05/2021,408,3,134,647,781
19/05/2021,104,3,96,337,433
19/05/2021,402,3,117,395,512
19/05/2021,479,3,33,139,172
19/05/2021,901,3,7,6,13
19/05/2021,272,3,81,322,403
19/05/2021,455,3,30,167,197
19/05/2021,358,3,217,887,1104
19/05/2021,828,3,131,308,439
19/05/2021,562,3,30,54,84
19/05/2021,905,3,0,2,2
19/05/2021,201,3,44,190,234
19/05/2021,641,3,64,264,328
19/05/2021,414,3,130,625,755
19/05/2021,653,3,20,89,109
19/05/2021,621,3,51,218,269
19/05/2021,343,3,42,216,258
19/05/2021,445,3,51,286,337
19/05/2021,156,3,71,324,395
19/05/2021,179,3,72,225,297
19/05/2021,741,3,32,117,149
19/05/2021,494,3,69,202,271
19/05/2021,503,3,74,397,471
19/05/2021,405,3,19,76,95
19/05/2021,605,3,159,524,683
19/05/2021,377,3,116,283,399
19/05/2021,283,3,54,256,310
19/05/2021,599,3,240,1078,1318
19/05/2021,273,3,54,319,373
19/05/2021,640,3,64,241,305
19/05/2021,36,3,55,248,303
19/05/2021,395,3,41,197,238
19/05/2021,336,3,228,846,1074
19/05/2021,13,3,44,200,244
19/05/2021,468,3,42,218,260
19/05/2021,919,3,112,384,496
19/05/2021,372,3,182,593,775
19/05/2021,554,3,66,241,307
19/05/2021,674,3,44,198,242
19/05/2021,307,3,114,398,512
19/05/2021,627,3,34,139,173
19/05/2021,197,3,68,224,292
19/05/2021,659,3,35,203,238
19/05/2021,376,3,26,73,99
19/05/2021,665,3,55,239,294
19/05/2021,270,3,33,168,201
19/05/2021,35,3,75,321,396
19/05/2021,295,3,29,166,195
19/05/2021,639,3,53,230,283
19/05/2021,85,3,250,906,1156
19/05/2021,254,3,44,144,188
19/05/2021,335,3,54,251,305
19/05/2021,869,3,97,271,368
19/05/2021,515,3,27,113,140
19/05/2021,282,3,51,231,282
19/05/2021,130,3,145,440,585
19/05/2021,347,3,197,683,880
19/05/2021,224,3,51,140,191
19/05/2021,20,3,70,117,187
19/05/2021,781,3,112,542,654
19/05/2021,676,3,50,133,183
19/05/2021,419,3,117,450,567
19/05/2021,779,3,80,188,268
19/05/2021,590,3,0,1,1
19/05/2021,207,3,35,183,218
19/05/2021,592,3,107,401,508
19/05/2021,629,3,60,252,312
19/05/2021,65,3,51,361,412
19/05/2021,789,3,118,326,444
19/05/2021,867,3,58,167,225
19/05/2021,396,3,34,141,175
19/05/2021,812,3,66,239,305
19/05/2021,345,3,86,197,283
19/05/2021,513,3,32,126,158
19/05/2021,317,3,157,444,601
19/05/2021,810,3,56,253,309
19/05/2021,576,3,8,62,70
19/05/2021,240,3,99,514,613
19/05/2021,26,3,101,321,422
19/05/2021,146,3,127,487,614
19/05/2021,148,3,59,201,260
19/05/2021,63,3,40,142,182
19/05/2021,806,3,140,567,707
19/05/2021,211,3,76,363,439
19/05/2021,57,3,53,365,418
19/05/2021,437,3,48,308,356
19/05/2021,67,3,51,306,357
19/05/2021,525,3,117,424,541
19/05/2021,368,3,97,434,531
19/05/2021,226,3,85,241,326
19/05/2021,560,3,191,537,728
19/05/2021,669,3,46,214,260
19/05/2021,152,3,73,277,350
19/05/2021,498,3,29,125,154
19/05/2021,4,3,50,169,219
19/05/2021,915,3,0,23,23
19/05/2021,657,3,124,381,505
19/05/2021,351,3,238,804,1042
19/05/2021,552,3,162,435,597
19/05/2021,388,3,117,487,604
19/05/2021,331,3,77,237,314
19/05/2021,81,3,23,115,138
19/05/2021,116,3,50,178,228
19/05/2021,645,3,53,201,254
19/05/2021,771,3,71,291,362
19/05/2021,773,3,32,180,212
19/05/2021,291,3,71,455,526
19/05/2021,606,3,87,337,424
19/05/2021,685,3,61,209,270
19/05/2021,86,3,41,166,207
19/05/2021,583,3,36,156,192
19/05/2021,263,3,61,177,238
19/05/2021,634,3,57,260,317
19/05/2021,369,3,170,574,744
19/05/2021,511,3,23,157,180
19/05/2021,841,3,1,66,67
19/05/2021,440,3,68,343,411
19/05/2021,731,3,48,170,218
19/05/2021,748,3,54,131,185
19/05/2021,487,3,61,233,294
19/05/2021,381,3,5,1,6
19/05/2021,703,3,40,182,222
19/05/2021,216,3,55,256,311
19/05/2021,624,3,20,95,115
19/05/2021,233,3,119,358,477
19/05/2021,268,3,115,449,564
19/05/2021,546,3,159,483,642
19/05/2021,22,3,94,317,411
19/05/2021,303,3,81,387,468
19/05/2021,471,3,62,226,288
19/05/2021,447,3,42,151,193
19/05/2021,761,3,38,118,156
19/05/2021,730,3,39,189,228
19/05/2021,800,3,98,292,390
19/05/2021,8,3,61,147,208
19/05/2021,682,3,23,112,135
19/05/2021,135,3,122,399,521
19/05/2021,428,3,34,179,213
19/05/2021,129,3,81,267,348
19/05/2021,542,3,120,325,445
19/05/2021,115,3,19,139,158
19/05/2021,616,3,130,385,515
19/05/2021,344,3,69,279,348
19/05/2021,884,3,1,42,43
19/05/2021,9,3,97,204,301
19/05/2021,933,3,0,1,1
19/05/2021,662,3,124,544,668
19/05/2021,68,3,58,381,439
19/05/2021,756,3,101,492,593
19/05/2021,559,3,195,556,751
19/05/2021,679,3,52,188,240
19/05/2021,821,3,116,369,485
19/05/2021,357,3,190,755,945
19/05/2021,316,3,38,247,285
19/05/2021,174,3,51,168,219
19/05/2021,476,3,49,183,232
19/05/2021,916,3,0,1,1
19/05/2021,107,3,189,775,964
19/05/2021,407,3,90,439,529
19/05/2021,668,3,36,145,181
19/05/2021,5,3,29,153,182
19/05/2021,530,3,59,168,227
19/05/2021,290,3,82,494,576
19/05/2021,38,3,69,266,335
19/05/2021,127,3,52,199,251
19/05/2021,612,3,177,703,880
19/05/2021,227,3,47,144,191
19/05/2021,691,3,63,207,270
19/05/2021,426,3,42,173,215
19/05/2021,772,3,135,451,586
19/05/2021,52,3,119,351,470
19/05/2021,861,3,112,328,440
19/05/2021,742,3,64,237,301
19/05/2021,310,3,253,998,1251
19/05/2021,275,3,73,361,434
19/05/2021,906,3,10,12,22
19/05/2021,481,3,63,274,337
19/05/2021,452,3,61,256,317
19/05/2021,326,3,43,129,172
19/05/2021,222,3,68,201,269
19/05/2021,209,3,14,103,117
19/05/2021,433,3,169,641,810
19/05/2021,739,3,33,111,144
19/05/2021,529,3,73,245,318
19/05/2021,862,3,110,377,487
19/05/2021,881,3,2,10,12
19/05/2021,167,3,102,380,482
19/05/2021,816,3,179,579,758
19/05/2021,467,3,63,280,343
19/05/2021,496,3,22,97,119
19/05/2021,527,3,57,193,250
19/05/2021,12,3,21,85,106
19/05/2021,394,3,47,203,250
19/05/2021,390,3,138,575,713
19/05/2021,173,3,70,209,279
19/05/2021,142,3,48,109,157
19/05/2021,403,3,122,399,521
19/05/2021,509,3,69,348,417
19/05/2021,58,3,101,542,643
19/05/2021,579,3,39,166,205
19/05/2021,715,3,154,415,569
19/05/2021,603,3,150,483,633
19/05/2021,322,3,70,255,325
19/05/2021,472,3,188,657,845
19/05/2021,764,3,28,81,109
19/05/2021,438,3,47,172,219
19/05/2021,308,3,84,322,406
19/05/2021,218,3,77,366,443
20/05/2021,308,3,88,370,458
20/05/2021,579,3,41,184,225
20/05/2021,438,3,59,175,234
20/05/2021,472,3,206,767,973
20/05/2021,218,3,91,370,461
20/05/2021,764,3,32,87,119
20/05/2021,603,3,146,483,629
20/05/2021,403,3,131,391,522
20/05/2021,715,3,171,458,629
20/05/2021,58,3,113,649,762
20/05/2021,509,3,103,395,498
20/05/2021,322,3,77,266,343
20/05/2021,28,3,50,225,275
20/05/2021,286,3,35,93,128
20/05/2021,895,3,50,183,233
20/05/2021,187,3,34,126,160
20/05/2021,305,3,96,398,494
20/05/2021,380,3,95,365,460
20/05/2021,238,3,134,563,697
20/05/2021,696,3,103,306,409
20/05/2021,570,3,70,216,286
20/05/2021,777,3,97,215,312
20/05/2021,897,3,37,141,178
20/05/2021,276,3,68,280,348
20/05/2021,785,3,291,1321,1612
20/05/2021,400,3,25,135,160
20/05/2021,423,3,82,506,588
20/05/2021,189,3,44,163,207
20/05/2021,411,3,117,723,840
20/05/2021,304,3,127,407,534
20/05/2021,493,3,81,205,286
20/05/2021,330,3,64,273,337
20/05/2021,210,3,67,162,229
20/05/2021,212,3,92,393,485
20/05/2021,117,3,143,359,502
20/05/2021,807,3,68,225,293
20/05/2021,902,3,119,319,438
20/05/2021,338,3,88,387,475
20/05/2021,78,3,260,1070,1330
20/05/2021,636,3,56,225,281
20/05/2021,859,3,12,18,30
20/05/2021,656,3,36,226,262
20/05/2021,355,3,38,158,196
20/05/2021,501,3,132,549,681
20/05/2021,80,3,35,151,186
20/05/2021,894,3,64,168,232
20/05/2021,499,3,62,219,281
20/05/2021,340,3,91,346,437
20/05/2021,733,3,50,179,229
20/05/2021,188,3,102,361,463
20/05/2021,601,3,42,168,210
20/05/2021,697,3,47,164,211
20/05/2021,97,3,133,507,640
20/05/2021,610,3,143,839,982
20/05/2021,870,3,28,95,123
20/05/2021,442,3,47,188,235
20/05/2021,133,3,21,90,111
20/05/2021,677,3,42,181,223
20/05/2021,46,3,64,187,251
20/05/2021,904,3,90,340,430
20/05/2021,687,3,107,366,473
20/05/2021,119,3,62,236,298
20/05/2021,231,3,65,293,358
20/05/2021,200,3,28,130,158
20/05/2021,581,3,133,374,507
20/05/2021,809,3,58,172,230
20/05/2021,245,3,38,132,170
20/05/2021,792,3,119,357,476
20/05/2021,145,3,98,356,454
20/05/2021,608,3,213,1084,1297
20/05/2021,922,3,0,11,11
20/05/2021,591,3,121,299,420
20/05/2021,507,3,159,587,746
20/05/2021,25,3,66,279,345
20/05/2021,652,3,23,94,117
20/05/2021,448,3,227,833,1060
20/05/2021,353,3,27,119,146
20/05/2021,555,3,192,556,748
20/05/2021,444,3,68,315,383
20/05/2021,204,3,71,286,357
20/05/2021,642,3,70,302,372
20/05/2021,202,3,123,599,722
20/05/2021,422,3,54,170,224
20/05/2021,3,3,36,164,200
20/05/2021,92,3,70,276,346
20/05/2021,139,3,53,198,251
20/05/2021,760,3,79,410,489
20/05/2021,622,3,147,456,603
20/05/2021,782,3,93,433,526
20/05/2021,464,3,105,363,468
20/05/2021,754,3,74,439,513
20/05/2021,292,3,106,549,655
20/05/2021,813,3,63,218,281
20/05/2021,72,3,131,766,897
20/05/2021,518,3,24,72,96
20/05/2021,794,3,174,651,825
20/05/2021,159,3,89,462,551
20/05/2021,456,3,55,298,353
20/05/2021,567,3,86,254,340
20/05/2021,90,3,40,192,232
20/05/2021,811,3,47,154,201
20/05/2021,547,3,321,1213,1534
20/05/2021,27,3,158,453,611
20/05/2021,736,3,24,110,134
20/05/2021,149,3,77,320,397
20/05/2021,937,3,0,1,1
20/05/2021,770,3,191,677,868
20/05/2021,524,3,121,370,491
20/05/2021,587,3,17,63,80
20/05/2021,164,3,50,266,316
20/05/2021,721,3,374,1287,1661
20/05/2021,561,3,52,166,218
20/05/2021,229,3,122,404,526
20/05/2021,746,3,47,172,219
20/05/2021,713,3,72,527,599
20/05/2021,931,3,0,3,3
20/05/2021,168,3,46,206,252
20/05/2021,673,3,69,290,359
20/05/2021,600,3,247,1002,1249
20/05/2021,354,3,4,9,13
20/05/2021,936,3,22,50,72
20/05/2021,163,3,49,204,253
20/05/2021,909,3,1,6,7
20/05/2021,321,3,41,144,185
20/05/2021,51,3,215,877,1092
20/05/2021,213,3,105,392,497
20/05/2021,684,3,99,361,460
20/05/2021,138,3,59,214,273
20/05/2021,417,3,108,743,851
20/05/2021,836,3,94,556,650
20/05/2021,875,3,41,162,203
20/05/2021,427,3,240,896,1136
20/05/2021,266,3,39,166,205
20/05/2021,252,3,49,150,199
20/05/2021,128,3,49,231,280
20/05/2021,47,3,78,223,301
20/05/2021,759,3,38,174,212
20/05/2021,236,3,43,204,247
20/05/2021,826,3,124,509,633
20/05/2021,221,3,80,231,311
20/05/2021,154,3,98,379,477
20/05/2021,242,3,135,587,722
20/05/2021,18,3,75,300,375
20/05/2021,765,3,65,316,381
20/05/2021,751,3,0,15,15
20/05/2021,488,3,75,216,291
20/05/2021,704,3,26,100,126
20/05/2021,879,3,2,16,18
20/05/2021,623,3,95,324,419
20/05/2021,480,3,49,156,205
20/05/2021,767,3,182,679,861
20/05/2021,392,3,53,196,249
20/05/2021,120,3,106,319,425
20/05/2021,232,3,79,236,315
20/05/2021,588,3,110,284,394
20/05/2021,429,3,62,336,398
20/05/2021,250,3,97,216,313
20/05/2021,177,3,49,155,204
20/05/2021,274,3,2,18,20
20/05/2021,33,3,46,198,244
20/05/2021,885,3,2,49,51
20/05/2021,854,3,150,642,792
20/05/2021,108,3,44,136,180
20/05/2021,366,3,54,114,168
20/05/2021,860,3,52,271,323
20/05/2021,144,3,78,358,436
20/05/2021,842,3,12,23,35
20/05/2021,30,3,136,364,500
20/05/2021,604,3,150,494,644
20/05/2021,61,3,55,377,432
20/05/2021,289,3,55,136,191
20/05/2021,185,3,55,198,253
20/05/2021,124,3,60,222,282
20/05/2021,850,3,207,638,845
20/05/2021,926,3,15,69,84
20/05/2021,302,3,71,474,545
20/05/2021,387,3,76,223,299
20/05/2021,536,3,41,148,189
20/05/2021,914,3,3,5,8
20/05/2021,727,3,48,224,272
20/05/2021,908,3,50,258,308
20/05/2021,367,3,97,439,536
20/05/2021,693,3,71,213,284
20/05/2021,449,3,84,291,375
20/05/2021,602,3,190,651,841
20/05/2021,722,3,23,132,155
20/05/2021,41,3,60,320,380
20/05/2021,775,3,53,224,277
20/05/2021,671,3,62,286,348
20/05/2021,793,3,78,362,440
20/05/2021,928,3,1,3,4
20/05/2021,93,3,64,349,413
20/05/2021,702,3,52,229,281
20/05/2021,398,3,12,28,40
20/05/2021,69,3,93,325,418
20/05/2021,492,3,56,151,207
20/05/2021,537,3,126,427,553
20/05/2021,586,3,107,420,527
20/05/2021,889,3,1,11,12
20/05/2021,477,3,54,182,236
20/05/2021,883,3,2,46,48
20/05/2021,175,3,72,245,317
20/05/2021,795,3,86,320,406
20/05/2021,558,3,60,206,266
20/05/2021,613,3,25,107,132
20/05/2021,903,3,2,3,5
20/05/2021,504,3,33,102,135
20/05/2021,406,3,92,410,502
20/05/2021,378,3,49,221,270
20/05/2021,858,3,158,523,681
20/05/2021,533,3,95,302,397
20/05/2021,91,3,68,273,341
20/05/2021,374,3,41,140,181
20/05/2021,435,3,36,135,171
20/05/2021,625,3,63,197,260
20/05/2021,749,3,38,186,224
20/05/2021,87,3,156,581,737
20/05/2021,246,3,143,633,776
20/05/2021,572,3,88,265,353
20/05/2021,631,3,26,93,119
20/05/2021,737,3,33,146,179
20/05/2021,205,3,55,267,322
20/05/2021,140,3,45,210,255
20/05/2021,635,3,77,372,449
20/05/2021,453,3,87,334,421
20/05/2021,692,3,105,335,440
20/05/2021,840,3,37,205,242
20/05/2021,463,3,184,689,873
20/05/2021,655,3,106,406,512
20/05/2021,877,3,2,28,30
20/05/2021,663,3,67,307,374
20/05/2021,457,3,45,159,204
20/05/2021,328,3,75,282,357
20/05/2021,910,3,2,43,45
20/05/2021,82,3,125,398,523
20/05/2021,454,3,63,344,407
20/05/2021,495,3,68,176,244
20/05/2021,288,3,30,64,94
20/05/2021,892,3,5,8,13
20/05/2021,261,3,406,1370,1776
20/05/2021,359,3,142,397,539
20/05/2021,843,3,52,178,230
20/05/2021,900,3,12,20,32
20/05/2021,675,3,61,206,267
20/05/2021,60,3,20,72,92
20/05/2021,534,3,54,271,325
20/05/2021,658,3,49,267,316
20/05/2021,924,3,2,5,7
20/05/2021,235,3,60,253,313
20/05/2021,918,3,1,11,12
20/05/2021,632,3,30,114,144
20/05/2021,752,3,149,644,793
20/05/2021,383,3,213,857,1070
20/05/2021,418,3,31,79,110
20/05/2021,681,3,137,354,491
20/05/2021,194,3,0,2,2
20/05/2021,863,3,72,252,324
20/05/2021,118,3,60,234,294
20/05/2021,938,3,0,8,8
20/05/2021,539,3,144,406,550
20/05/2021,234,3,22,101,123
20/05/2021,734,3,33,86,119
20/05/2021,6,3,35,161,196
20/05/2021,925,3,0,1,1
20/05/2021,258,3,371,1284,1655
20/05/2021,799,3,23,69,92
20/05/2021,230,3,56,220,276
20/05/2021,787,3,311,1322,1633
20/05/2021,873,3,144,435,579
20/05/2021,49,3,25,96,121
20/05/2021,521,3,57,158,215
20/05/2021,325,3,44,236,280
20/05/2021,284,3,38,98,136
20/05/2021,364,3,120,266,386
20/05/2021,849,3,58,369,427
20/05/2021,470,3,65,289,354
20/05/2021,553,3,50,82,132
20/05/2021,379,3,105,341,446
20/05/2021,573,3,66,222,288
20/05/2021,801,3,66,303,369
20/05/2021,896,3,327,1237,1564
20/05/2021,50,3,25,97,122
20/05/2021,23,3,15,73,88
20/05/2021,847,3,6,26,32
20/05/2021,819,3,90,287,377
20/05/2021,434,3,4,25,29
20/05/2021,709,3,199,580,779
20/05/2021,835,3,128,385,513
20/05/2021,277,3,82,280,362
20/05/2021,121,3,282,1052,1334
20/05/2021,257,3,331,1061,1392
20/05/2021,32,3,104,235,339
20/05/2021,505,3,24,105,129
20/05/2021,831,3,80,310,390
20/05/2021,314,3,32,136,168
20/05/2021,103,3,133,465,598
20/05/2021,389,3,141,586,727
20/05/2021,176,3,108,349,457
20/05/2021,837,3,110,383,493
20/05/2021,855,3,102,380,482
20/05/2021,920,3,1,5,6
20/05/2021,446,3,50,213,263
20/05/2021,66,3,52,349,401
20/05/2021,784,3,238,1089,1327
20/05/2021,882,3,0,14,14
20/05/2021,450,3,59,280,339
20/05/2021,239,3,78,284,362
20/05/2021,267,3,53,236,289
20/05/2021,182,3,36,196,232
20/05/2021,281,3,62,305,367
20/05/2021,416,3,35,185,220
20/05/2021,522,3,46,187,233
20/05/2021,401,3,36,165,201
20/05/2021,666,3,111,345,456
20/05/2021,296,3,53,99,152
20/05/2021,707,3,167,445,612
20/05/2021,491,3,126,530,656
20/05/2021,790,3,66,298,364
20/05/2021,917,3,4,21,25
20/05/2021,755,3,105,533,638
20/05/2021,451,3,198,692,890
20/05/2021,262,3,48,91,139
20/05/2021,475,3,156,478,634
20/05/2021,932,3,1,23,24
20/05/2021,865,3,23,82,105
20/05/2021,519,3,69,319,388
20/05/2021,594,3,142,584,726
20/05/2021,106,3,126,639,765
20/05/2021,228,3,39,126,165
20/05/2021,193,3,80,283,363
20/05/2021,617,3,45,181,226
20/05/2021,848,3,63,220,283
20/05/2021,183,3,48,160,208
20/05/2021,34,3,51,159,210
20/05/2021,143,3,128,568,696
20/05/2021,805,3,47,206,253
20/05/2021,220,3,62,206,268
20/05/2021,285,3,55,175,230
20/05/2021,626,3,45,163,208
20/05/2021,857,3,54,191,245
20/05/2021,294,3,125,331,456
20/05/2021,84,3,205,647,852
20/05/2021,432,3,56,301,357
20/05/2021,750,3,61,487,548
20/05/2021,180,3,58,257,315
20/05/2021,699,3,48,193,241
20/05/2021,886,3,2,28,30
20/05/2021,206,3,3,8,11
20/05/2021,76,3,117,693,810
20/05/2021,385,3,73,314,387
20/05/2021,329,3,224,881,1105
20/05/2021,337,3,33,115,148
20/05/2021,508,3,109,411,520
20/05/2021,911,3,75,394,469
20/05/2021,814,3,67,139,206
20/05/2021,550,3,154,422,576
20/05/2021,913,3,8,35,43
20/05/2021,301,3,98,448,546
20/05/2021,891,3,56,234,290
20/05/2021,844,3,32,176,208
20/05/2021,724,3,281,1081,1362
20/05/2021,55,3,35,176,211
20/05/2021,319,3,22,122,144
20/05/2021,808,3,148,541,689
20/05/2021,98,3,126,638,764
20/05/2021,698,3,46,160,206
20/05/2021,459,3,83,295,378
20/05/2021,716,3,47,192,239
20/05/2021,299,3,35,145,180
20/05/2021,181,3,42,188,230
20/05/2021,313,3,30,112,142
20/05/2021,856,3,128,415,543
20/05/2021,890,3,50,241,291
20/05/2021,723,3,68,277,345
20/05/2021,88,3,66,281,347
20/05/2021,101,3,56,200,256
20/05/2021,334,3,157,514,671
20/05/2021,803,3,75,222,297
20/05/2021,99,3,185,821,1006
20/05/2021,485,3,79,250,329
20/05/2021,868,3,287,932,1219
20/05/2021,19,3,114,460,574
20/05/2021,466,3,87,275,362
20/05/2021,64,3,40,164,204
20/05/2021,520,3,68,199,267
20/05/2021,738,3,89,292,381
20/05/2021,815,3,273,1045,1318
20/05/2021,172,3,62,329,391
20/05/2021,460,3,52,204,256
20/05/2021,184,3,40,175,215
20/05/2021,420,3,153,453,606
20/05/2021,526,3,43,150,193
20/05/2021,259,3,253,720,973
20/05/2021,271,3,56,224,280
20/05/2021,778,3,80,365,445
20/05/2021,131,3,55,224,279
20/05/2021,593,3,236,884,1120
20/05/2021,190,3,97,324,421
20/05/2021,342,3,64,249,313
20/05/2021,817,3,102,354,456
20/05/2021,151,3,57,188,245
20/05/2021,243,3,145,651,796
20/05/2021,689,3,123,336,459
20/05/2021,365,3,55,163,218
20/05/2021,939,3,0,6,6
20/05/2021,255,3,11,7,18
20/05/2021,620,3,0,2,2
20/05/2021,2,3,36,162,198
20/05/2021,486,3,82,341,423
20/05/2021,203,3,71,301,372
20/05/2021,158,3,39,132,171
20/05/2021,410,3,82,545,627
20/05/2021,327,3,175,677,852
20/05/2021,531,3,63,351,414
20/05/2021,791,3,64,266,330
20/05/2021,643,3,71,339,410
20/05/2021,441,3,184,655,839
20/05/2021,490,3,53,123,176
20/05/2021,386,3,217,1050,1267
20/05/2021,818,3,69,259,328
20/05/2021,256,3,110,335,445
20/05/2021,732,3,40,153,193
20/05/2021,339,3,93,330,423
20/05/2021,921,3,0,12,12
20/05/2021,820,3,52,228,280
20/05/2021,830,3,319,1177,1496
20/05/2021,53,3,111,340,451
20/05/2021,96,3,45,166,211
20/05/2021,757,3,161,385,546
20/05/2021,717,3,55,225,280
20/05/2021,70,3,100,655,755
20/05/2021,711,3,45,209,254
20/05/2021,424,3,87,529,616
20/05/2021,829,3,124,533,657
20/05/2021,638,3,118,367,485
20/05/2021,780,3,187,664,851
20/05/2021,409,3,26,80,106
20/05/2021,614,3,43,146,189
20/05/2021,705,3,23,78,101
20/05/2021,11,3,56,243,299
20/05/2021,866,3,161,667,828
20/05/2021,170,3,70,346,416
20/05/2021,876,3,0,6,6
20/05/2021,532,3,364,1299,1663
20/05/2021,719,3,48,176,224
20/05/2021,874,3,62,287,349
20/05/2021,577,3,55,332,387
20/05/2021,44,3,101,368,469
20/05/2021,595,3,41,172,213
20/05/2021,683,3,89,292,381
20/05/2021,15,3,90,398,488
20/05/2021,512,3,24,94,118
20/05/2021,56,3,64,438,502
20/05/2021,462,3,43,296,339
20/05/2021,251,3,51,157,208
20/05/2021,253,3,45,167,212
20/05/2021,597,3,47,227,274
20/05/2021,825,3,105,413,518
20/05/2021,436,3,48,219,267
20/05/2021,654,3,49,217,266
20/05/2021,350,3,62,216,278
20/05/2021,162,3,223,764,987
20/05/2021,247,3,102,401,503
20/05/2021,399,3,141,532,673
20/05/2021,393,3,35,158,193
20/05/2021,192,3,43,160,203
20/05/2021,269,3,52,196,248
20/05/2021,186,3,48,100,148
20/05/2021,474,3,40,188,228
20/05/2021,497,3,121,516,637
20/05/2021,646,3,56,295,351
20/05/2021,125,3,75,216,291
20/05/2021,7,3,34,165,199
20/05/2021,157,3,62,280,342
20/05/2021,105,3,105,335,440
20/05/2021,298,3,91,590,681
20/05/2021,166,3,28,210,238
20/05/2021,196,3,59,205,264
20/05/2021,123,3,65,242,307
20/05/2021,798,3,190,444,634
20/05/2021,774,3,65,247,312
20/05/2021,585,3,189,471,660
20/05/2021,941,3,0,1,1
20/05/2021,529,3,75,240,315
20/05/2021,467,3,44,286,330
20/05/2021,394,3,39,179,218
20/05/2021,433,3,194,728,922
20/05/2021,816,3,172,642,814
20/05/2021,167,3,100,345,445
20/05/2021,739,3,32,139,171
20/05/2021,862,3,116,384,500
20/05/2021,527,3,57,181,238
20/05/2021,173,3,101,263,364
20/05/2021,881,3,2,12,14
20/05/2021,496,3,22,94,116
20/05/2021,142,3,50,115,165
20/05/2021,209,3,10,121,131
20/05/2021,390,3,157,674,831
20/05/2021,12,3,20,93,113
20/05/2021,83,3,314,1233,1547
20/05/2021,535,3,54,238,292
20/05/2021,408,3,130,751,881
20/05/2021,688,3,57,273,330
20/05/2021,934,3,1,14,15
20/05/2021,899,3,157,689,846
20/05/2021,901,3,7,10,17
20/05/2021,804,3,146,593,739
20/05/2021,104,3,99,396,495
20/05/2021,272,3,94,361,455
20/05/2021,402,3,127,388,515
20/05/2021,112,3,53,159,212
20/05/2021,264,3,41,102,143
20/05/2021,479,3,45,149,194
20/05/2021,248,3,49,128,177
20/05/2021,551,3,153,504,657
20/05/2021,650,3,85,357,442
20/05/2021,430,3,55,265,320
20/05/2021,373,3,119,324,443
20/05/2021,137,3,59,229,288
20/05/2021,538,3,99,332,431
20/05/2021,563,3,76,248,324
20/05/2021,839,3,58,264,322
20/05/2021,569,3,85,252,337
20/05/2021,872,3,69,151,220
20/05/2021,575,3,30,107,137
20/05/2021,113,3,31,131,162
20/05/2021,758,3,88,326,414
20/05/2021,500,3,18,66,84
20/05/2021,217,3,90,351,441
20/05/2021,824,3,173,658,831
20/05/2021,356,3,168,684,852
20/05/2021,712,3,44,214,258
20/05/2021,360,3,56,259,315
20/05/2021,783,3,117,688,805
20/05/2021,114,3,110,326,436
20/05/2021,333,3,67,455,522
20/05/2021,280,3,27,69,96
20/05/2021,79,3,53,237,290
20/05/2021,465,3,46,235,281
20/05/2021,907,3,142,525,667
20/05/2021,43,3,82,360,442
20/05/2021,566,3,50,181,231
20/05/2021,797,3,133,457,590
20/05/2021,637,3,138,607,745
20/05/2021,293,3,48,336,384
20/05/2021,846,3,7,35,42
20/05/2021,311,3,82,307,389
20/05/2021,473,3,37,142,179
20/05/2021,195,3,30,125,155
20/05/2021,309,3,19,93,112
20/05/2021,95,3,168,668,836
20/05/2021,443,3,64,297,361
20/05/2021,37,3,54,162,216
20/05/2021,59,3,38,188,226
20/05/2021,244,3,52,193,245
20/05/2021,802,3,177,827,1004
20/05/2021,161,3,236,804,1040
20/05/2021,510,3,116,507,623
20/05/2021,126,3,101,424,525
20/05/2021,412,3,22,236,258
20/05/2021,45,3,48,156,204
20/05/2021,930,3,2,9,11
20/05/2021,134,3,136,359,495
20/05/2021,341,3,251,962,1213
20/05/2021,743,3,44,159,203
20/05/2021,199,3,26,107,133
20/05/2021,543,3,310,1190,1500
20/05/2021,706,3,199,577,776
20/05/2021,102,3,145,503,648
20/05/2021,39,3,81,356,437
20/05/2021,582,3,292,1066,1358
20/05/2021,607,3,176,1021,1197
20/05/2021,198,3,131,335,466
20/05/2021,648,3,69,206,275
20/05/2021,776,3,61,331,392
20/05/2021,17,3,37,178,215
20/05/2021,361,3,119,257,376
20/05/2021,571,3,67,213,280
20/05/2021,864,3,52,144,196
20/05/2021,153,3,106,420,526
20/05/2021,332,3,61,226,287
20/05/2021,287,3,108,609,717
20/05/2021,147,3,77,337,414
20/05/2021,413,3,105,657,762
20/05/2021,589,3,93,221,314
20/05/2021,42,3,42,225,267
20/05/2021,888,3,4,24,28
20/05/2021,71,3,57,300,357
20/05/2021,615,3,81,361,442
20/05/2021,122,3,107,320,427
20/05/2021,745,3,58,231,289
20/05/2021,89,3,108,421,529
20/05/2021,100,3,185,836,1021
20/05/2021,700,3,42,170,212
20/05/2021,370,3,95,429,524
20/05/2021,852,3,131,297,428
20/05/2021,753,3,79,511,590
20/05/2021,278,3,59,253,312
20/05/2021,710,3,42,219,261
20/05/2021,171,3,5,32,37
20/05/2021,160,3,5,25,30
20/05/2021,618,3,77,290,367
20/05/2021,483,3,102,337,439
20/05/2021,725,3,57,213,270
20/05/2021,225,3,68,299,367
20/05/2021,21,3,89,348,437
20/05/2021,31,3,54,288,342
20/05/2021,346,3,43,159,202
20/05/2021,827,3,158,482,640
20/05/2021,363,3,131,270,401
20/05/2021,94,3,0,1,1
20/05/2021,214,3,92,368,460
20/05/2021,845,3,68,252,320
20/05/2021,880,3,0,15,15
20/05/2021,664,3,117,426,543
20/05/2021,208,3,32,142,174
20/05/2021,557,3,63,226,289
20/05/2021,670,3,355,1358,1713
20/05/2021,768,3,103,447,550
20/05/2021,249,3,153,648,801
20/05/2021,833,3,42,146,188
20/05/2021,300,3,85,532,617
20/05/2021,397,3,35,138,173
20/05/2021,540,3,168,489,657
20/05/2021,898,3,52,124,176
20/05/2021,851,3,87,332,419
20/05/2021,348,3,43,153,196
20/05/2021,853,3,63,208,271
20/05/2021,312,3,99,256,355
20/05/2021,48,3,24,93,117
20/05/2021,578,3,23,88,111
20/05/2021,580,3,50,252,302
20/05/2021,661,3,119,434,553
20/05/2021,461,3,83,341,424
20/05/2021,421,3,137,349,486
20/05/2021,517,3,51,176,227
20/05/2021,651,3,80,263,343
20/05/2021,24,3,15,70,85
20/05/2021,469,3,43,184,227
20/05/2021,694,3,56,241,297
20/05/2021,680,3,61,147,208
20/05/2021,260,3,408,1372,1780
20/05/2021,425,3,64,344,408
20/05/2021,565,3,207,595,802
20/05/2021,178,3,99,324,423
20/05/2021,478,3,58,126,184
20/05/2021,306,3,0,2,2
20/05/2021,528,3,49,168,217
20/05/2021,279,3,68,316,384
20/05/2021,318,3,135,444,579
20/05/2021,54,3,80,199,279
20/05/2021,786,3,164,764,928
20/05/2021,735,3,25,145,170
20/05/2021,628,3,61,204,265
20/05/2021,155,3,112,460,572
20/05/2021,237,3,131,565,696
20/05/2021,458,3,103,348,451
20/05/2021,489,3,37,54,91
20/05/2021,788,3,299,1331,1630
20/05/2021,323,3,41,166,207
20/05/2021,556,3,216,621,837
20/05/2021,75,3,118,757,875
20/05/2021,544,3,121,348,469
20/05/2021,219,3,45,218,263
20/05/2021,633,3,39,210,249
20/05/2021,215,3,39,179,218
20/05/2021,887,3,2,10,12
20/05/2021,384,3,107,328,435
20/05/2021,349,3,42,198,240
20/05/2021,564,3,124,372,496
20/05/2021,77,3,115,695,810
20/05/2021,619,3,75,205,280
20/05/2021,371,3,73,270,343
20/05/2021,391,3,137,538,675
20/05/2021,660,3,53,164,217
20/05/2021,701,3,53,220,273
20/05/2021,514,3,22,90,112
20/05/2021,823,3,50,184,234
20/05/2021,878,3,1,17,18
20/05/2021,1,3,34,161,195
20/05/2021,265,3,52,113,165
20/05/2021,111,3,132,493,625
20/05/2021,726,3,57,211,268
20/05/2021,169,3,55,264,319
20/05/2021,871,3,111,446,557
20/05/2021,747,3,89,292,381
20/05/2021,720,3,54,212,266
20/05/2021,649,3,71,178,249
20/05/2021,297,3,79,389,468
20/05/2021,315,3,7,85,92
20/05/2021,548,3,74,181,255
20/05/2021,832,3,52,282,334
20/05/2021,484,3,77,216,293
20/05/2021,647,3,56,270,326
20/05/2021,352,3,75,386,461
20/05/2021,431,3,65,225,290
20/05/2021,584,3,238,871,1109
20/05/2021,110,3,41,193,234
20/05/2021,686,3,51,236,287
20/05/2021,136,3,136,376,512
20/05/2021,728,3,59,315,374
20/05/2021,506,3,156,561,717
20/05/2021,714,3,118,352,470
20/05/2021,598,3,268,1136,1404
20/05/2021,382,3,0,2,2
20/05/2021,404,3,201,806,1007
20/05/2021,574,3,88,266,354
20/05/2021,439,3,45,183,228
20/05/2021,838,3,64,240,304
20/05/2021,362,3,125,264,389
20/05/2021,742,3,80,268,348
20/05/2021,52,3,123,357,480
20/05/2021,772,3,151,483,634
20/05/2021,691,3,67,232,299
20/05/2021,222,3,83,223,306
20/05/2021,275,3,87,351,438
20/05/2021,127,3,55,234,289
20/05/2021,426,3,56,187,243
20/05/2021,612,3,124,628,752
20/05/2021,310,3,239,1055,1294
20/05/2021,481,3,85,256,341
20/05/2021,861,3,121,376,497
20/05/2021,227,3,38,137,175
20/05/2021,452,3,58,257,315
20/05/2021,906,3,7,14,21
20/05/2021,326,3,34,106,140
20/05/2021,388,3,117,523,640
20/05/2021,351,3,268,880,1148
20/05/2021,81,3,27,133,160
20/05/2021,645,3,49,258,307
20/05/2021,606,3,92,355,447
20/05/2021,331,3,82,236,318
20/05/2021,773,3,38,208,246
20/05/2021,771,3,73,413,486
20/05/2021,116,3,55,225,280
20/05/2021,291,3,74,483,557
20/05/2021,552,3,163,455,618
20/05/2021,659,3,51,267,318
20/05/2021,674,3,43,282,325
20/05/2021,627,3,40,125,165
20/05/2021,197,3,65,252,317
20/05/2021,639,3,69,221,290
20/05/2021,919,3,134,408,542
20/05/2021,554,3,59,240,299
20/05/2021,85,3,290,1085,1375
20/05/2021,372,3,217,604,821
20/05/2021,307,3,118,450,568
20/05/2021,665,3,60,305,365
20/05/2021,295,3,25,174,199
20/05/2021,35,3,66,357,423
20/05/2021,376,3,16,72,88
20/05/2021,270,3,47,167,214
20/05/2021,741,3,32,144,176
20/05/2021,201,3,35,174,209
20/05/2021,455,3,47,180,227
20/05/2021,156,3,67,305,372
20/05/2021,358,3,204,866,1070
20/05/2021,445,3,53,287,340
20/05/2021,905,3,2,6,8
20/05/2021,621,3,50,227,277
20/05/2021,179,3,83,244,327
20/05/2021,653,3,22,97,119
20/05/2021,562,3,15,81,96
20/05/2021,494,3,63,205,268
20/05/2021,414,3,121,704,825
20/05/2021,828,3,132,341,473
20/05/2021,641,3,69,312,381
20/05/2021,343,3,44,194,238
20/05/2021,273,3,56,283,339
20/05/2021,605,3,158,538,696
20/05/2021,468,3,51,221,272
20/05/2021,13,3,53,192,245
20/05/2021,395,3,38,177,215
20/05/2021,640,3,65,291,356
20/05/2021,36,3,54,282,336
20/05/2021,377,3,117,325,442
20/05/2021,336,3,244,927,1171
20/05/2021,599,3,266,1140,1406
20/05/2021,405,3,23,92,115
20/05/2021,283,3,67,223,290
20/05/2021,503,3,109,438,547
20/05/2021,560,3,201,570,771
20/05/2021,368,3,110,430,540
20/05/2021,806,3,133,659,792
20/05/2021,4,3,52,188,240
20/05/2021,152,3,74,341,415
20/05/2021,498,3,67,162,229
20/05/2021,657,3,115,362,477
20/05/2021,226,3,75,191,266
20/05/2021,669,3,49,298,347
20/05/2021,437,3,56,304,360
20/05/2021,211,3,91,368,459
20/05/2021,915,3,0,17,17
20/05/2021,525,3,125,428,553
20/05/2021,57,3,59,371,430
20/05/2021,67,3,51,321,372
20/05/2021,207,3,43,198,241
20/05/2021,515,3,61,133,194
20/05/2021,592,3,111,465,576
20/05/2021,629,3,57,280,337
20/05/2021,396,3,36,130,166
20/05/2021,419,3,130,483,613
20/05/2021,789,3,135,356,491
20/05/2021,347,3,213,702,915
20/05/2021,254,3,52,176,228
20/05/2021,779,3,76,171,247
20/05/2021,130,3,172,446,618
20/05/2021,335,3,64,271,335
20/05/2021,282,3,56,247,303
20/05/2021,65,3,52,386,438
20/05/2021,676,3,50,130,180
20/05/2021,869,3,116,260,376
20/05/2021,20,3,73,128,201
20/05/2021,224,3,40,124,164
20/05/2021,867,3,66,188,254
20/05/2021,781,3,119,563,682
20/05/2021,345,3,71,169,240
20/05/2021,26,3,102,339,441
20/05/2021,317,3,163,500,663
20/05/2021,576,3,13,74,87
20/05/2021,810,3,80,275,355
20/05/2021,513,3,33,122,155
20/05/2021,63,3,35,143,178
20/05/2021,812,3,79,288,367
20/05/2021,148,3,47,184,231
20/05/2021,146,3,132,572,704
20/05/2021,240,3,131,576,707
20/05/2021,174,3,55,183,238
20/05/2021,916,3,1,1,2
20/05/2021,476,3,52,192,244
20/05/2021,357,3,182,725,907
20/05/2021,316,3,42,236,278
20/05/2021,407,3,84,556,640
20/05/2021,821,3,139,381,520
20/05/2021,107,3,187,857,1044
20/05/2021,559,3,206,591,797
20/05/2021,290,3,82,523,605
20/05/2021,668,3,35,136,171
20/05/2021,530,3,48,196,244
20/05/2021,38,3,73,337,410
20/05/2021,5,3,34,160,194
20/05/2021,679,3,62,183,245
20/05/2021,761,3,41,141,182
20/05/2021,8,3,44,165,209
20/05/2021,447,3,49,172,221
20/05/2021,268,3,102,447,549
20/05/2021,730,3,40,210,250
20/05/2021,471,3,70,253,323
20/05/2021,303,3,94,387,481
20/05/2021,800,3,105,296,401
20/05/2021,682,3,30,114,144
20/05/2021,546,3,173,505,678
20/05/2021,22,3,105,334,439
20/05/2021,86,3,43,168,211
20/05/2021,685,3,52,238,290
20/05/2021,748,3,51,135,186
20/05/2021,634,3,75,273,348
20/05/2021,731,3,47,155,202
20/05/2021,440,3,112,404,516
20/05/2021,233,3,148,419,567
20/05/2021,703,3,41,178,219
20/05/2021,624,3,17,109,126
20/05/2021,511,3,31,172,203
20/05/2021,487,3,72,219,291
20/05/2021,841,3,3,56,59
20/05/2021,369,3,189,610,799
20/05/2021,263,3,68,177,245
20/05/2021,381,3,5,9,14
20/05/2021,583,3,25,162,187
20/05/2021,216,3,54,243,297
20/05/2021,68,3,61,397,458
20/05/2021,9,3,113,310,423
20/05/2021,884,3,2,44,46
20/05/2021,756,3,103,488,591
20/05/2021,428,3,41,201,242
20/05/2021,344,3,74,303,377
20/05/2021,933,3,0,3,3
20/05/2021,115,3,27,140,167
20/05/2021,616,3,140,367,507
20/05/2021,129,3,71,261,332
20/05/2021,542,3,106,334,440
20/05/2021,662,3,130,508,638
20/05/2021,135,3,142,396,538
21/05/2021,756,3,133,855,988
21/05/2021,115,3,41,188,229
21/05/2021,662,3,219,996,1215
21/05/2021,884,3,7,143,150
21/05/2021,9,3,153,482,635
21/05/2021,344,3,110,516,626
21/05/2021,135,3,173,698,871
21/05/2021,616,3,149,510,659
21/05/2021,933,3,0,5,5
21/05/2021,542,3,125,332,457
21/05/2021,428,3,46,349,395
21/05/2021,129,3,129,609,738
21/05/2021,68,3,110,785,895
21/05/2021,512,3,28,170,198
21/05/2021,474,3,72,325,397
21/05/2021,393,3,51,254,305
21/05/2021,654,3,74,503,577
21/05/2021,15,3,174,670,844
21/05/2021,192,3,80,389,469
21/05/2021,683,3,92,471,563
21/05/2021,162,3,327,1215,1542
21/05/2021,56,3,110,843,953
21/05/2021,251,3,52,241,293
21/05/2021,436,3,54,415,469
21/05/2021,253,3,47,208,255
21/05/2021,597,3,89,687,776
21/05/2021,269,3,57,283,340
21/05/2021,825,3,167,812,979
21/05/2021,186,3,50,174,224
21/05/2021,247,3,135,702,837
21/05/2021,399,3,208,900,1108
21/05/2021,350,3,77,287,364
21/05/2021,462,3,64,469,533
21/05/2021,625,3,77,389,466
21/05/2021,91,3,69,422,491
21/05/2021,435,3,42,250,292
21/05/2021,737,3,37,239,276
21/05/2021,205,3,87,429,516
21/05/2021,631,3,32,123,155
21/05/2021,572,3,133,573,706
21/05/2021,749,3,42,330,372
21/05/2021,533,3,132,527,659
21/05/2021,374,3,63,241,304
21/05/2021,87,3,222,1156,1378
21/05/2021,246,3,182,1188,1370
21/05/2021,168,3,63,261,324
21/05/2021,736,3,38,190,228
21/05/2021,547,3,375,1758,2133
21/05/2021,149,3,92,561,653
21/05/2021,931,3,0,2,2
21/05/2021,673,3,101,438,539
21/05/2021,587,3,23,119,142
21/05/2021,794,3,265,1138,1403
21/05/2021,456,3,91,489,580
21/05/2021,721,3,432,1988,2420
21/05/2021,27,3,232,831,1063
21/05/2021,159,3,169,1145,1314
21/05/2021,746,3,57,207,264
21/05/2021,164,3,82,539,621
21/05/2021,811,3,38,221,259
21/05/2021,770,3,233,1192,1425
21/05/2021,713,3,79,1094,1173
21/05/2021,567,3,114,491,605
21/05/2021,229,3,185,807,992
21/05/2021,561,3,54,221,275
21/05/2021,524,3,134,604,738
21/05/2021,90,3,71,417,488
21/05/2021,411,3,172,1486,1658
21/05/2021,304,3,175,728,903
21/05/2021,330,3,66,423,489
21/05/2021,78,3,343,1760,2103
21/05/2021,212,3,122,668,790
21/05/2021,902,3,122,432,554
21/05/2021,117,3,194,618,812
21/05/2021,493,3,78,260,338
21/05/2021,210,3,91,326,417
21/05/2021,807,3,91,284,375
21/05/2021,338,3,102,534,636
21/05/2021,715,3,202,789,991
21/05/2021,579,3,50,420,470
21/05/2021,322,3,107,449,556
21/05/2021,58,3,203,1807,2010
21/05/2021,218,3,113,631,744
21/05/2021,764,3,32,165,197
21/05/2021,308,3,126,659,785
21/05/2021,509,3,148,879,1027
21/05/2021,403,3,175,825,1000
21/05/2021,472,3,325,1517,1842
21/05/2021,603,3,233,953,1186
21/05/2021,438,3,53,272,325
21/05/2021,276,3,93,379,472
21/05/2021,777,3,131,410,541
21/05/2021,400,3,40,243,283
21/05/2021,895,3,71,236,307
21/05/2021,189,3,60,317,377
21/05/2021,305,3,134,632,766
21/05/2021,897,3,40,193,233
21/05/2021,286,3,57,157,214
21/05/2021,570,3,122,517,639
21/05/2021,423,3,95,1056,1151
21/05/2021,238,3,158,1073,1231
21/05/2021,187,3,45,221,266
21/05/2021,785,3,385,2462,2847
21/05/2021,28,3,70,313,383
21/05/2021,380,3,161,686,847
21/05/2021,696,3,122,588,710
21/05/2021,3,3,51,216,267
21/05/2021,642,3,88,514,602
21/05/2021,422,3,83,416,499
21/05/2021,292,3,133,914,1047
21/05/2021,622,3,204,813,1017
21/05/2021,813,3,78,335,413
21/05/2021,204,3,105,460,565
21/05/2021,760,3,103,776,879
21/05/2021,782,3,54,183,237
21/05/2021,139,3,115,518,633
21/05/2021,518,3,22,115,137
21/05/2021,92,3,87,522,609
21/05/2021,464,3,114,676,790
21/05/2021,202,3,204,1314,1518
21/05/2021,754,3,93,831,924
21/05/2021,72,3,241,1661,1902
21/05/2021,499,3,101,383,484
21/05/2021,97,3,221,956,1177
21/05/2021,610,3,255,1749,2004
21/05/2021,697,3,57,384,441
21/05/2021,601,3,61,374,435
21/05/2021,733,3,56,298,354
21/05/2021,188,3,126,588,714
21/05/2021,636,3,104,427,531
21/05/2021,340,3,108,497,605
21/05/2021,80,3,36,246,282
21/05/2021,870,3,34,171,205
21/05/2021,859,3,16,45,61
21/05/2021,501,3,193,1254,1447
21/05/2021,894,3,108,364,472
21/05/2021,656,3,56,511,567
21/05/2021,355,3,57,328,385
21/05/2021,591,3,117,401,518
21/05/2021,119,3,113,531,644
21/05/2021,231,3,65,347,412
21/05/2021,677,3,56,385,441
21/05/2021,444,3,138,630,768
21/05/2021,448,3,331,1612,1943
21/05/2021,353,3,42,207,249
21/05/2021,809,3,81,289,370
21/05/2021,245,3,60,258,318
21/05/2021,608,3,321,2210,2531
21/05/2021,687,3,128,594,722
21/05/2021,652,3,41,234,275
21/05/2021,904,3,142,731,873
21/05/2021,200,3,34,211,245
21/05/2021,442,3,62,405,467
21/05/2021,507,3,197,1250,1447
21/05/2021,555,3,195,1023,1218
21/05/2021,25,3,88,400,488
21/05/2021,145,3,149,635,784
21/05/2021,792,3,140,520,660
21/05/2021,133,3,25,100,125
21/05/2021,46,3,93,262,355
21/05/2021,581,3,153,558,711
21/05/2021,922,3,0,15,15
21/05/2021,504,3,42,173,215
21/05/2021,537,3,197,847,1044
21/05/2021,858,3,176,1033,1209
21/05/2021,492,3,54,173,227
21/05/2021,883,3,7,129,136
21/05/2021,613,3,34,159,193
21/05/2021,398,3,21,55,76
21/05/2021,903,3,0,12,12
21/05/2021,702,3,86,311,397
21/05/2021,586,3,119,693,812
21/05/2021,93,3,142,772,914
21/05/2021,378,3,67,279,346
21/05/2021,175,3,76,442,518
21/05/2021,795,3,119,497,616
21/05/2021,889,3,0,11,11
21/05/2021,406,3,192,753,945
21/05/2021,69,3,101,534,635
21/05/2021,558,3,60,251,311
21/05/2021,477,3,67,241,308
21/05/2021,767,3,249,1436,1685
21/05/2021,108,3,77,300,377
21/05/2021,250,3,106,311,417
21/05/2021,232,3,99,397,496
21/05/2021,33,3,102,505,607
21/05/2021,885,3,7,137,144
21/05/2021,588,3,103,341,444
21/05/2021,366,3,70,158,228
21/05/2021,480,3,62,234,296
21/05/2021,120,3,141,425,566
21/05/2021,860,3,139,379,518
21/05/2021,429,3,140,743,883
21/05/2021,623,3,160,701,861
21/05/2021,392,3,60,323,383
21/05/2021,177,3,47,239,286
21/05/2021,854,3,222,1087,1309
21/05/2021,274,3,4,41,45
21/05/2021,163,3,77,284,361
21/05/2021,427,3,348,1723,2071
21/05/2021,684,3,124,575,699
21/05/2021,417,3,201,1814,2015
21/05/2021,213,3,115,643,758
21/05/2021,252,3,42,261,303
21/05/2021,138,3,108,511,619
21/05/2021,354,3,3,15,18
21/05/2021,51,3,299,1616,1915
21/05/2021,128,3,77,440,517
21/05/2021,266,3,49,189,238
21/05/2021,875,3,47,212,259
21/05/2021,936,3,23,81,104
21/05/2021,321,3,79,266,345
21/05/2021,836,3,140,1195,1335
21/05/2021,600,3,342,1646,1988
21/05/2021,909,3,1,14,15
21/05/2021,765,3,110,611,721
21/05/2021,751,3,3,50,53
21/05/2021,154,3,139,674,813
21/05/2021,759,3,68,396,464
21/05/2021,879,3,5,35,40
21/05/2021,236,3,65,345,410
21/05/2021,704,3,43,183,226
21/05/2021,18,3,101,556,657
21/05/2021,826,3,166,983,1149
21/05/2021,242,3,169,1120,1289
21/05/2021,488,3,92,344,436
21/05/2021,47,3,120,349,469
21/05/2021,221,3,79,458,537
21/05/2021,775,3,61,356,417
21/05/2021,928,3,1,4,5
21/05/2021,671,3,79,483,562
21/05/2021,722,3,28,145,173
21/05/2021,41,3,92,568,660
21/05/2021,449,3,80,484,564
21/05/2021,793,3,71,514,585
21/05/2021,602,3,310,1309,1619
21/05/2021,842,3,22,24,46
21/05/2021,144,3,104,619,723
21/05/2021,289,3,53,252,305
21/05/2021,604,3,287,1014,1301
21/05/2021,61,3,108,783,891
21/05/2021,124,3,58,306,364
21/05/2021,185,3,69,352,421
21/05/2021,30,3,157,589,746
21/05/2021,850,3,241,804,1045
21/05/2021,536,3,52,289,341
21/05/2021,387,3,126,619,745
21/05/2021,693,3,77,409,486
21/05/2021,367,3,141,798,939
21/05/2021,926,3,39,249,288
21/05/2021,914,3,2,6,8
21/05/2021,908,3,79,695,774
21/05/2021,302,3,105,789,894
21/05/2021,727,3,75,370,445
21/05/2021,874,3,111,422,533
21/05/2021,595,3,50,261,311
21/05/2021,719,3,65,297,362
21/05/2021,577,3,81,619,700
21/05/2021,532,3,439,2292,2731
21/05/2021,44,3,162,527,689
21/05/2021,876,3,0,19,19
21/05/2021,401,3,54,276,330
21/05/2021,296,3,39,185,224
21/05/2021,920,3,1,0,1
21/05/2021,239,3,87,455,542
21/05/2021,790,3,89,623,712
21/05/2021,491,3,181,1126,1307
21/05/2021,416,3,64,468,532
21/05/2021,784,3,268,1645,1913
21/05/2021,522,3,58,390,448
21/05/2021,450,3,106,489,595
21/05/2021,267,3,64,353,417
21/05/2021,666,3,139,616,755
21/05/2021,182,3,80,367,447
21/05/2021,882,3,0,28,28
21/05/2021,446,3,58,351,409
21/05/2021,66,3,90,731,821
21/05/2021,281,3,113,488,601
21/05/2021,707,3,227,771,998
21/05/2021,918,3,0,12,12
21/05/2021,60,3,36,141,177
21/05/2021,418,3,32,155,187
21/05/2021,863,3,69,323,392
21/05/2021,658,3,77,470,547
21/05/2021,900,3,18,38,56
21/05/2021,924,3,2,18,20
21/05/2021,681,3,167,453,620
21/05/2021,383,3,308,1750,2058
21/05/2021,534,3,81,502,583
21/05/2021,752,3,228,1198,1426
21/05/2021,632,3,44,169,213
21/05/2021,235,3,67,408,475
21/05/2021,675,3,84,346,430
21/05/2021,194,3,1,5,6
21/05/2021,635,3,125,792,917
21/05/2021,692,3,107,516,623
21/05/2021,463,3,261,1180,1441
21/05/2021,877,3,0,40,40
21/05/2021,663,3,120,645,765
21/05/2021,453,3,111,494,605
21/05/2021,140,3,79,594,673
21/05/2021,840,3,55,354,409
21/05/2021,457,3,65,270,335
21/05/2021,655,3,168,789,957
21/05/2021,288,3,29,123,152
21/05/2021,328,3,74,419,493
21/05/2021,82,3,193,943,1136
21/05/2021,495,3,76,252,328
21/05/2021,843,3,56,251,307
21/05/2021,892,3,9,22,31
21/05/2021,359,3,153,497,650
21/05/2021,454,3,93,678,771
21/05/2021,261,3,464,2198,2662
21/05/2021,910,3,8,126,134
21/05/2021,835,3,151,587,738
21/05/2021,314,3,49,223,272
21/05/2021,176,3,115,637,752
21/05/2021,434,3,8,31,39
21/05/2021,121,3,326,1467,1793
21/05/2021,32,3,108,411,519
21/05/2021,505,3,41,172,213
21/05/2021,257,3,355,1449,1804
21/05/2021,831,3,104,496,600
21/05/2021,103,3,220,688,908
21/05/2021,277,3,118,477,595
21/05/2021,837,3,132,749,881
21/05/2021,389,3,210,1350,1560
21/05/2021,855,3,133,580,713
21/05/2021,709,3,273,956,1229
21/05/2021,230,3,106,492,598
21/05/2021,799,3,37,124,161
21/05/2021,234,3,27,153,180
21/05/2021,938,3,0,11,11
21/05/2021,49,3,25,111,136
21/05/2021,325,3,66,511,577
21/05/2021,539,3,196,724,920
21/05/2021,521,3,46,239,285
21/05/2021,118,3,111,496,607
21/05/2021,787,3,401,2284,2685
21/05/2021,873,3,165,603,768
21/05/2021,923,3,0,3,3
21/05/2021,284,3,48,249,297
21/05/2021,925,3,0,4,4
21/05/2021,734,3,44,192,236
21/05/2021,364,3,129,385,514
21/05/2021,258,3,451,2093,2544
21/05/2021,6,3,49,223,272
21/05/2021,819,3,113,556,669
21/05/2021,470,3,75,493,568
21/05/2021,50,3,25,111,136
21/05/2021,379,3,104,541,645
21/05/2021,896,3,354,1527,1881
21/05/2021,573,3,88,440,528
21/05/2021,801,3,155,654,809
21/05/2021,23,3,23,83,106
21/05/2021,553,3,61,165,226
21/05/2021,847,3,7,79,86
21/05/2021,849,3,79,771,850
21/05/2021,409,3,28,123,151
21/05/2021,711,3,54,367,421
21/05/2021,780,3,237,1279,1516
21/05/2021,424,3,103,1098,1201
21/05/2021,170,3,122,668,790
21/05/2021,866,3,225,1200,1425
21/05/2021,638,3,159,692,851
21/05/2021,70,3,189,1437,1626
21/05/2021,717,3,65,408,473
21/05/2021,829,3,148,943,1091
21/05/2021,705,3,39,158,197
21/05/2021,11,3,73,385,458
21/05/2021,614,3,49,267,316
21/05/2021,856,3,212,826,1038
21/05/2021,698,3,53,355,408
21/05/2021,913,3,89,658,747
21/05/2021,911,3,107,868,975
21/05/2021,508,3,158,890,1048
21/05/2021,98,3,204,1202,1406
21/05/2021,313,3,46,239,285
21/05/2021,319,3,33,179,212
21/05/2021,55,3,42,285,327
21/05/2021,459,3,101,322,423
21/05/2021,716,3,54,351,405
21/05/2021,181,3,71,348,419
21/05/2021,724,3,336,1558,1894
21/05/2021,329,3,223,1238,1461
21/05/2021,301,3,125,810,935
21/05/2021,891,3,99,389,488
21/05/2021,337,3,36,193,229
21/05/2021,550,3,195,756,951
21/05/2021,299,3,72,252,324
21/05/2021,844,3,41,281,322
21/05/2021,814,3,73,191,264
21/05/2021,808,3,250,1099,1349
21/05/2021,932,3,2,46,48
21/05/2021,617,3,55,258,313
21/05/2021,594,3,150,837,987
21/05/2021,183,3,47,268,315
21/05/2021,451,3,296,1403,1699
21/05/2021,475,3,176,947,1123
21/05/2021,106,3,210,1184,1394
21/05/2021,865,3,25,88,113
21/05/2021,262,3,49,171,220
21/05/2021,519,3,96,473,569
21/05/2021,917,3,6,59,65
21/05/2021,228,3,41,190,231
21/05/2021,193,3,146,628,774
21/05/2021,848,3,113,526,639
21/05/2021,755,3,169,1086,1255
21/05/2021,385,3,120,565,685
21/05/2021,805,3,69,243,312
21/05/2021,34,3,41,249,290
21/05/2021,206,3,2,10,12
21/05/2021,699,3,63,311,374
21/05/2021,285,3,69,358,427
21/05/2021,432,3,83,590,673
21/05/2021,180,3,78,351,429
21/05/2021,220,3,71,435,506
21/05/2021,84,3,246,841,1087
21/05/2021,626,3,52,281,333
21/05/2021,886,3,3,60,63
21/05/2021,143,3,177,1079,1256
21/05/2021,294,3,217,834,1051
21/05/2021,750,3,119,957,1076
21/05/2021,857,3,114,499,613
21/05/2021,76,3,212,1540,1752
21/05/2021,531,3,121,629,750
21/05/2021,386,3,327,2256,2583
21/05/2021,490,3,47,169,216
21/05/2021,158,3,30,210,240
21/05/2021,791,3,77,500,577
21/05/2021,486,3,84,507,591
21/05/2021,256,3,135,676,811
21/05/2021,339,3,132,586,718
21/05/2021,820,3,49,383,432
21/05/2021,732,3,33,234,267
21/05/2021,757,3,194,683,877
21/05/2021,921,3,1,20,21
21/05/2021,203,3,107,486,593
21/05/2021,830,3,385,1815,2200
21/05/2021,643,3,93,572,665
21/05/2021,818,3,86,448,534
21/05/2021,327,3,215,1137,1352
21/05/2021,96,3,56,340,396
21/05/2021,441,3,255,1148,1403
21/05/2021,410,3,152,1304,1456
21/05/2021,2,3,50,221,271
21/05/2021,53,3,108,465,573
21/05/2021,520,3,68,229,297
21/05/2021,723,3,140,582,722
21/05/2021,99,3,298,1574,1872
21/05/2021,88,3,63,339,402
21/05/2021,19,3,156,772,928
21/05/2021,334,3,301,1026,1327
21/05/2021,101,3,81,513,594
21/05/2021,466,3,112,426,538
21/05/2021,485,3,92,467,559
21/05/2021,803,3,118,475,593
21/05/2021,460,3,68,381,449
21/05/2021,868,3,351,1642,1993
21/05/2021,64,3,65,276,341
21/05/2021,738,3,86,485,571
21/05/2021,890,3,83,523,606
21/05/2021,172,3,100,646,746
21/05/2021,815,3,435,2056,2491
21/05/2021,255,3,20,17,37
21/05/2021,420,3,226,833,1059
21/05/2021,271,3,54,332,386
21/05/2021,151,3,57,208,265
21/05/2021,190,3,101,487,588
21/05/2021,817,3,125,582,707
21/05/2021,689,3,119,489,608
21/05/2021,593,3,284,1488,1772
21/05/2021,939,3,1,13,14
21/05/2021,131,3,104,515,619
21/05/2021,365,3,87,320,407
21/05/2021,243,3,181,1192,1373
21/05/2021,526,3,77,270,347
21/05/2021,620,3,0,1,1
21/05/2021,778,3,167,621,788
21/05/2021,342,3,77,297,374
21/05/2021,259,3,334,1363,1697
21/05/2021,184,3,53,264,317
21/05/2021,263,3,81,332,413
21/05/2021,583,3,35,207,242
21/05/2021,369,3,229,1103,1332
21/05/2021,841,3,12,170,182
21/05/2021,634,3,70,381,451
21/05/2021,748,3,66,241,307
21/05/2021,440,3,126,779,905
21/05/2021,381,3,12,12,24
21/05/2021,233,3,168,504,672
21/05/2021,216,3,89,318,407
21/05/2021,685,3,76,401,477
21/05/2021,511,3,41,383,424
21/05/2021,86,3,70,357,427
21/05/2021,731,3,43,271,314
21/05/2021,487,3,75,421,496
21/05/2021,624,3,30,170,200
21/05/2021,703,3,78,327,405
21/05/2021,878,3,4,32,36
21/05/2021,660,3,62,246,308
21/05/2021,391,3,220,1182,1402
21/05/2021,823,3,67,217,284
21/05/2021,701,3,90,283,373
21/05/2021,1,3,48,213,261
21/05/2021,514,3,24,172,196
21/05/2021,371,3,100,465,565
21/05/2021,265,3,59,213,272
21/05/2021,111,3,227,936,1163
21/05/2021,134,3,167,644,811
21/05/2021,39,3,113,652,765
21/05/2021,102,3,184,715,899
21/05/2021,45,3,46,296,342
21/05/2021,510,3,170,1158,1328
21/05/2021,743,3,43,202,245
21/05/2021,543,3,369,1763,2132
21/05/2021,582,3,345,1799,2144
21/05/2021,706,3,268,1031,1299
21/05/2021,412,3,68,772,840
21/05/2021,341,3,290,1338,1628
21/05/2021,126,3,142,697,839
21/05/2021,930,3,6,20,26
21/05/2021,199,3,30,168,198
21/05/2021,272,3,126,580,706
21/05/2021,479,3,63,249,312
21/05/2021,104,3,177,895,1072
21/05/2021,402,3,165,793,958
21/05/2021,408,3,184,1578,1762
21/05/2021,688,3,88,417,505
21/05/2021,934,3,2,27,29
21/05/2021,535,3,83,441,524
21/05/2021,248,3,61,277,338
21/05/2021,264,3,44,190,234
21/05/2021,83,3,469,2214,2683
21/05/2021,901,3,6,22,28
21/05/2021,804,3,164,980,1144
21/05/2021,899,3,246,1359,1605
21/05/2021,112,3,66,274,340
21/05/2021,646,3,67,477,544
21/05/2021,774,3,91,358,449
21/05/2021,157,3,129,452,581
21/05/2021,497,3,171,1116,1287
21/05/2021,941,3,1,1,2
21/05/2021,7,3,48,216,264
21/05/2021,196,3,114,518,632
21/05/2021,298,3,144,974,1118
21/05/2021,798,3,220,778,998
21/05/2021,125,3,126,407,533
21/05/2021,166,3,41,401,442
21/05/2021,585,3,222,823,1045
21/05/2021,123,3,70,346,416
21/05/2021,105,3,153,725,878
21/05/2021,12,3,32,127,159
21/05/2021,467,3,67,473,540
21/05/2021,142,3,71,228,299
21/05/2021,862,3,141,627,768
21/05/2021,209,3,16,140,156
21/05/2021,527,3,83,246,329
21/05/2021,173,3,88,311,399
21/05/2021,167,3,140,753,893
21/05/2021,390,3,210,1391,1601
21/05/2021,881,3,4,33,37
21/05/2021,529,3,97,337,434
21/05/2021,739,3,44,241,285
21/05/2021,394,3,54,298,352
21/05/2021,433,3,319,1464,1783
21/05/2021,496,3,26,172,198
21/05/2021,816,3,239,1083,1322
21/05/2021,37,3,57,233,290
21/05/2021,95,3,255,1269,1524
21/05/2021,195,3,58,251,309
21/05/2021,443,3,77,512,589
21/05/2021,244,3,78,379,457
21/05/2021,473,3,31,246,277
21/05/2021,59,3,87,454,541
21/05/2021,802,3,220,1617,1837
21/05/2021,309,3,32,144,176
21/05/2021,161,3,358,1458,1816
21/05/2021,373,3,100,398,498
21/05/2021,575,3,31,154,185
21/05/2021,538,3,102,546,648
21/05/2021,113,3,54,267,321
21/05/2021,650,3,80,420,500
21/05/2021,839,3,90,422,512
21/05/2021,563,3,100,384,484
21/05/2021,137,3,113,574,687
21/05/2021,551,3,209,929,1138
21/05/2021,430,3,76,427,503
21/05/2021,758,3,118,533,651
21/05/2021,872,3,98,277,375
21/05/2021,569,3,110,470,580
21/05/2021,797,3,149,685,834
21/05/2021,114,3,150,539,689
21/05/2021,311,3,152,687,839
21/05/2021,824,3,258,1149,1407
21/05/2021,280,3,42,114,156
21/05/2021,356,3,247,1294,1541
21/05/2021,79,3,120,398,518
21/05/2021,566,3,47,196,243
21/05/2021,333,3,76,872,948
21/05/2021,465,3,64,444,508
21/05/2021,360,3,66,464,530
21/05/2021,500,3,22,151,173
21/05/2021,217,3,110,608,718
21/05/2021,846,3,9,95,104
21/05/2021,43,3,116,674,790
21/05/2021,293,3,69,562,631
21/05/2021,712,3,58,378,436
21/05/2021,783,3,177,1021,1198
21/05/2021,637,3,233,1194,1427
21/05/2021,907,3,214,972,1186
21/05/2021,556,3,242,1170,1412
21/05/2021,633,3,77,431,508
21/05/2021,75,3,221,1583,1804
21/05/2021,349,3,76,350,426
21/05/2021,215,3,56,219,275
21/05/2021,219,3,72,280,352
21/05/2021,77,3,197,1369,1566
21/05/2021,619,3,96,409,505
21/05/2021,323,3,70,289,359
21/05/2021,384,3,107,542,649
21/05/2021,564,3,165,654,819
21/05/2021,544,3,166,645,811
21/05/2021,887,3,6,20,26
21/05/2021,214,3,112,628,740
21/05/2021,160,3,18,67,85
21/05/2021,225,3,124,635,759
21/05/2021,845,3,72,332,404
21/05/2021,21,3,119,619,738
21/05/2021,725,3,67,225,292
21/05/2021,880,3,2,29,31
21/05/2021,208,3,41,236,277
21/05/2021,827,3,216,843,1059
21/05/2021,94,3,0,3,3
21/05/2021,618,3,83,390,473
21/05/2021,346,3,33,199,232
21/05/2021,664,3,160,742,902
21/05/2021,363,3,145,386,531
21/05/2021,31,3,64,475,539
21/05/2021,483,3,119,603,722
21/05/2021,776,3,82,571,653
21/05/2021,888,3,6,66,72
21/05/2021,607,3,295,2049,2344
21/05/2021,287,3,154,982,1136
21/05/2021,571,3,91,426,517
21/05/2021,864,3,48,212,260
21/05/2021,198,3,169,501,670
21/05/2021,361,3,126,377,503
21/05/2021,153,3,142,670,812
21/05/2021,413,3,194,1700,1894
21/05/2021,42,3,61,329,390
21/05/2021,17,3,59,313,372
21/05/2021,332,3,89,370,459
21/05/2021,589,3,112,371,483
21/05/2021,648,3,87,447,534
21/05/2021,147,3,99,544,643
21/05/2021,370,3,138,781,919
21/05/2021,745,3,67,305,372
21/05/2021,100,3,311,1635,1946
21/05/2021,852,3,183,556,739
21/05/2021,615,3,127,603,730
21/05/2021,700,3,53,371,424
21/05/2021,278,3,69,311,380
21/05/2021,122,3,142,458,600
21/05/2021,71,3,83,577,660
21/05/2021,89,3,167,840,1007
21/05/2021,171,3,9,41,50
21/05/2021,710,3,57,344,401
21/05/2021,753,3,126,1022,1148
21/05/2021,528,3,66,250,316
21/05/2021,237,3,148,952,1100
21/05/2021,489,3,15,48,63
21/05/2021,178,3,114,622,736
21/05/2021,279,3,117,505,622
21/05/2021,735,3,50,241,291
21/05/2021,788,3,370,2221,2591
21/05/2021,318,3,196,914,1110
21/05/2021,786,3,257,1671,1928
21/05/2021,565,3,237,1141,1378
21/05/2021,155,3,151,917,1068
21/05/2021,54,3,112,384,496
21/05/2021,929,3,0,1,1
21/05/2021,458,3,186,728,914
21/05/2021,628,3,95,339,434
21/05/2021,478,3,58,69,127
21/05/2021,300,3,127,933,1060
21/05/2021,249,3,192,1198,1390
21/05/2021,851,3,104,601,705
21/05/2021,853,3,62,268,330
21/05/2021,397,3,49,237,286
21/05/2021,48,3,27,114,141
21/05/2021,833,3,45,231,276
21/05/2021,670,3,416,2046,2462
21/05/2021,557,3,73,329,402
21/05/2021,898,3,67,179,246
21/05/2021,768,3,164,1269,1433
21/05/2021,540,3,225,850,1075
21/05/2021,348,3,33,199,232
21/05/2021,312,3,107,448,555
21/05/2021,421,3,194,670,864
21/05/2021,694,3,114,557,671
21/05/2021,425,3,91,638,729
21/05/2021,580,3,68,449,517
21/05/2021,469,3,64,461,525
21/05/2021,680,3,62,255,317
21/05/2021,260,3,480,2238,2718
21/05/2021,661,3,180,822,1002
21/05/2021,517,3,54,280,334
21/05/2021,24,3,21,80,101
21/05/2021,461,3,137,782,919
21/05/2021,578,3,28,129,157
21/05/2021,651,3,101,508,609
21/05/2021,447,3,58,290,348
21/05/2021,800,3,138,416,554
21/05/2021,303,3,123,660,783
21/05/2021,761,3,50,305,355
21/05/2021,546,3,233,891,1124
21/05/2021,730,3,78,473,551
21/05/2021,471,3,93,371,464
21/05/2021,682,3,55,204,259
21/05/2021,268,3,203,959,1162
21/05/2021,22,3,117,528,645
21/05/2021,8,3,54,391,445
21/05/2021,503,3,156,1023,1179
21/05/2021,273,3,76,453,529
21/05/2021,605,3,263,1096,1359
21/05/2021,640,3,76,479,555
21/05/2021,336,3,282,1250,1532
21/05/2021,36,3,72,448,520
21/05/2021,13,3,78,333,411
21/05/2021,395,3,53,292,345
21/05/2021,377,3,133,530,663
21/05/2021,405,3,24,104,128
21/05/2021,283,3,88,477,565
21/05/2021,599,3,405,1969,2374
21/05/2021,468,3,64,351,415
21/05/2021,326,3,39,185,224
21/05/2021,127,3,75,414,489
21/05/2021,861,3,122,459,581
21/05/2021,227,3,41,213,254
21/05/2021,481,3,90,432,522
21/05/2021,772,3,182,660,842
21/05/2021,52,3,160,620,780
21/05/2021,426,3,65,293,358
21/05/2021,222,3,85,417,502
21/05/2021,452,3,85,514,599
21/05/2021,612,3,162,949,1111
21/05/2021,310,3,355,2093,2448
21/05/2021,742,3,98,515,613
21/05/2021,906,3,11,16,27
21/05/2021,691,3,94,459,553
21/05/2021,275,3,158,657,815
21/05/2021,548,3,80,340,420
21/05/2021,169,3,100,582,682
21/05/2021,315,3,13,100,113
21/05/2021,649,3,74,234,308
21/05/2021,871,3,177,827,1004
21/05/2021,720,3,62,341,403
21/05/2021,726,3,43,160,203
21/05/2021,297,3,83,678,761
21/05/2021,747,3,88,381,469
21/05/2021,584,3,271,1296,1567
21/05/2021,728,3,112,754,866
21/05/2021,506,3,188,1202,1390
21/05/2021,686,3,74,469,543
21/05/2021,484,3,84,400,484
21/05/2021,404,3,249,1374,1623
21/05/2021,838,3,108,471,579
21/05/2021,647,3,68,341,409
21/05/2021,352,3,176,549,725
21/05/2021,110,3,84,438,522
21/05/2021,362,3,135,384,519
21/05/2021,832,3,81,327,408
21/05/2021,136,3,165,660,825
21/05/2021,382,3,0,1,1
21/05/2021,574,3,104,523,627
21/05/2021,439,3,63,364,427
21/05/2021,431,3,85,397,482
21/05/2021,714,3,161,737,898
21/05/2021,598,3,401,1897,2298
21/05/2021,201,3,49,252,301
21/05/2021,905,3,2,3,5
21/05/2021,156,3,150,605,755
21/05/2021,179,3,76,426,502
21/05/2021,414,3,159,1335,1494
21/05/2021,828,3,161,585,746
21/05/2021,562,3,33,127,160
21/05/2021,641,3,85,529,614
21/05/2021,741,3,40,251,291
21/05/2021,358,3,273,1460,1733
21/05/2021,494,3,96,435,531
21/05/2021,621,3,45,257,302
21/05/2021,343,3,51,220,271
21/05/2021,445,3,86,506,592
21/05/2021,653,3,47,187,234
21/05/2021,455,3,57,315,372
21/05/2021,81,3,35,207,242
21/05/2021,606,3,173,774,947
21/05/2021,351,3,352,1720,2072
21/05/2021,645,3,64,451,515
21/05/2021,388,3,207,1156,1363
21/05/2021,331,3,91,396,487
21/05/2021,771,3,140,1207,1347
21/05/2021,116,3,77,325,402
21/05/2021,773,3,61,311,372
21/05/2021,552,3,197,765,962
21/05/2021,291,3,101,796,897
21/05/2021,376,3,23,85,108
21/05/2021,554,3,55,231,286
21/05/2021,197,3,123,579,702
21/05/2021,674,3,93,524,617
21/05/2021,665,3,89,541,630
21/05/2021,627,3,43,251,294
21/05/2021,639,3,67,332,399
21/05/2021,919,3,145,531,676
21/05/2021,85,3,434,1986,2420
21/05/2021,372,3,265,1037,1302
21/05/2021,295,3,38,252,290
21/05/2021,35,3,84,558,642
21/05/2021,307,3,177,804,981
21/05/2021,659,3,87,481,568
21/05/2021,270,3,78,296,374
21/05/2021,174,3,56,297,353
21/05/2021,668,3,45,219,264
21/05/2021,5,3,49,214,263
21/05/2021,38,3,111,614,725
21/05/2021,559,3,231,1153,1384
21/05/2021,290,3,123,847,970
21/05/2021,107,3,298,1475,1773
21/05/2021,316,3,60,386,446
21/05/2021,821,3,149,635,784
21/05/2021,530,3,54,194,248
21/05/2021,476,3,78,277,355
21/05/2021,407,3,163,1425,1588
21/05/2021,357,3,257,1411,1668
21/05/2021,679,3,58,211,269
21/05/2021,779,3,103,333,436
21/05/2021,789,3,163,572,735
21/05/2021,20,3,79,192,271
21/05/2021,254,3,47,231,278
21/05/2021,629,3,68,487,555
21/05/2021,65,3,101,765,866
21/05/2021,867,3,66,257,323
21/05/2021,347,3,292,1013,1305
21/05/2021,335,3,65,327,392
21/05/2021,592,3,138,913,1051
21/05/2021,224,3,41,196,237
21/05/2021,590,3,0,4,4
21/05/2021,396,3,53,232,285
21/05/2021,419,3,203,867,1070
21/05/2021,781,3,162,1142,1304
21/05/2021,207,3,52,340,392
21/05/2021,515,3,58,208,266
21/05/2021,676,3,65,205,270
21/05/2021,130,3,198,792,990
21/05/2021,282,3,67,377,444
21/05/2021,869,3,126,375,501
21/05/2021,525,3,157,796,953
21/05/2021,226,3,119,448,567
21/05/2021,657,3,191,694,885
21/05/2021,498,3,65,211,276
21/05/2021,437,3,118,647,765
21/05/2021,211,3,113,627,740
21/05/2021,57,3,108,754,862
21/05/2021,4,3,74,333,407
21/05/2021,67,3,85,625,710
21/05/2021,560,3,211,1079,1290
21/05/2021,368,3,142,819,961
21/05/2021,915,3,2,32,34
21/05/2021,152,3,107,588,695
21/05/2021,669,3,97,570,667
21/05/2021,806,3,179,1398,1577
21/05/2021,26,3,111,616,727
21/05/2021,317,3,190,989,1179
21/05/2021,812,3,121,513,634
21/05/2021,810,3,76,419,495
21/05/2021,63,3,72,275,347
21/05/2021,240,3,163,1103,1266
21/05/2021,513,3,48,161,209
21/05/2021,576,3,18,103,121
21/05/2021,345,3,102,292,394
21/05/2021,148,3,41,208,249
21/05/2021,146,3,201,1197,1398
22/05/2021,317,3,254,1288,1542
22/05/2021,345,3,136,458,594
22/05/2021,810,3,90,520,610
22/05/2021,812,3,133,630,763
22/05/2021,26,3,171,991,1162
22/05/2021,63,3,83,369,452
22/05/2021,513,3,60,247,307
22/05/2021,148,3,50,235,285
22/05/2021,576,3,14,149,163
22/05/2021,146,3,240,1587,1827
22/05/2021,240,3,206,1508,1714
22/05/2021,466,3,131,607,738
22/05/2021,723,3,147,731,878
22/05/2021,520,3,71,299,370
22/05/2021,890,3,93,766,859
22/05/2021,485,3,131,680,811
22/05/2021,88,3,80,473,553
22/05/2021,64,3,78,459,537
22/05/2021,101,3,113,744,857
22/05/2021,99,3,334,2021,2355
22/05/2021,868,3,400,2004,2404
22/05/2021,815,3,442,2648,3090
22/05/2021,803,3,169,920,1089
22/05/2021,334,3,320,1286,1606
22/05/2021,19,3,168,1045,1213
22/05/2021,460,3,90,612,702
22/05/2021,738,3,108,627,735
22/05/2021,172,3,129,850,979
22/05/2021,793,3,88,663,751
22/05/2021,928,3,1,5,6
22/05/2021,41,3,89,754,843
22/05/2021,602,3,364,1665,2029
22/05/2021,775,3,91,531,622
22/05/2021,722,3,38,178,216
22/05/2021,449,3,100,628,728
22/05/2021,671,3,80,642,722
22/05/2021,286,3,62,210,272
22/05/2021,696,3,165,816,981
22/05/2021,305,3,151,774,925
22/05/2021,380,3,168,752,920
22/05/2021,189,3,73,442,515
22/05/2021,187,3,75,348,423
22/05/2021,28,3,84,412,496
22/05/2021,895,3,65,183,248
22/05/2021,276,3,116,495,611
22/05/2021,238,3,208,1466,1674
22/05/2021,423,3,119,1442,1561
22/05/2021,785,3,467,3274,3741
22/05/2021,400,3,53,350,403
22/05/2021,570,3,177,817,994
22/05/2021,777,3,163,670,833
22/05/2021,897,3,43,236,279
22/05/2021,435,3,62,414,476
22/05/2021,205,3,90,640,730
22/05/2021,246,3,227,1629,1856
22/05/2021,572,3,173,735,908
22/05/2021,737,3,40,387,427
22/05/2021,91,3,87,618,705
22/05/2021,625,3,138,613,751
22/05/2021,749,3,61,424,485
22/05/2021,87,3,295,1733,2028
22/05/2021,631,3,39,244,283
22/05/2021,374,3,70,312,382
22/05/2021,533,3,153,768,921
22/05/2021,115,3,52,244,296
22/05/2021,756,3,99,585,684
22/05/2021,68,3,135,1174,1309
22/05/2021,135,3,171,778,949
22/05/2021,344,3,98,680,778
22/05/2021,884,3,10,171,181
22/05/2021,428,3,79,556,635
22/05/2021,542,3,94,207,301
22/05/2021,9,3,148,587,735
22/05/2021,662,3,329,1557,1886
22/05/2021,129,3,182,854,1036
22/05/2021,616,3,162,769,931
22/05/2021,933,3,0,4,4
22/05/2021,597,3,161,1383,1544
22/05/2021,15,3,192,724,916
22/05/2021,512,3,37,300,337
22/05/2021,56,3,137,1123,1260
22/05/2021,436,3,80,534,614
22/05/2021,474,3,122,541,663
22/05/2021,462,3,90,604,694
22/05/2021,393,3,79,424,503
22/05/2021,683,3,112,662,774
22/05/2021,247,3,125,955,1080
22/05/2021,654,3,92,667,759
22/05/2021,192,3,140,588,728
22/05/2021,399,3,229,1154,1383
22/05/2021,269,3,65,355,420
22/05/2021,253,3,62,299,361
22/05/2021,251,3,75,319,394
22/05/2021,825,3,232,1202,1434
22/05/2021,350,3,86,433,519
22/05/2021,162,3,264,1192,1456
22/05/2021,186,3,49,238,287
22/05/2021,603,3,239,1206,1445
22/05/2021,308,3,178,1028,1206
22/05/2021,218,3,109,810,919
22/05/2021,579,3,69,591,660
22/05/2021,715,3,251,1117,1368
22/05/2021,764,3,40,257,297
22/05/2021,509,3,209,1419,1628
22/05/2021,403,3,208,1066,1274
22/05/2021,58,3,190,1903,2093
22/05/2021,322,3,117,656,773
22/05/2021,438,3,69,358,427
22/05/2021,472,3,455,2209,2664
22/05/2021,90,3,116,658,774
22/05/2021,673,3,119,521,640
22/05/2021,770,3,277,1597,1874
22/05/2021,713,3,98,1409,1507
22/05/2021,937,3,0,1,1
22/05/2021,587,3,32,199,231
22/05/2021,159,3,220,1559,1779
22/05/2021,149,3,132,777,909
22/05/2021,456,3,91,530,621
22/05/2021,168,3,65,308,373
22/05/2021,547,3,385,1887,2272
22/05/2021,524,3,156,756,912
22/05/2021,736,3,38,286,324
22/05/2021,567,3,114,449,563
22/05/2021,27,3,267,1048,1315
22/05/2021,794,3,337,1630,1967
22/05/2021,746,3,75,306,381
22/05/2021,811,3,54,304,358
22/05/2021,229,3,216,1150,1366
22/05/2021,561,3,66,325,391
22/05/2021,931,3,0,2,2
22/05/2021,164,3,119,812,931
22/05/2021,721,3,446,2416,2862
22/05/2021,807,3,123,479,602
22/05/2021,338,3,108,698,806
22/05/2021,330,3,88,559,647
22/05/2021,212,3,117,877,994
22/05/2021,78,3,350,2010,2360
22/05/2021,411,3,233,2401,2634
22/05/2021,210,3,74,302,376
22/05/2021,902,3,124,523,647
22/05/2021,493,3,82,334,416
22/05/2021,304,3,220,1022,1242
22/05/2021,117,3,237,860,1097
22/05/2021,759,3,79,609,688
22/05/2021,879,3,5,57,62
22/05/2021,765,3,165,812,977
22/05/2021,488,3,84,333,417
22/05/2021,242,3,214,1545,1759
22/05/2021,18,3,122,750,872
22/05/2021,704,3,51,297,348
22/05/2021,236,3,68,512,580
22/05/2021,154,3,163,918,1081
22/05/2021,47,3,140,534,674
22/05/2021,826,3,186,915,1101
22/05/2021,221,3,105,639,744
22/05/2021,751,3,5,60,65
22/05/2021,591,3,123,470,593
22/05/2021,442,3,91,595,686
22/05/2021,507,3,265,1935,2200
22/05/2021,245,3,69,280,349
22/05/2021,200,3,51,346,397
22/05/2021,119,3,162,782,944
22/05/2021,687,3,152,756,908
22/05/2021,555,3,262,1327,1589
22/05/2021,904,3,208,1099,1307
22/05/2021,46,3,113,436,549
22/05/2021,231,3,63,307,370
22/05/2021,353,3,54,379,433
22/05/2021,809,3,82,415,497
22/05/2021,792,3,162,653,815
22/05/2021,145,3,188,947,1135
22/05/2021,25,3,90,526,616
22/05/2021,608,3,389,2926,3315
22/05/2021,581,3,159,758,917
22/05/2021,448,3,465,2236,2701
22/05/2021,133,3,34,163,197
22/05/2021,652,3,67,519,586
22/05/2021,677,3,53,582,635
22/05/2021,922,3,0,13,13
22/05/2021,444,3,121,564,685
22/05/2021,202,3,233,1686,1919
22/05/2021,92,3,117,861,978
22/05/2021,3,3,44,241,285
22/05/2021,292,3,163,1213,1376
22/05/2021,760,3,135,1065,1200
22/05/2021,813,3,114,476,590
22/05/2021,422,3,116,626,742
22/05/2021,782,3,125,762,887
22/05/2021,204,3,110,629,739
22/05/2021,754,3,140,1211,1351
22/05/2021,642,3,141,766,907
22/05/2021,622,3,234,1043,1277
22/05/2021,464,3,165,942,1107
22/05/2021,518,3,16,78,94
22/05/2021,72,3,287,2149,2436
22/05/2021,139,3,158,734,892
22/05/2021,80,3,61,397,458
22/05/2021,601,3,78,552,630
22/05/2021,188,3,149,738,887
22/05/2021,501,3,257,1829,2086
22/05/2021,894,3,128,454,582
22/05/2021,636,3,145,708,853
22/05/2021,697,3,69,552,621
22/05/2021,355,3,77,509,586
22/05/2021,656,3,66,714,780
22/05/2021,859,3,18,75,93
22/05/2021,499,3,151,731,882
22/05/2021,610,3,305,2207,2512
22/05/2021,97,3,275,1223,1498
22/05/2021,340,3,101,649,750
22/05/2021,733,3,78,481,559
22/05/2021,870,3,39,212,251
22/05/2021,138,3,146,668,814
22/05/2021,51,3,314,1993,2307
22/05/2021,936,3,21,117,138
22/05/2021,128,3,109,634,743
22/05/2021,909,3,1,21,22
22/05/2021,354,3,8,16,24
22/05/2021,252,3,53,328,381
22/05/2021,213,3,104,705,809
22/05/2021,427,3,477,2420,2897
22/05/2021,163,3,113,574,687
22/05/2021,875,3,57,274,331
22/05/2021,321,3,89,407,496
22/05/2021,417,3,236,2424,2660
22/05/2021,266,3,50,271,321
22/05/2021,836,3,176,1823,1999
22/05/2021,600,3,302,1489,1791
22/05/2021,684,3,149,755,904
22/05/2021,702,3,103,407,510
22/05/2021,858,3,229,1266,1495
22/05/2021,93,3,140,777,917
22/05/2021,477,3,81,346,427
22/05/2021,69,3,118,678,796
22/05/2021,406,3,238,1019,1257
22/05/2021,613,3,47,188,235
22/05/2021,537,3,237,1233,1470
22/05/2021,504,3,55,266,321
22/05/2021,175,3,128,802,930
22/05/2021,492,3,60,234,294
22/05/2021,889,3,1,40,41
22/05/2021,883,3,11,146,157
22/05/2021,586,3,106,759,865
22/05/2021,795,3,126,627,753
22/05/2021,398,3,35,85,120
22/05/2021,378,3,84,383,467
22/05/2021,558,3,80,361,441
22/05/2021,903,3,0,10,10
22/05/2021,120,3,165,622,787
22/05/2021,767,3,280,1704,1984
22/05/2021,366,3,71,197,268
22/05/2021,480,3,64,309,373
22/05/2021,885,3,10,151,161
22/05/2021,392,3,96,465,561
22/05/2021,860,3,170,567,737
22/05/2021,232,3,92,507,599
22/05/2021,108,3,110,540,650
22/05/2021,274,3,2,43,45
22/05/2021,588,3,79,181,260
22/05/2021,623,3,233,1059,1292
22/05/2021,250,3,103,357,460
22/05/2021,33,3,145,678,823
22/05/2021,854,3,273,1530,1803
22/05/2021,177,3,77,399,476
22/05/2021,429,3,131,734,865
22/05/2021,486,3,101,716,817
22/05/2021,386,3,438,3202,3640
22/05/2021,256,3,202,1029,1231
22/05/2021,203,3,102,681,783
22/05/2021,441,3,324,1574,1898
22/05/2021,327,3,246,1572,1818
22/05/2021,2,3,44,243,287
22/05/2021,158,3,37,297,334
22/05/2021,818,3,92,449,541
22/05/2021,96,3,67,494,561
22/05/2021,643,3,149,843,992
22/05/2021,531,3,131,824,955
22/05/2021,339,3,105,576,681
22/05/2021,757,3,203,794,997
22/05/2021,830,3,399,2050,2449
22/05/2021,791,3,92,711,803
22/05/2021,53,3,106,516,622
22/05/2021,820,3,61,532,593
22/05/2021,490,3,59,230,289
22/05/2021,410,3,141,1435,1576
22/05/2021,732,3,58,388,446
22/05/2021,921,3,0,15,15
22/05/2021,261,3,465,2510,2975
22/05/2021,359,3,166,619,785
22/05/2021,328,3,84,516,600
22/05/2021,288,3,31,134,165
22/05/2021,892,3,8,30,38
22/05/2021,454,3,131,893,1024
22/05/2021,910,3,11,150,161
22/05/2021,843,3,77,401,478
22/05/2021,82,3,243,1300,1543
22/05/2021,495,3,96,333,429
22/05/2021,595,3,80,408,488
22/05/2021,719,3,83,469,552
22/05/2021,532,3,463,2784,3247
22/05/2021,874,3,100,492,592
22/05/2021,876,3,0,18,18
22/05/2021,44,3,165,513,678
22/05/2021,577,3,106,906,1012
22/05/2021,185,3,84,499,583
22/05/2021,30,3,168,676,844
22/05/2021,604,3,311,1299,1610
22/05/2021,850,3,142,409,551
22/05/2021,842,3,22,30,52
22/05/2021,289,3,57,327,384
22/05/2021,124,3,72,397,469
22/05/2021,144,3,115,798,913
22/05/2021,61,3,122,1147,1269
22/05/2021,536,3,99,475,574
22/05/2021,914,3,0,4,4
22/05/2021,367,3,175,1153,1328
22/05/2021,387,3,182,818,1000
22/05/2021,302,3,136,1076,1212
22/05/2021,693,3,108,603,711
22/05/2021,908,3,99,1105,1204
22/05/2021,727,3,106,458,564
22/05/2021,926,3,72,647,719
22/05/2021,655,3,242,1044,1286
22/05/2021,635,3,153,1101,1254
22/05/2021,463,3,348,1652,2000
22/05/2021,840,3,72,468,540
22/05/2021,453,3,137,688,825
22/05/2021,692,3,121,598,719
22/05/2021,663,3,184,925,1109
22/05/2021,877,3,1,59,60
22/05/2021,140,3,143,1261,1404
22/05/2021,457,3,66,348,414
22/05/2021,446,3,76,461,537
22/05/2021,522,3,81,559,640
22/05/2021,66,3,111,1078,1189
22/05/2021,882,3,1,33,34
22/05/2021,296,3,46,266,312
22/05/2021,239,3,115,620,735
22/05/2021,450,3,110,566,676
22/05/2021,491,3,226,1583,1809
22/05/2021,267,3,68,433,501
22/05/2021,920,3,1,3,4
22/05/2021,401,3,65,324,389
22/05/2021,784,3,304,2053,2357
22/05/2021,281,3,154,748,902
22/05/2021,416,3,55,623,678
22/05/2021,666,3,149,780,929
22/05/2021,790,3,114,819,933
22/05/2021,707,3,235,815,1050
22/05/2021,182,3,100,504,604
22/05/2021,675,3,125,547,672
22/05/2021,918,3,1,29,30
22/05/2021,863,3,79,449,528
22/05/2021,383,3,345,2249,2594
22/05/2021,632,3,63,288,351
22/05/2021,418,3,30,166,196
22/05/2021,60,3,37,199,236
22/05/2021,658,3,71,537,608
22/05/2021,900,3,17,48,65
22/05/2021,235,3,94,536,630
22/05/2021,681,3,151,497,648
22/05/2021,534,3,103,727,830
22/05/2021,194,3,2,4,6
22/05/2021,924,3,1,21,22
22/05/2021,752,3,264,1572,1836
22/05/2021,180,3,94,458,552
22/05/2021,886,3,2,78,80
22/05/2021,294,3,258,1333,1591
22/05/2021,143,3,203,1384,1587
22/05/2021,385,3,151,744,895
22/05/2021,285,3,117,534,651
22/05/2021,84,3,195,1050,1245
22/05/2021,750,3,116,934,1050
22/05/2021,699,3,74,389,463
22/05/2021,34,3,61,370,431
22/05/2021,857,3,152,644,796
22/05/2021,220,3,97,622,719
22/05/2021,206,3,1,11,12
22/05/2021,432,3,118,775,893
22/05/2021,626,3,74,482,556
22/05/2021,76,3,263,2011,2274
22/05/2021,805,3,80,332,412
22/05/2021,847,3,6,93,99
22/05/2021,573,3,103,486,589
22/05/2021,50,3,41,182,223
22/05/2021,801,3,137,591,728
22/05/2021,553,3,71,221,292
22/05/2021,849,3,115,1110,1225
22/05/2021,896,3,357,1523,1880
22/05/2021,470,3,80,627,707
22/05/2021,379,3,115,711,826
22/05/2021,23,3,23,106,129
22/05/2021,819,3,118,631,749
22/05/2021,835,3,170,782,952
22/05/2021,103,3,208,583,791
22/05/2021,505,3,52,278,330
22/05/2021,257,3,381,1956,2337
22/05/2021,434,3,7,40,47
22/05/2021,314,3,75,364,439
22/05/2021,837,3,202,1064,1266
22/05/2021,32,3,106,529,635
22/05/2021,831,3,101,552,653
22/05/2021,709,3,288,1105,1393
22/05/2021,176,3,172,976,1148
22/05/2021,121,3,326,1545,1871
22/05/2021,855,3,159,767,926
22/05/2021,277,3,146,674,820
22/05/2021,389,3,331,2235,2566
22/05/2021,364,3,128,469,597
22/05/2021,521,3,61,324,385
22/05/2021,325,3,88,760,848
22/05/2021,118,3,161,704,865
22/05/2021,230,3,155,751,906
22/05/2021,258,3,474,2509,2983
22/05/2021,234,3,41,249,290
22/05/2021,539,3,198,967,1165
22/05/2021,925,3,0,7,7
22/05/2021,799,3,55,161,216
22/05/2021,923,3,1,3,4
22/05/2021,6,3,43,246,289
22/05/2021,49,3,39,174,213
22/05/2021,734,3,41,169,210
22/05/2021,873,3,175,885,1060
22/05/2021,284,3,79,383,462
22/05/2021,787,3,369,2219,2588
22/05/2021,938,3,0,6,6
22/05/2021,193,3,219,942,1161
22/05/2021,865,3,32,162,194
22/05/2021,594,3,157,1024,1181
22/05/2021,932,3,2,68,70
22/05/2021,228,3,44,233,277
22/05/2021,475,3,228,1267,1495
22/05/2021,755,3,169,1164,1333
22/05/2021,917,3,6,70,76
22/05/2021,451,3,395,1929,2324
22/05/2021,183,3,64,410,474
22/05/2021,262,3,45,245,290
22/05/2021,106,3,252,1627,1879
22/05/2021,848,3,158,709,867
22/05/2021,519,3,79,496,575
22/05/2021,617,3,66,363,429
22/05/2021,70,3,247,1943,2190
22/05/2021,711,3,65,510,575
22/05/2021,11,3,74,469,543
22/05/2021,170,3,156,933,1089
22/05/2021,424,3,129,1484,1613
22/05/2021,409,3,26,153,179
22/05/2021,717,3,109,726,835
22/05/2021,614,3,74,494,568
22/05/2021,638,3,179,878,1057
22/05/2021,866,3,267,1634,1901
22/05/2021,829,3,176,1300,1476
22/05/2021,705,3,48,249,297
22/05/2021,780,3,279,1687,1966
22/05/2021,299,3,81,309,390
22/05/2021,181,3,90,496,586
22/05/2021,550,3,205,1006,1211
22/05/2021,337,3,39,308,347
22/05/2021,814,3,50,162,212
22/05/2021,459,3,123,489,612
22/05/2021,313,3,67,376,443
22/05/2021,98,3,260,1625,1885
22/05/2021,808,3,283,1313,1596
22/05/2021,891,3,139,496,635
22/05/2021,55,3,56,422,478
22/05/2021,329,3,243,1444,1687
22/05/2021,911,3,167,1406,1573
22/05/2021,508,3,229,1328,1557
22/05/2021,319,3,32,221,253
22/05/2021,301,3,148,1161,1309
22/05/2021,856,3,235,1059,1294
22/05/2021,698,3,62,540,602
22/05/2021,844,3,47,387,434
22/05/2021,724,3,339,1661,2000
22/05/2021,913,3,117,1017,1134
22/05/2021,716,3,87,607,694
22/05/2021,498,3,89,294,383
22/05/2021,67,3,104,894,998
22/05/2021,669,3,140,788,928
22/05/2021,226,3,133,711,844
22/05/2021,437,3,119,643,762
22/05/2021,560,3,271,1400,1671
22/05/2021,4,3,68,385,453
22/05/2021,368,3,173,1222,1395
22/05/2021,915,3,3,43,46
22/05/2021,57,3,123,979,1102
22/05/2021,806,3,222,1551,1773
22/05/2021,152,3,127,825,952
22/05/2021,657,3,167,613,780
22/05/2021,525,3,185,1161,1346
22/05/2021,211,3,106,800,906
22/05/2021,489,3,13,48,61
22/05/2021,528,3,97,339,436
22/05/2021,279,3,159,752,911
22/05/2021,628,3,108,425,533
22/05/2021,929,3,0,2,2
22/05/2021,565,3,304,1517,1821
22/05/2021,788,3,346,2058,2404
22/05/2021,155,3,182,1239,1421
22/05/2021,786,3,334,2557,2891
22/05/2021,735,3,45,325,370
22/05/2021,54,3,122,515,637
22/05/2021,318,3,237,1202,1439
22/05/2021,458,3,177,746,923
22/05/2021,237,3,176,1259,1435
22/05/2021,478,3,36,31,67
22/05/2021,178,3,157,891,1048
22/05/2021,173,3,94,380,474
22/05/2021,390,3,245,1497,1742
22/05/2021,881,3,2,34,36
22/05/2021,142,3,75,263,338
22/05/2021,394,3,85,454,539
22/05/2021,816,3,293,1713,2006
22/05/2021,529,3,106,469,575
22/05/2021,12,3,49,203,252
22/05/2021,496,3,39,300,339
22/05/2021,433,3,451,2099,2550
22/05/2021,467,3,80,630,710
22/05/2021,739,3,45,367,412
22/05/2021,527,3,100,322,422
22/05/2021,167,3,183,1059,1242
22/05/2021,209,3,18,157,175
22/05/2021,862,3,164,895,1059
22/05/2021,660,3,83,352,435
22/05/2021,265,3,56,329,385
22/05/2021,111,3,278,1341,1619
22/05/2021,701,3,108,427,535
22/05/2021,371,3,115,740,855
22/05/2021,823,3,83,392,475
22/05/2021,391,3,288,1735,2023
22/05/2021,514,3,33,312,345
22/05/2021,1,3,42,239,281
22/05/2021,878,3,4,39,43
22/05/2021,151,3,66,303,369
22/05/2021,778,3,180,594,774
22/05/2021,255,3,22,38,60
22/05/2021,190,3,120,604,724
22/05/2021,259,3,273,1068,1341
22/05/2021,939,3,1,5,6
22/05/2021,243,3,225,1577,1802
22/05/2021,817,3,145,746,891
22/05/2021,420,3,252,1059,1311
22/05/2021,620,3,0,1,1
22/05/2021,342,3,104,424,528
22/05/2021,271,3,63,416,479
22/05/2021,689,3,127,547,674
22/05/2021,593,3,278,1755,2033
22/05/2021,184,3,66,415,481
22/05/2021,526,3,91,350,441
22/05/2021,131,3,155,671,826
22/05/2021,365,3,107,590,697
22/05/2021,233,3,169,637,806
22/05/2021,685,3,85,390,475
22/05/2021,216,3,129,460,589
22/05/2021,369,3,267,1587,1854
22/05/2021,487,3,93,609,702
22/05/2021,841,3,18,206,224
22/05/2021,263,3,77,582,659
22/05/2021,703,3,99,444,543
22/05/2021,86,3,101,529,630
22/05/2021,440,3,194,1070,1264
22/05/2021,511,3,49,578,627
22/05/2021,381,3,8,6,14
22/05/2021,624,3,30,246,276
22/05/2021,731,3,54,329,383
22/05/2021,748,3,86,333,419
22/05/2021,583,3,41,242,283
22/05/2021,634,3,71,396,467
22/05/2021,157,3,148,586,734
22/05/2021,123,3,76,436,512
22/05/2021,7,3,42,241,283
22/05/2021,298,3,169,1282,1451
22/05/2021,125,3,149,610,759
22/05/2021,798,3,219,910,1129
22/05/2021,497,3,198,1491,1689
22/05/2021,166,3,72,653,725
22/05/2021,646,3,80,637,717
22/05/2021,105,3,224,999,1223
22/05/2021,196,3,188,793,981
22/05/2021,774,3,99,480,579
22/05/2021,585,3,218,982,1200
22/05/2021,935,3,0,1,1
22/05/2021,941,3,0,3,3
22/05/2021,341,3,268,1360,1628
22/05/2021,199,3,48,285,333
22/05/2021,126,3,157,952,1109
22/05/2021,510,3,239,1796,2035
22/05/2021,930,3,4,41,45
22/05/2021,543,3,380,1957,2337
22/05/2021,39,3,120,886,1006
22/05/2021,45,3,71,452,523
22/05/2021,743,3,53,262,315
22/05/2021,706,3,302,1457,1759
22/05/2021,102,3,211,881,1092
22/05/2021,582,3,327,1725,2052
22/05/2021,134,3,159,677,836
22/05/2021,412,3,69,967,1036
22/05/2021,264,3,42,265,307
22/05/2021,112,3,61,315,376
22/05/2021,688,3,82,321,403
22/05/2021,804,3,191,1332,1523
22/05/2021,899,3,272,1766,2038
22/05/2021,272,3,126,786,912
22/05/2021,479,3,72,354,426
22/05/2021,83,3,494,2883,3377
22/05/2021,248,3,81,408,489
22/05/2021,408,3,257,2534,2791
22/05/2021,535,3,114,566,680
22/05/2021,901,3,7,43,50
22/05/2021,402,3,193,945,1138
22/05/2021,934,3,2,43,45
22/05/2021,104,3,239,1156,1395
22/05/2021,745,3,89,419,508
22/05/2021,370,3,169,1130,1299
22/05/2021,89,3,214,1373,1587
22/05/2021,171,3,11,49,60
22/05/2021,71,3,120,865,985
22/05/2021,100,3,365,2107,2472
22/05/2021,852,3,221,713,934
22/05/2021,278,3,79,388,467
22/05/2021,615,3,125,823,948
22/05/2021,122,3,177,681,858
22/05/2021,700,3,63,552,615
22/05/2021,753,3,152,1319,1471
22/05/2021,710,3,52,351,403
22/05/2021,333,3,91,1145,1236
22/05/2021,360,3,82,682,764
22/05/2021,712,3,66,522,588
22/05/2021,311,3,168,920,1088
22/05/2021,280,3,32,105,137
22/05/2021,217,3,102,772,874
22/05/2021,356,3,267,1742,2009
22/05/2021,566,3,60,384,444
22/05/2021,797,3,160,741,901
22/05/2021,293,3,80,796,876
22/05/2021,637,3,267,1674,1941
22/05/2021,465,3,98,598,696
22/05/2021,846,3,8,109,117
22/05/2021,783,3,173,1011,1184
22/05/2021,114,3,195,815,1010
22/05/2021,43,3,126,967,1093
22/05/2021,500,3,28,260,288
22/05/2021,907,3,235,1323,1558
22/05/2021,824,3,334,1626,1960
22/05/2021,79,3,142,567,709
22/05/2021,309,3,21,79,100
22/05/2021,802,3,229,1921,2150
22/05/2021,37,3,65,311,376
22/05/2021,95,3,289,1708,1997
22/05/2021,161,3,342,1744,2086
22/05/2021,244,3,90,583,673
22/05/2021,473,3,39,308,347
22/05/2021,443,3,101,654,755
22/05/2021,59,3,109,762,871
22/05/2021,195,3,101,388,489
22/05/2021,563,3,118,513,631
22/05/2021,430,3,99,553,652
22/05/2021,137,3,164,828,992
22/05/2021,839,3,91,578,669
22/05/2021,575,3,47,191,238
22/05/2021,373,3,109,493,602
22/05/2021,872,3,113,337,450
22/05/2021,538,3,119,693,812
22/05/2021,650,3,88,513,601
22/05/2021,758,3,116,629,745
22/05/2021,569,3,138,598,736
22/05/2021,551,3,271,1298,1569
22/05/2021,113,3,85,377,462
22/05/2021,413,3,223,2307,2530
22/05/2021,607,3,363,2622,2985
22/05/2021,287,3,182,1290,1472
22/05/2021,153,3,174,874,1048
22/05/2021,17,3,90,442,532
22/05/2021,42,3,72,415,487
22/05/2021,864,3,60,277,337
22/05/2021,361,3,125,446,571
22/05/2021,332,3,110,497,607
22/05/2021,888,3,6,75,81
22/05/2021,589,3,116,471,587
22/05/2021,198,3,189,772,961
22/05/2021,571,3,134,587,721
22/05/2021,147,3,113,655,768
22/05/2021,776,3,110,786,896
22/05/2021,648,3,120,670,790
22/05/2021,544,3,177,910,1087
22/05/2021,633,3,110,599,709
22/05/2021,619,3,132,693,825
22/05/2021,384,3,122,640,762
22/05/2021,215,3,73,301,374
22/05/2021,887,3,4,47,51
22/05/2021,349,3,107,512,619
22/05/2021,219,3,96,402,498
22/05/2021,556,3,306,1528,1834
22/05/2021,77,3,236,1775,2011
22/05/2021,323,3,66,318,384
22/05/2021,75,3,275,2128,2403
22/05/2021,564,3,163,810,973
22/05/2021,827,3,241,1049,1290
22/05/2021,346,3,48,299,347
22/05/2021,225,3,189,877,1066
22/05/2021,160,3,20,60,80
22/05/2021,31,3,110,780,890
22/05/2021,618,3,109,638,747
22/05/2021,483,3,174,891,1065
22/05/2021,21,3,156,888,1044
22/05/2021,880,3,3,41,44
22/05/2021,363,3,143,461,604
22/05/2021,664,3,225,987,1212
22/05/2021,214,3,108,801,909
22/05/2021,208,3,62,356,418
22/05/2021,725,3,75,277,352
22/05/2021,845,3,85,479,564
22/05/2021,94,3,0,4,4
22/05/2021,207,3,71,471,542
22/05/2021,419,3,282,1253,1535
22/05/2021,592,3,164,1208,1372
22/05/2021,590,3,0,2,2
22/05/2021,224,3,46,231,277
22/05/2021,65,3,132,1108,1240
22/05/2021,869,3,125,433,558
22/05/2021,130,3,191,888,1079
22/05/2021,282,3,67,373,440
22/05/2021,396,3,77,323,400
22/05/2021,867,3,63,297,360
22/05/2021,629,3,121,745,866
22/05/2021,515,3,88,339,427
22/05/2021,335,3,64,366,430
22/05/2021,347,3,237,935,1172
22/05/2021,676,3,80,281,361
22/05/2021,254,3,69,367,436
22/05/2021,781,3,218,1613,1831
22/05/2021,779,3,152,556,708
22/05/2021,20,3,57,227,284
22/05/2021,789,3,172,903,1075
22/05/2021,574,3,137,593,730
22/05/2021,484,3,97,458,555
22/05/2021,110,3,131,627,758
22/05/2021,686,3,96,680,776
22/05/2021,832,3,112,509,621
22/05/2021,728,3,176,1144,1320
22/05/2021,431,3,89,574,663
22/05/2021,584,3,258,1356,1614
22/05/2021,598,3,448,2724,3172
22/05/2021,352,3,214,792,1006
22/05/2021,362,3,132,455,587
22/05/2021,647,3,80,435,515
22/05/2021,404,3,260,1561,1821
22/05/2021,506,3,257,1780,2037
22/05/2021,439,3,68,550,618
22/05/2021,136,3,159,677,836
22/05/2021,714,3,217,1079,1296
22/05/2021,838,3,180,958,1138
22/05/2021,382,3,0,2,2
22/05/2021,800,3,157,612,769
22/05/2021,730,3,136,1099,1235
22/05/2021,546,3,258,1201,1459
22/05/2021,8,3,75,568,643
22/05/2021,268,3,252,1286,1538
22/05/2021,303,3,119,884,1003
22/05/2021,761,3,60,377,437
22/05/2021,22,3,144,758,902
22/05/2021,447,3,71,366,437
22/05/2021,682,3,73,357,430
22/05/2021,471,3,103,488,591
22/05/2021,312,3,133,576,709
22/05/2021,851,3,143,853,996
22/05/2021,540,3,241,1129,1370
22/05/2021,48,3,38,183,221
22/05/2021,557,3,88,438,526
22/05/2021,300,3,159,1235,1394
22/05/2021,853,3,79,401,480
22/05/2021,348,3,37,263,300
22/05/2021,833,3,54,344,398
22/05/2021,898,3,66,237,303
22/05/2021,249,3,227,1623,1850
22/05/2021,670,3,427,2251,2678
22/05/2021,768,3,198,1608,1806
22/05/2021,397,3,81,374,455
22/05/2021,517,3,78,367,445
22/05/2021,425,3,121,848,969
22/05/2021,469,3,92,592,684
22/05/2021,661,3,244,1117,1361
22/05/2021,461,3,202,1129,1331
22/05/2021,578,3,36,188,224
22/05/2021,651,3,144,856,1000
22/05/2021,421,3,197,634,831
22/05/2021,260,3,493,2650,3143
22/05/2021,694,3,109,658,767
22/05/2021,580,3,86,590,676
22/05/2021,24,3,23,104,127
22/05/2021,680,3,67,375,442
22/05/2021,649,3,82,381,463
22/05/2021,726,3,56,160,216
22/05/2021,747,3,91,443,534
22/05/2021,169,3,122,648,770
22/05/2021,297,3,103,924,1027
22/05/2021,720,3,75,523,598
22/05/2021,871,3,218,1180,1398
22/05/2021,315,3,16,128,144
22/05/2021,548,3,105,344,449
22/05/2021,395,3,87,450,537
22/05/2021,405,3,35,170,205
22/05/2021,13,3,100,462,562
22/05/2021,336,3,291,1417,1708
22/05/2021,503,3,223,1651,1874
22/05/2021,599,3,444,2694,3138
22/05/2021,605,3,289,1421,1710
22/05/2021,640,3,110,661,771
22/05/2021,283,3,135,701,836
22/05/2021,377,3,170,807,977
22/05/2021,468,3,79,504,583
22/05/2021,36,3,115,707,822
22/05/2021,273,3,81,461,542
22/05/2021,742,3,139,778,917
22/05/2021,222,3,102,582,684
22/05/2021,906,3,12,31,43
22/05/2021,310,3,410,2906,3316
22/05/2021,691,3,113,514,627
22/05/2021,326,3,47,250,297
22/05/2021,452,3,108,722,830
22/05/2021,127,3,110,626,736
22/05/2021,227,3,45,263,308
22/05/2021,275,3,149,791,940
22/05/2021,481,3,154,749,903
22/05/2021,52,3,179,888,1067
22/05/2021,772,3,214,944,1158
22/05/2021,426,3,80,375,455
22/05/2021,612,3,165,1020,1185
22/05/2021,861,3,135,593,728
22/05/2021,530,3,53,178,231
22/05/2021,316,3,70,488,558
22/05/2021,107,3,343,2012,2355
22/05/2021,476,3,94,386,480
22/05/2021,357,3,282,1887,2169
22/05/2021,5,3,42,237,279
22/05/2021,407,3,172,1962,2134
22/05/2021,38,3,107,823,930
22/05/2021,668,3,62,287,349
22/05/2021,559,3,294,1535,1829
22/05/2021,821,3,154,804,958
22/05/2021,290,3,151,1140,1291
22/05/2021,174,3,82,453,535
22/05/2021,679,3,66,407,473
22/05/2021,645,3,80,597,677
22/05/2021,773,3,64,351,415
22/05/2021,351,3,420,2371,2791
22/05/2021,552,3,200,909,1109
22/05/2021,331,3,89,557,646
22/05/2021,606,3,182,968,1150
22/05/2021,388,3,314,1961,2275
22/05/2021,291,3,130,1081,1211
22/05/2021,116,3,93,452,545
22/05/2021,81,3,55,313,368
22/05/2021,771,3,144,1475,1619
22/05/2021,201,3,72,482,554
22/05/2021,621,3,50,305,355
22/05/2021,562,3,44,246,290
22/05/2021,455,3,75,412,487
22/05/2021,641,3,133,770,903
22/05/2021,343,3,69,295,364
22/05/2021,445,3,103,590,693
22/05/2021,653,3,55,357,412
22/05/2021,156,3,188,840,1028
22/05/2021,494,3,152,715,867
22/05/2021,741,3,41,374,415
22/05/2021,828,3,251,1563,1814
22/05/2021,905,3,1,5,6
22/05/2021,358,3,274,1630,1904
22/05/2021,414,3,245,2308,2553
22/05/2021,179,3,123,744,867
22/05/2021,919,3,142,659,801
22/05/2021,197,3,201,832,1033
22/05/2021,659,3,89,689,778
22/05/2021,627,3,64,433,497
22/05/2021,554,3,122,809,931
22/05/2021,372,3,274,1231,1505
22/05/2021,665,3,90,728,818
22/05/2021,307,3,220,1163,1383
22/05/2021,674,3,137,678,815
22/05/2021,639,3,77,440,517
22/05/2021,85,3,449,2560,3009
22/05/2021,270,3,82,477,559
22/05/2021,295,3,47,294,341
22/05/2021,35,3,127,934,1061
22/05/2021,376,3,25,105,130
23/05/2021,665,3,47,236,283
23/05/2021,659,3,44,213,257
23/05/2021,307,3,115,463,578
23/05/2021,919,3,96,278,374
23/05/2021,554,3,79,310,389
23/05/2021,197,3,61,277,338
23/05/2021,295,3,32,132,164
23/05/2021,639,3,44,170,214
23/05/2021,674,3,50,226,276
23/05/2021,376,3,12,65,77
23/05/2021,270,3,52,207,259
23/05/2021,35,3,76,229,305
23/05/2021,627,3,33,142,175
23/05/2021,85,3,385,1165,1550
23/05/2021,372,3,165,613,778
23/05/2021,866,3,154,651,805
23/05/2021,424,3,96,640,736
23/05/2021,70,3,139,645,784
23/05/2021,170,3,100,367,467
23/05/2021,614,3,33,148,181
23/05/2021,780,3,200,720,920
23/05/2021,409,3,16,73,89
23/05/2021,829,3,96,595,691
23/05/2021,717,3,40,202,242
23/05/2021,638,3,121,329,450
23/05/2021,705,3,23,68,91
23/05/2021,711,3,41,195,236
23/05/2021,11,3,59,150,209
23/05/2021,213,3,89,430,519
23/05/2021,138,3,77,205,282
23/05/2021,51,3,239,848,1087
23/05/2021,163,3,58,234,292
23/05/2021,266,3,45,121,166
23/05/2021,909,3,1,16,17
23/05/2021,321,3,33,114,147
23/05/2021,427,3,225,970,1195
23/05/2021,128,3,31,187,218
23/05/2021,875,3,41,114,155
23/05/2021,684,3,69,291,360
23/05/2021,252,3,38,119,157
23/05/2021,600,3,283,915,1198
23/05/2021,354,3,3,3,6
23/05/2021,417,3,151,836,987
23/05/2021,836,3,123,692,815
23/05/2021,936,3,24,56,80
23/05/2021,269,3,50,110,160
23/05/2021,462,3,26,264,290
23/05/2021,825,3,116,455,571
23/05/2021,654,3,50,249,299
23/05/2021,512,3,14,75,89
23/05/2021,253,3,27,149,176
23/05/2021,393,3,38,144,182
23/05/2021,247,3,69,439,508
23/05/2021,597,3,60,207,267
23/05/2021,162,3,294,711,1005
23/05/2021,15,3,137,353,490
23/05/2021,192,3,38,163,201
23/05/2021,474,3,39,171,210
23/05/2021,436,3,38,243,281
23/05/2021,56,3,105,299,404
23/05/2021,683,3,59,257,316
23/05/2021,350,3,44,146,190
23/05/2021,186,3,27,114,141
23/05/2021,251,3,41,138,179
23/05/2021,399,3,144,482,626
23/05/2021,41,3,50,248,298
23/05/2021,775,3,30,177,207
23/05/2021,928,3,1,1,2
23/05/2021,671,3,61,302,363
23/05/2021,602,3,210,736,946
23/05/2021,793,3,67,239,306
23/05/2021,449,3,61,268,329
23/05/2021,722,3,21,80,101
23/05/2021,317,3,187,542,729
23/05/2021,576,3,6,41,47
23/05/2021,148,3,42,159,201
23/05/2021,345,3,59,188,247
23/05/2021,810,3,61,235,296
23/05/2021,812,3,67,218,285
23/05/2021,146,3,161,655,816
23/05/2021,63,3,37,128,165
23/05/2021,513,3,23,75,98
23/05/2021,26,3,101,328,429
23/05/2021,240,3,106,643,749
23/05/2021,803,3,90,335,425
23/05/2021,723,3,78,245,323
23/05/2021,890,3,69,298,367
23/05/2021,868,3,269,938,1207
23/05/2021,172,3,87,348,435
23/05/2021,460,3,39,214,253
23/05/2021,485,3,76,215,291
23/05/2021,334,3,206,596,802
23/05/2021,815,3,336,1032,1368
23/05/2021,520,3,53,215,268
23/05/2021,99,3,198,765,963
23/05/2021,64,3,40,126,166
23/05/2021,88,3,47,153,200
23/05/2021,466,3,65,208,273
23/05/2021,101,3,51,246,297
23/05/2021,19,3,116,382,498
23/05/2021,738,3,75,272,347
23/05/2021,115,3,28,85,113
23/05/2021,542,3,106,192,298
23/05/2021,756,3,103,539,642
23/05/2021,884,3,13,327,340
23/05/2021,933,3,0,5,5
23/05/2021,616,3,100,285,385
23/05/2021,135,3,104,408,512
23/05/2021,9,3,102,265,367
23/05/2021,428,3,24,179,203
23/05/2021,662,3,148,551,699
23/05/2021,344,3,76,268,344
23/05/2021,129,3,91,257,348
23/05/2021,68,3,109,271,380
23/05/2021,189,3,26,141,167
23/05/2021,276,3,68,236,304
23/05/2021,380,3,79,274,353
23/05/2021,897,3,32,113,145
23/05/2021,400,3,26,95,121
23/05/2021,28,3,37,156,193
23/05/2021,187,3,37,134,171
23/05/2021,895,3,46,119,165
23/05/2021,570,3,62,227,289
23/05/2021,238,3,108,640,748
23/05/2021,777,3,70,208,278
23/05/2021,305,3,94,385,479
23/05/2021,696,3,98,351,449
23/05/2021,423,3,85,621,706
23/05/2021,286,3,37,115,152
23/05/2021,785,3,293,1234,1527
23/05/2021,631,3,14,52,66
23/05/2021,749,3,31,161,192
23/05/2021,625,3,78,204,282
23/05/2021,533,3,92,302,394
23/05/2021,246,3,110,683,793
23/05/2021,205,3,59,206,265
23/05/2021,91,3,53,204,257
23/05/2021,374,3,27,106,133
23/05/2021,87,3,156,580,736
23/05/2021,435,3,25,157,182
23/05/2021,737,3,20,138,158
23/05/2021,572,3,84,229,313
23/05/2021,188,3,66,289,355
23/05/2021,80,3,27,105,132
23/05/2021,733,3,36,144,180
23/05/2021,601,3,48,213,261
23/05/2021,894,3,83,222,305
23/05/2021,499,3,50,167,217
23/05/2021,340,3,68,259,327
23/05/2021,870,3,26,63,89
23/05/2021,97,3,138,423,561
23/05/2021,501,3,108,520,628
23/05/2021,610,3,171,740,911
23/05/2021,636,3,64,223,287
23/05/2021,656,3,42,261,303
23/05/2021,697,3,47,227,274
23/05/2021,859,3,13,26,39
23/05/2021,355,3,44,122,166
23/05/2021,117,3,164,456,620
23/05/2021,78,3,310,1145,1455
23/05/2021,212,3,81,454,535
23/05/2021,902,3,83,224,307
23/05/2021,338,3,79,289,368
23/05/2021,807,3,47,141,188
23/05/2021,411,3,141,859,1000
23/05/2021,210,3,43,165,208
23/05/2021,330,3,50,212,262
23/05/2021,493,3,56,169,225
23/05/2021,304,3,116,414,530
23/05/2021,438,3,45,133,178
23/05/2021,715,3,178,442,620
23/05/2021,218,3,82,422,504
23/05/2021,603,3,152,525,677
23/05/2021,403,3,123,443,566
23/05/2021,308,3,93,397,490
23/05/2021,322,3,86,213,299
23/05/2021,579,3,43,231,274
23/05/2021,58,3,114,713,827
23/05/2021,509,3,82,385,467
23/05/2021,764,3,19,81,100
23/05/2021,472,3,220,893,1113
23/05/2021,721,3,335,1466,1801
23/05/2021,673,3,68,208,276
23/05/2021,547,3,331,1164,1495
23/05/2021,164,3,76,271,347
23/05/2021,713,3,76,655,731
23/05/2021,90,3,54,181,235
23/05/2021,937,3,1,0,1
23/05/2021,159,3,99,382,481
23/05/2021,794,3,173,701,874
23/05/2021,746,3,43,137,180
23/05/2021,770,3,202,739,941
23/05/2021,27,3,192,543,735
23/05/2021,561,3,35,93,128
23/05/2021,567,3,81,232,313
23/05/2021,811,3,36,115,151
23/05/2021,456,3,45,260,305
23/05/2021,524,3,78,326,404
23/05/2021,229,3,117,397,514
23/05/2021,149,3,64,289,353
23/05/2021,168,3,47,154,201
23/05/2021,736,3,18,76,94
23/05/2021,587,3,9,63,72
23/05/2021,518,3,19,73,92
23/05/2021,422,3,61,193,254
23/05/2021,642,3,68,220,288
23/05/2021,754,3,95,319,414
23/05/2021,3,3,30,105,135
23/05/2021,204,3,73,216,289
23/05/2021,72,3,142,642,784
23/05/2021,292,3,92,520,612
23/05/2021,464,3,83,361,444
23/05/2021,782,3,114,512,626
23/05/2021,813,3,43,141,184
23/05/2021,202,3,134,722,856
23/05/2021,622,3,171,519,690
23/05/2021,92,3,61,217,278
23/05/2021,760,3,74,343,417
23/05/2021,139,3,70,207,277
23/05/2021,759,3,31,164,195
23/05/2021,236,3,22,202,224
23/05/2021,47,3,67,170,237
23/05/2021,765,3,80,333,413
23/05/2021,826,3,107,471,578
23/05/2021,18,3,76,259,335
23/05/2021,488,3,49,158,207
23/05/2021,221,3,62,248,310
23/05/2021,879,3,3,44,47
23/05/2021,154,3,101,392,493
23/05/2021,751,3,8,5,13
23/05/2021,242,3,112,664,776
23/05/2021,704,3,27,84,111
23/05/2021,555,3,199,588,787
23/05/2021,200,3,34,84,118
23/05/2021,581,3,104,293,397
23/05/2021,507,3,111,553,664
23/05/2021,448,3,232,913,1145
23/05/2021,46,3,48,142,190
23/05/2021,687,3,70,301,371
23/05/2021,25,3,57,186,243
23/05/2021,677,3,27,157,184
23/05/2021,591,3,84,200,284
23/05/2021,119,3,85,229,314
23/05/2021,133,3,21,60,81
23/05/2021,442,3,48,226,274
23/05/2021,231,3,59,186,245
23/05/2021,444,3,62,284,346
23/05/2021,809,3,48,141,189
23/05/2021,353,3,34,88,122
23/05/2021,145,3,103,381,484
23/05/2021,792,3,116,339,455
23/05/2021,922,3,0,4,4
23/05/2021,904,3,95,424,519
23/05/2021,245,3,32,160,192
23/05/2021,608,3,230,1018,1248
23/05/2021,652,3,28,84,112
23/05/2021,755,3,114,629,743
23/05/2021,475,3,172,539,711
23/05/2021,228,3,19,116,135
23/05/2021,617,3,44,124,168
23/05/2021,183,3,35,124,159
23/05/2021,262,3,23,109,132
23/05/2021,917,3,7,165,172
23/05/2021,594,3,131,653,784
23/05/2021,848,3,79,227,306
23/05/2021,932,3,2,57,59
23/05/2021,193,3,79,295,374
23/05/2021,519,3,73,264,337
23/05/2021,451,3,220,908,1128
23/05/2021,106,3,136,581,717
23/05/2021,865,3,20,53,73
23/05/2021,693,3,60,235,295
23/05/2021,387,3,104,320,424
23/05/2021,536,3,41,139,180
23/05/2021,302,3,79,422,501
23/05/2021,926,3,18,100,118
23/05/2021,914,3,2,4,6
23/05/2021,367,3,106,441,547
23/05/2021,908,3,51,417,468
23/05/2021,727,3,54,224,278
23/05/2021,158,3,31,116,147
23/05/2021,830,3,340,1150,1490
23/05/2021,531,3,74,302,376
23/05/2021,339,3,54,233,287
23/05/2021,791,3,49,264,313
23/05/2021,486,3,61,241,302
23/05/2021,732,3,18,118,136
23/05/2021,256,3,120,317,437
23/05/2021,757,3,124,403,527
23/05/2021,820,3,44,176,220
23/05/2021,2,3,32,104,136
23/05/2021,818,3,72,313,385
23/05/2021,643,3,75,239,314
23/05/2021,441,3,175,671,846
23/05/2021,490,3,35,96,131
23/05/2021,386,3,223,1067,1290
23/05/2021,327,3,199,823,1022
23/05/2021,203,3,73,232,305
23/05/2021,53,3,93,277,370
23/05/2021,96,3,36,196,232
23/05/2021,410,3,96,610,706
23/05/2021,921,3,0,7,7
23/05/2021,537,3,128,432,560
23/05/2021,586,3,91,465,556
23/05/2021,613,3,30,91,121
23/05/2021,883,3,13,312,325
23/05/2021,492,3,35,90,125
23/05/2021,504,3,35,112,147
23/05/2021,93,3,63,317,380
23/05/2021,558,3,34,118,152
23/05/2021,903,3,1,4,5
23/05/2021,398,3,17,29,46
23/05/2021,795,3,84,257,341
23/05/2021,702,3,55,188,243
23/05/2021,889,3,0,27,27
23/05/2021,69,3,65,278,343
23/05/2021,378,3,41,161,202
23/05/2021,477,3,42,142,184
23/05/2021,175,3,55,194,249
23/05/2021,858,3,186,595,781
23/05/2021,406,3,144,387,531
23/05/2021,767,3,191,721,912
23/05/2021,588,3,66,146,212
23/05/2021,854,3,153,657,810
23/05/2021,177,3,41,112,153
23/05/2021,392,3,46,162,208
23/05/2021,885,3,13,314,327
23/05/2021,108,3,42,125,167
23/05/2021,429,3,59,292,351
23/05/2021,274,3,2,98,100
23/05/2021,33,3,65,193,258
23/05/2021,480,3,41,120,161
23/05/2021,250,3,68,211,279
23/05/2021,623,3,92,368,460
23/05/2021,232,3,63,249,312
23/05/2021,366,3,49,110,159
23/05/2021,120,3,90,223,313
23/05/2021,860,3,106,236,342
23/05/2021,30,3,137,357,494
23/05/2021,61,3,93,257,350
23/05/2021,289,3,25,144,169
23/05/2021,144,3,62,273,335
23/05/2021,185,3,55,171,226
23/05/2021,604,3,196,579,775
23/05/2021,124,3,46,121,167
23/05/2021,850,3,224,399,623
23/05/2021,842,3,13,22,35
23/05/2021,288,3,14,63,77
23/05/2021,328,3,50,226,276
23/05/2021,261,3,351,1440,1791
23/05/2021,843,3,33,159,192
23/05/2021,359,3,93,214,307
23/05/2021,910,3,14,310,324
23/05/2021,495,3,45,125,170
23/05/2021,82,3,129,465,594
23/05/2021,892,3,4,17,21
23/05/2021,454,3,50,354,404
23/05/2021,874,3,50,243,293
23/05/2021,532,3,338,1500,1838
23/05/2021,595,3,47,157,204
23/05/2021,44,3,103,338,441
23/05/2021,719,3,45,138,183
23/05/2021,876,3,0,15,15
23/05/2021,577,3,49,254,303
23/05/2021,6,3,28,111,139
23/05/2021,787,3,314,1206,1520
23/05/2021,118,3,83,219,302
23/05/2021,923,3,1,1,2
23/05/2021,234,3,29,111,140
23/05/2021,539,3,134,418,552
23/05/2021,284,3,48,108,156
23/05/2021,938,3,0,3,3
23/05/2021,230,3,59,215,274
23/05/2021,258,3,330,1394,1724
23/05/2021,521,3,40,127,167
23/05/2021,364,3,79,267,346
23/05/2021,49,3,24,61,85
23/05/2021,799,3,25,56,81
23/05/2021,873,3,103,326,429
23/05/2021,325,3,67,267,334
23/05/2021,925,3,0,4,4
23/05/2021,734,3,39,87,126
23/05/2021,924,3,2,30,32
23/05/2021,863,3,40,149,189
23/05/2021,900,3,14,36,50
23/05/2021,675,3,63,148,211
23/05/2021,752,3,157,664,821
23/05/2021,534,3,57,227,284
23/05/2021,632,3,26,79,105
23/05/2021,60,3,18,52,70
23/05/2021,194,3,3,2,5
23/05/2021,658,3,37,209,246
23/05/2021,418,3,17,70,87
23/05/2021,383,3,212,889,1101
23/05/2021,681,3,92,190,282
23/05/2021,235,3,40,211,251
23/05/2021,918,3,0,15,15
23/05/2021,635,3,80,408,488
23/05/2021,655,3,112,436,548
23/05/2021,463,3,179,710,889
23/05/2021,140,3,55,205,260
23/05/2021,692,3,91,303,394
23/05/2021,840,3,38,188,226
23/05/2021,663,3,83,352,435
23/05/2021,457,3,36,140,176
23/05/2021,453,3,75,238,313
23/05/2021,877,3,2,45,47
23/05/2021,450,3,53,291,344
23/05/2021,920,3,0,1,1
23/05/2021,267,3,57,133,190
23/05/2021,239,3,47,236,283
23/05/2021,882,3,1,33,34
23/05/2021,491,3,102,472,574
23/05/2021,401,3,26,120,146
23/05/2021,446,3,38,168,206
23/05/2021,522,3,51,219,270
23/05/2021,416,3,20,142,162
23/05/2021,666,3,110,358,468
23/05/2021,707,3,156,408,564
23/05/2021,182,3,35,156,191
23/05/2021,784,3,225,889,1114
23/05/2021,281,3,76,254,330
23/05/2021,790,3,63,306,369
23/05/2021,66,3,97,241,338
23/05/2021,296,3,16,117,133
23/05/2021,32,3,73,247,320
23/05/2021,103,3,167,391,558
23/05/2021,176,3,101,324,425
23/05/2021,389,3,143,611,754
23/05/2021,314,3,32,121,153
23/05/2021,855,3,87,295,382
23/05/2021,835,3,100,382,482
23/05/2021,257,3,297,1183,1480
23/05/2021,837,3,79,425,504
23/05/2021,831,3,65,227,292
23/05/2021,709,3,178,547,725
23/05/2021,277,3,88,269,357
23/05/2021,434,3,8,28,36
23/05/2021,121,3,273,982,1255
23/05/2021,505,3,16,76,92
23/05/2021,385,3,80,273,353
23/05/2021,285,3,62,188,250
23/05/2021,857,3,72,195,267
23/05/2021,432,3,44,333,377
23/05/2021,76,3,149,695,844
23/05/2021,143,3,140,540,680
23/05/2021,84,3,267,640,907
23/05/2021,34,3,31,154,185
23/05/2021,180,3,65,220,285
23/05/2021,699,3,42,148,190
23/05/2021,886,3,1,77,78
23/05/2021,626,3,43,157,200
23/05/2021,206,3,4,7,11
23/05/2021,805,3,61,120,181
23/05/2021,750,3,83,459,542
23/05/2021,220,3,55,253,308
23/05/2021,294,3,142,510,652
23/05/2021,573,3,64,195,259
23/05/2021,553,3,42,94,136
23/05/2021,801,3,66,265,331
23/05/2021,379,3,71,317,388
23/05/2021,819,3,79,284,363
23/05/2021,847,3,8,194,202
23/05/2021,23,3,12,66,78
23/05/2021,849,3,93,269,362
23/05/2021,896,3,328,1104,1432
23/05/2021,50,3,22,59,81
23/05/2021,470,3,66,244,310
23/05/2021,201,3,45,122,167
23/05/2021,179,3,61,205,266
23/05/2021,905,3,0,2,2
23/05/2021,343,3,37,126,163
23/05/2021,562,3,20,70,90
23/05/2021,641,3,66,232,298
23/05/2021,494,3,53,242,295
23/05/2021,414,3,154,867,1021
23/05/2021,621,3,53,178,231
23/05/2021,358,3,235,811,1046
23/05/2021,445,3,51,266,317
23/05/2021,156,3,74,272,346
23/05/2021,455,3,36,159,195
23/05/2021,653,3,22,75,97
23/05/2021,741,3,23,126,149
23/05/2021,828,3,120,341,461
23/05/2021,571,3,62,186,248
23/05/2021,198,3,112,269,381
23/05/2021,147,3,57,246,303
23/05/2021,888,3,7,169,176
23/05/2021,864,3,40,116,156
23/05/2021,153,3,99,393,492
23/05/2021,17,3,31,143,174
23/05/2021,361,3,75,261,336
23/05/2021,332,3,64,173,237
23/05/2021,42,3,49,169,218
23/05/2021,413,3,134,803,937
23/05/2021,776,3,47,266,313
23/05/2021,607,3,211,942,1153
23/05/2021,287,3,101,542,643
23/05/2021,648,3,84,240,324
23/05/2021,589,3,75,183,258
23/05/2021,703,3,42,142,184
23/05/2021,86,3,50,151,201
23/05/2021,216,3,51,175,226
23/05/2021,440,3,96,437,533
23/05/2021,841,3,21,383,404
23/05/2021,748,3,52,110,162
23/05/2021,583,3,29,130,159
23/05/2021,685,3,53,222,275
23/05/2021,634,3,51,197,248
23/05/2021,511,3,24,151,175
23/05/2021,233,3,97,215,312
23/05/2021,263,3,42,226,268
23/05/2021,731,3,36,124,160
23/05/2021,624,3,16,82,98
23/05/2021,369,3,210,627,837
23/05/2021,487,3,48,178,226
23/05/2021,381,3,6,2,8
23/05/2021,528,3,34,104,138
23/05/2021,489,3,9,22,31
23/05/2021,458,3,77,305,382
23/05/2021,786,3,166,705,871
23/05/2021,478,3,89,119,208
23/05/2021,155,3,111,488,599
23/05/2021,318,3,149,469,618
23/05/2021,565,3,226,640,866
23/05/2021,237,3,102,571,673
23/05/2021,279,3,80,274,354
23/05/2021,628,3,48,164,212
23/05/2021,735,3,23,122,145
23/05/2021,54,3,82,171,253
23/05/2021,788,3,307,1192,1499
23/05/2021,178,3,95,307,402
23/05/2021,929,3,0,2,2
23/05/2021,724,3,288,1043,1331
23/05/2021,55,3,57,108,165
23/05/2021,313,3,30,118,148
23/05/2021,508,3,99,401,500
23/05/2021,913,3,92,426,518
23/05/2021,698,3,42,218,260
23/05/2021,911,3,72,402,474
23/05/2021,808,3,154,488,642
23/05/2021,319,3,32,88,120
23/05/2021,856,3,142,476,618
23/05/2021,891,3,47,173,220
23/05/2021,814,3,64,163,227
23/05/2021,550,3,136,425,561
23/05/2021,98,3,138,570,708
23/05/2021,329,3,203,841,1044
23/05/2021,337,3,21,98,119
23/05/2021,301,3,68,451,519
23/05/2021,181,3,42,169,211
23/05/2021,299,3,50,160,210
23/05/2021,716,3,35,170,205
23/05/2021,459,3,72,226,298
23/05/2021,844,3,20,152,172
23/05/2021,67,3,97,220,317
23/05/2021,525,3,76,353,429
23/05/2021,560,3,206,607,813
23/05/2021,4,3,48,197,245
23/05/2021,657,3,126,415,541
23/05/2021,498,3,42,120,162
23/05/2021,437,3,55,264,319
23/05/2021,211,3,82,418,500
23/05/2021,152,3,65,269,334
23/05/2021,57,3,104,266,370
23/05/2021,806,3,111,583,694
23/05/2021,915,3,2,31,33
23/05/2021,368,3,105,437,542
23/05/2021,669,3,50,247,297
23/05/2021,226,3,76,275,351
23/05/2021,365,3,53,167,220
23/05/2021,593,3,230,1009,1239
23/05/2021,526,3,33,122,155
23/05/2021,689,3,112,324,436
23/05/2021,151,3,33,150,183
23/05/2021,259,3,255,892,1147
23/05/2021,342,3,54,166,220
23/05/2021,243,3,113,703,816
23/05/2021,131,3,72,218,290
23/05/2021,778,3,134,331,465
23/05/2021,255,3,13,18,31
23/05/2021,271,3,49,125,174
23/05/2021,817,3,69,303,372
23/05/2021,420,3,188,546,734
23/05/2021,184,3,43,135,178
23/05/2021,190,3,57,247,304
23/05/2021,620,3,0,3,3
23/05/2021,939,3,0,10,10
23/05/2021,167,3,112,421,533
23/05/2021,527,3,45,123,168
23/05/2021,12,3,25,82,107
23/05/2021,209,3,19,81,100
23/05/2021,467,3,27,256,283
23/05/2021,739,3,27,108,135
23/05/2021,816,3,207,774,981
23/05/2021,173,3,68,132,200
23/05/2021,862,3,96,330,426
23/05/2021,496,3,22,77,99
23/05/2021,881,3,2,94,96
23/05/2021,433,3,217,868,1085
23/05/2021,142,3,36,116,152
23/05/2021,529,3,48,158,206
23/05/2021,394,3,42,157,199
23/05/2021,390,3,131,588,719
23/05/2021,823,3,46,172,218
23/05/2021,660,3,43,131,174
23/05/2021,1,3,28,106,134
23/05/2021,371,3,86,292,378
23/05/2021,514,3,18,84,102
23/05/2021,701,3,57,197,254
23/05/2021,878,3,5,38,43
23/05/2021,391,3,141,597,738
23/05/2021,265,3,24,142,166
23/05/2021,111,3,151,480,631
23/05/2021,373,3,72,167,239
23/05/2021,839,3,51,212,263
23/05/2021,538,3,66,284,350
23/05/2021,137,3,74,242,316
23/05/2021,563,3,48,154,202
23/05/2021,872,3,53,172,225
23/05/2021,430,3,58,219,277
23/05/2021,650,3,70,239,309
23/05/2021,569,3,74,212,286
23/05/2021,575,3,29,86,115
23/05/2021,551,3,169,536,705
23/05/2021,758,3,90,280,370
23/05/2021,113,3,28,124,152
23/05/2021,804,3,110,607,717
23/05/2021,83,3,407,1273,1680
23/05/2021,112,3,62,146,208
23/05/2021,248,3,39,163,202
23/05/2021,408,3,149,903,1052
23/05/2021,264,3,20,119,139
23/05/2021,934,3,2,29,31
23/05/2021,899,3,183,770,953
23/05/2021,104,3,103,351,454
23/05/2021,901,3,7,12,19
23/05/2021,402,3,120,411,531
23/05/2021,688,3,53,209,262
23/05/2021,479,3,50,126,176
23/05/2021,535,3,51,213,264
23/05/2021,272,3,89,268,357
23/05/2021,123,3,54,159,213
23/05/2021,125,3,79,211,290
23/05/2021,298,3,97,542,639
23/05/2021,646,3,55,266,321
23/05/2021,7,3,28,103,131
23/05/2021,774,3,73,160,233
23/05/2021,157,3,115,285,400
23/05/2021,105,3,108,289,397
23/05/2021,166,3,50,227,277
23/05/2021,196,3,49,221,270
23/05/2021,798,3,132,483,615
23/05/2021,497,3,94,435,529
23/05/2021,935,3,0,1,1
23/05/2021,941,3,0,1,1
23/05/2021,585,3,131,505,636
23/05/2021,510,3,95,482,577
23/05/2021,706,3,183,554,737
23/05/2021,412,3,32,266,298
23/05/2021,126,3,112,355,467
23/05/2021,102,3,126,385,511
23/05/2021,341,3,239,888,1127
23/05/2021,930,3,2,29,31
23/05/2021,134,3,95,369,464
23/05/2021,582,3,277,1225,1502
23/05/2021,39,3,66,297,363
23/05/2021,45,3,35,166,201
23/05/2021,199,3,30,77,107
23/05/2021,543,3,323,1150,1473
23/05/2021,743,3,29,114,143
23/05/2021,95,3,172,702,874
23/05/2021,37,3,55,104,159
23/05/2021,473,3,30,116,146
23/05/2021,59,3,43,169,212
23/05/2021,195,3,30,125,155
23/05/2021,309,3,31,60,91
23/05/2021,244,3,28,211,239
23/05/2021,802,3,167,779,946
23/05/2021,443,3,54,266,320
23/05/2021,161,3,307,777,1084
23/05/2021,122,3,98,241,339
23/05/2021,89,3,115,380,495
23/05/2021,745,3,47,173,220
23/05/2021,100,3,195,769,964
23/05/2021,71,3,63,212,275
23/05/2021,700,3,41,222,263
23/05/2021,710,3,38,174,212
23/05/2021,852,3,142,408,550
23/05/2021,278,3,64,202,266
23/05/2021,370,3,104,430,534
23/05/2021,753,3,88,475,563
23/05/2021,171,3,9,29,38
23/05/2021,615,3,92,307,399
23/05/2021,293,3,42,302,344
23/05/2021,356,3,183,655,838
23/05/2021,783,3,124,587,711
23/05/2021,79,3,97,250,347
23/05/2021,907,3,126,475,601
23/05/2021,114,3,122,299,421
23/05/2021,43,3,65,296,361
23/05/2021,360,3,53,250,303
23/05/2021,280,3,36,57,93
23/05/2021,311,3,102,366,468
23/05/2021,566,3,31,108,139
23/05/2021,465,3,46,227,273
23/05/2021,500,3,15,63,78
23/05/2021,637,3,179,760,939
23/05/2021,797,3,128,418,546
23/05/2021,712,3,39,191,230
23/05/2021,846,3,10,213,223
23/05/2021,333,3,66,502,568
23/05/2021,217,3,81,412,493
23/05/2021,824,3,170,695,865
23/05/2021,388,3,139,512,651
23/05/2021,291,3,77,428,505
23/05/2021,645,3,61,239,300
23/05/2021,331,3,59,233,292
23/05/2021,116,3,64,256,320
23/05/2021,606,3,110,419,529
23/05/2021,552,3,148,442,590
23/05/2021,771,3,90,508,598
23/05/2021,351,3,250,935,1185
23/05/2021,773,3,54,123,177
23/05/2021,81,3,22,98,120
23/05/2021,680,3,36,156,192
23/05/2021,24,3,12,58,70
23/05/2021,461,3,87,423,510
23/05/2021,517,3,44,135,179
23/05/2021,694,3,46,198,244
23/05/2021,578,3,13,57,70
23/05/2021,661,3,133,447,580
23/05/2021,651,3,82,266,348
23/05/2021,425,3,48,350,398
23/05/2021,260,3,362,1477,1839
23/05/2021,469,3,43,230,273
23/05/2021,580,3,76,246,322
23/05/2021,421,3,144,376,520
23/05/2021,515,3,37,119,156
23/05/2021,254,3,27,138,165
23/05/2021,20,3,52,137,189
23/05/2021,781,3,147,585,732
23/05/2021,347,3,284,598,882
23/05/2021,335,3,50,185,235
23/05/2021,869,3,72,261,333
23/05/2021,779,3,58,132,190
23/05/2021,789,3,102,315,417
23/05/2021,629,3,62,193,255
23/05/2021,419,3,131,510,641
23/05/2021,207,3,28,143,171
23/05/2021,592,3,118,479,597
23/05/2021,676,3,49,102,151
23/05/2021,65,3,100,252,352
23/05/2021,396,3,35,114,149
23/05/2021,224,3,18,121,139
23/05/2021,867,3,59,203,262
23/05/2021,130,3,121,469,590
23/05/2021,282,3,64,218,282
23/05/2021,384,3,96,296,392
23/05/2021,215,3,41,134,175
23/05/2021,323,3,55,113,168
23/05/2021,349,3,37,159,196
23/05/2021,556,3,236,652,888
23/05/2021,219,3,48,158,206
23/05/2021,887,3,2,34,36
23/05/2021,77,3,154,719,873
23/05/2021,619,3,81,225,306
23/05/2021,75,3,150,720,870
23/05/2021,564,3,118,369,487
23/05/2021,544,3,114,356,470
23/05/2021,633,3,37,169,206
23/05/2021,725,3,45,192,237
23/05/2021,845,3,55,166,221
23/05/2021,880,3,2,30,32
23/05/2021,160,3,4,23,27
23/05/2021,827,3,174,532,706
23/05/2021,225,3,85,344,429
23/05/2021,346,3,30,92,122
23/05/2021,618,3,50,191,241
23/05/2021,363,3,88,269,357
23/05/2021,31,3,60,178,238
23/05/2021,483,3,102,277,379
23/05/2021,21,3,107,302,409
23/05/2021,214,3,84,424,508
23/05/2021,664,3,127,444,571
23/05/2021,208,3,24,112,136
23/05/2021,249,3,114,719,833
23/05/2021,851,3,71,292,363
23/05/2021,348,3,21,92,113
23/05/2021,768,3,103,472,575
23/05/2021,670,3,375,1307,1682
23/05/2021,48,3,24,65,89
23/05/2021,898,3,46,121,167
23/05/2021,397,3,33,118,151
23/05/2021,540,3,161,501,662
23/05/2021,833,3,31,96,127
23/05/2021,557,3,40,137,177
23/05/2021,853,3,37,135,172
23/05/2021,312,3,78,221,299
23/05/2021,300,3,85,503,588
23/05/2021,838,3,69,252,321
23/05/2021,404,3,208,778,986
23/05/2021,431,3,56,179,235
23/05/2021,484,3,63,189,252
23/05/2021,728,3,77,330,407
23/05/2021,647,3,28,155,183
23/05/2021,362,3,79,274,353
23/05/2021,832,3,61,165,226
23/05/2021,110,3,43,173,216
23/05/2021,439,3,39,186,225
23/05/2021,352,3,138,346,484
23/05/2021,506,3,110,501,611
23/05/2021,714,3,114,346,460
23/05/2021,584,3,204,938,1142
23/05/2021,686,3,49,216,265
23/05/2021,382,3,0,2,2
23/05/2021,598,3,325,1200,1525
23/05/2021,136,3,94,377,471
23/05/2021,574,3,76,218,294
23/05/2021,761,3,28,112,140
23/05/2021,730,3,60,193,253
23/05/2021,800,3,79,203,282
23/05/2021,546,3,166,517,683
23/05/2021,268,3,141,525,666
23/05/2021,447,3,35,155,190
23/05/2021,682,3,22,101,123
23/05/2021,22,3,73,254,327
23/05/2021,471,3,56,175,231
23/05/2021,303,3,82,447,529
23/05/2021,8,3,54,213,267
23/05/2021,38,3,55,267,322
23/05/2021,107,3,200,767,967
23/05/2021,559,3,219,627,846
23/05/2021,290,3,89,464,553
23/05/2021,316,3,48,196,244
23/05/2021,476,3,50,153,203
23/05/2021,174,3,46,141,187
23/05/2021,668,3,22,91,113
23/05/2021,821,3,104,389,493
23/05/2021,5,3,28,107,135
23/05/2021,679,3,51,196,247
23/05/2021,407,3,100,655,755
23/05/2021,357,3,185,704,889
23/05/2021,530,3,27,121,148
23/05/2021,336,3,245,870,1115
23/05/2021,503,3,97,440,537
23/05/2021,377,3,108,296,404
23/05/2021,640,3,58,217,275
23/05/2021,36,3,64,188,252
23/05/2021,405,3,22,56,78
23/05/2021,273,3,63,320,383
23/05/2021,13,3,47,174,221
23/05/2021,395,3,46,147,193
23/05/2021,599,3,311,1179,1490
23/05/2021,605,3,167,614,781
23/05/2021,283,3,86,257,343
23/05/2021,468,3,53,208,261
23/05/2021,315,3,17,55,72
23/05/2021,548,3,57,153,210
23/05/2021,649,3,79,209,288
23/05/2021,169,3,89,320,409
23/05/2021,720,3,46,165,211
23/05/2021,871,3,107,390,497
23/05/2021,297,3,51,335,386
23/05/2021,747,3,51,151,202
23/05/2021,726,3,31,140,171
23/05/2021,275,3,75,279,354
23/05/2021,906,3,7,15,22
23/05/2021,127,3,34,181,215
23/05/2021,52,3,105,335,440
23/05/2021,742,3,81,291,372
23/05/2021,691,3,71,276,347
23/05/2021,772,3,115,362,477
23/05/2021,426,3,44,167,211
23/05/2021,481,3,85,243,328
23/05/2021,612,3,146,575,721
23/05/2021,310,3,267,1034,1301
23/05/2021,222,3,56,231,287
23/05/2021,452,3,62,252,314
23/05/2021,227,3,20,130,150
23/05/2021,861,3,105,334,439
23/05/2021,326,3,24,72,96
24/05/2021,426,3,60,173,233
24/05/2021,275,3,75,275,350
24/05/2021,222,3,73,216,289
24/05/2021,861,3,134,388,522
24/05/2021,481,3,88,213,301
24/05/2021,691,3,57,210,267
24/05/2021,452,3,61,215,276
24/05/2021,52,3,105,315,420
24/05/2021,772,3,109,353,462
24/05/2021,742,3,82,244,326
24/05/2021,310,3,298,1072,1370
24/05/2021,127,3,53,165,218
24/05/2021,227,3,31,145,176
24/05/2021,612,3,153,675,828
24/05/2021,906,3,10,16,26
24/05/2021,326,3,21,82,103
24/05/2021,76,3,141,607,748
24/05/2021,626,3,42,152,194
24/05/2021,285,3,52,174,226
24/05/2021,294,3,144,432,576
24/05/2021,143,3,147,453,600
24/05/2021,886,3,0,38,38
24/05/2021,34,3,51,128,179
24/05/2021,750,3,78,374,452
24/05/2021,180,3,56,216,272
24/05/2021,699,3,40,159,199
24/05/2021,206,3,4,14,18
24/05/2021,857,3,75,182,257
24/05/2021,432,3,59,276,335
24/05/2021,220,3,71,229,300
24/05/2021,805,3,64,150,214
24/05/2021,385,3,102,268,370
24/05/2021,84,3,336,689,1025
24/05/2021,72,3,134,562,696
24/05/2021,92,3,71,211,282
24/05/2021,622,3,183,523,706
24/05/2021,754,3,110,321,431
24/05/2021,782,3,137,593,730
24/05/2021,292,3,123,533,656
24/05/2021,3,3,26,154,180
24/05/2021,642,3,69,227,296
24/05/2021,518,3,29,137,166
24/05/2021,202,3,154,708,862
24/05/2021,760,3,84,357,441
24/05/2021,813,3,72,150,222
24/05/2021,139,3,66,207,273
24/05/2021,422,3,55,181,236
24/05/2021,204,3,84,233,317
24/05/2021,464,3,89,340,429
24/05/2021,485,3,73,208,281
24/05/2021,466,3,75,199,274
24/05/2021,88,3,62,240,302
24/05/2021,64,3,45,119,164
24/05/2021,890,3,59,279,338
24/05/2021,868,3,263,853,1116
24/05/2021,101,3,63,244,307
24/05/2021,723,3,76,245,321
24/05/2021,520,3,64,220,284
24/05/2021,803,3,85,322,407
24/05/2021,172,3,87,371,458
24/05/2021,99,3,202,699,901
24/05/2021,738,3,74,255,329
24/05/2021,19,3,123,395,518
24/05/2021,334,3,230,596,826
24/05/2021,815,3,389,957,1346
24/05/2021,460,3,39,185,224
24/05/2021,909,3,2,12,14
24/05/2021,128,3,47,174,221
24/05/2021,875,3,50,141,191
24/05/2021,163,3,60,199,259
24/05/2021,836,3,98,532,630
24/05/2021,600,3,339,939,1278
24/05/2021,354,3,3,2,5
24/05/2021,138,3,68,204,272
24/05/2021,321,3,34,99,133
24/05/2021,936,3,24,51,75
24/05/2021,417,3,137,680,817
24/05/2021,266,3,52,142,194
24/05/2021,427,3,192,791,983
24/05/2021,684,3,91,346,437
24/05/2021,51,3,266,918,1184
24/05/2021,213,3,95,372,467
24/05/2021,252,3,38,116,154
24/05/2021,376,3,13,45,58
24/05/2021,307,3,112,397,509
24/05/2021,372,3,192,605,797
24/05/2021,270,3,46,223,269
24/05/2021,85,3,442,1176,1618
24/05/2021,639,3,63,160,223
24/05/2021,659,3,49,180,229
24/05/2021,295,3,39,150,189
24/05/2021,197,3,75,256,331
24/05/2021,35,3,90,247,337
24/05/2021,674,3,66,236,302
24/05/2021,665,3,57,204,261
24/05/2021,627,3,40,119,159
24/05/2021,919,3,98,283,381
24/05/2021,554,3,84,305,389
24/05/2021,614,3,41,151,192
24/05/2021,866,3,149,527,676
24/05/2021,70,3,123,550,673
24/05/2021,424,3,107,622,729
24/05/2021,705,3,26,84,110
24/05/2021,717,3,51,200,251
24/05/2021,780,3,214,674,888
24/05/2021,829,3,140,588,728
24/05/2021,638,3,132,330,462
24/05/2021,170,3,98,397,495
24/05/2021,11,3,68,170,238
24/05/2021,711,3,46,215,261
24/05/2021,409,3,19,78,97
24/05/2021,812,3,70,202,272
24/05/2021,240,3,143,617,760
24/05/2021,576,3,8,47,55
24/05/2021,345,3,63,196,259
24/05/2021,317,3,183,538,721
24/05/2021,810,3,71,254,325
24/05/2021,63,3,37,110,147
24/05/2021,146,3,165,582,747
24/05/2021,513,3,24,95,119
24/05/2021,26,3,96,282,378
24/05/2021,942,3,0,1,1
24/05/2021,148,3,50,170,220
24/05/2021,683,3,60,223,283
24/05/2021,462,3,47,243,290
24/05/2021,350,3,47,148,195
24/05/2021,393,3,33,116,149
24/05/2021,56,3,119,323,442
24/05/2021,512,3,16,101,117
24/05/2021,436,3,54,200,254
24/05/2021,192,3,47,146,193
24/05/2021,825,3,132,405,537
24/05/2021,474,3,47,177,224
24/05/2021,399,3,169,495,664
24/05/2021,162,3,346,755,1101
24/05/2021,186,3,40,123,163
24/05/2021,15,3,145,368,513
24/05/2021,597,3,63,163,226
24/05/2021,247,3,88,387,475
24/05/2021,251,3,54,168,222
24/05/2021,253,3,26,135,161
24/05/2021,654,3,43,230,273
24/05/2021,269,3,54,153,207
24/05/2021,793,3,85,267,352
24/05/2021,928,3,1,5,6
24/05/2021,602,3,231,714,945
24/05/2021,775,3,49,167,216
24/05/2021,671,3,67,299,366
24/05/2021,449,3,66,282,348
24/05/2021,41,3,64,224,288
24/05/2021,722,3,27,114,141
24/05/2021,90,3,56,205,261
24/05/2021,673,3,62,252,314
24/05/2021,547,3,376,1276,1652
24/05/2021,168,3,52,150,202
24/05/2021,561,3,41,107,148
24/05/2021,713,3,88,655,743
24/05/2021,456,3,52,238,290
24/05/2021,229,3,144,371,515
24/05/2021,587,3,14,58,72
24/05/2021,524,3,113,352,465
24/05/2021,149,3,80,285,365
24/05/2021,721,3,362,1539,1901
24/05/2021,794,3,149,556,705
24/05/2021,159,3,89,297,386
24/05/2021,567,3,84,224,308
24/05/2021,27,3,189,547,736
24/05/2021,746,3,46,179,225
24/05/2021,931,3,0,1,1
24/05/2021,811,3,39,134,173
24/05/2021,937,3,2,0,2
24/05/2021,770,3,206,676,882
24/05/2021,736,3,18,84,102
24/05/2021,164,3,71,271,342
24/05/2021,737,3,28,143,171
24/05/2021,91,3,75,298,373
24/05/2021,572,3,84,195,279
24/05/2021,374,3,34,103,137
24/05/2021,205,3,72,218,290
24/05/2021,749,3,49,166,215
24/05/2021,87,3,191,486,677
24/05/2021,625,3,70,192,262
24/05/2021,435,3,41,126,167
24/05/2021,533,3,89,299,388
24/05/2021,246,3,151,671,822
24/05/2021,631,3,12,41,53
24/05/2021,129,3,83,249,332
24/05/2021,662,3,151,439,590
24/05/2021,428,3,23,163,186
24/05/2021,9,3,87,276,363
24/05/2021,135,3,142,395,537
24/05/2021,115,3,26,107,133
24/05/2021,542,3,111,275,386
24/05/2021,344,3,83,280,363
24/05/2021,756,3,127,576,703
24/05/2021,884,3,11,84,95
24/05/2021,68,3,111,310,421
24/05/2021,616,3,100,343,443
24/05/2021,933,3,0,5,5
24/05/2021,400,3,36,113,149
24/05/2021,895,3,70,165,235
24/05/2021,286,3,29,97,126
24/05/2021,897,3,38,130,168
24/05/2021,276,3,60,224,284
24/05/2021,28,3,52,138,190
24/05/2021,696,3,86,310,396
24/05/2021,187,3,42,137,179
24/05/2021,189,3,30,158,188
24/05/2021,777,3,73,203,276
24/05/2021,238,3,143,613,756
24/05/2021,305,3,90,323,413
24/05/2021,785,3,348,1182,1530
24/05/2021,380,3,93,248,341
24/05/2021,570,3,56,189,245
24/05/2021,423,3,93,590,683
24/05/2021,308,3,88,317,405
24/05/2021,438,3,49,140,189
24/05/2021,509,3,70,320,390
24/05/2021,715,3,190,431,621
24/05/2021,472,3,178,703,881
24/05/2021,218,3,86,352,438
24/05/2021,764,3,20,97,117
24/05/2021,58,3,104,550,654
24/05/2021,322,3,111,248,359
24/05/2021,603,3,176,539,715
24/05/2021,579,3,47,235,282
24/05/2021,403,3,128,389,517
24/05/2021,97,3,147,457,604
24/05/2021,859,3,15,31,46
24/05/2021,894,3,82,231,313
24/05/2021,601,3,59,221,280
24/05/2021,697,3,59,228,287
24/05/2021,656,3,50,289,339
24/05/2021,733,3,45,142,187
24/05/2021,355,3,46,140,186
24/05/2021,501,3,95,452,547
24/05/2021,80,3,25,134,159
24/05/2021,188,3,90,335,425
24/05/2021,340,3,73,246,319
24/05/2021,870,3,20,82,102
24/05/2021,636,3,63,202,265
24/05/2021,499,3,41,167,208
24/05/2021,610,3,162,691,853
24/05/2021,117,3,167,502,669
24/05/2021,338,3,81,266,347
24/05/2021,807,3,66,159,225
24/05/2021,304,3,112,373,485
24/05/2021,902,3,100,208,308
24/05/2021,330,3,73,240,313
24/05/2021,212,3,92,385,477
24/05/2021,493,3,71,146,217
24/05/2021,411,3,135,708,843
24/05/2021,78,3,332,1175,1507
24/05/2021,210,3,53,160,213
24/05/2021,389,3,156,475,631
24/05/2021,835,3,99,333,432
24/05/2021,176,3,98,279,377
24/05/2021,257,3,314,1230,1544
24/05/2021,855,3,94,264,358
24/05/2021,277,3,93,295,388
24/05/2021,121,3,329,1099,1428
24/05/2021,831,3,74,213,287
24/05/2021,434,3,10,53,63
24/05/2021,103,3,190,441,631
24/05/2021,32,3,65,258,323
24/05/2021,709,3,181,496,677
24/05/2021,837,3,97,379,476
24/05/2021,505,3,21,86,107
24/05/2021,314,3,32,122,154
24/05/2021,429,3,75,285,360
24/05/2021,366,3,72,165,237
24/05/2021,232,3,90,232,322
24/05/2021,108,3,40,106,146
24/05/2021,885,3,11,91,102
24/05/2021,177,3,33,95,128
24/05/2021,250,3,85,255,340
24/05/2021,480,3,56,119,175
24/05/2021,588,3,80,177,257
24/05/2021,623,3,100,300,400
24/05/2021,274,3,2,13,15
24/05/2021,767,3,191,647,838
24/05/2021,854,3,134,573,707
24/05/2021,392,3,44,162,206
24/05/2021,860,3,103,233,336
24/05/2021,120,3,92,253,345
24/05/2021,33,3,64,185,249
24/05/2021,106,3,106,477,583
24/05/2021,262,3,39,119,158
24/05/2021,917,3,7,38,45
24/05/2021,932,3,0,23,23
24/05/2021,193,3,97,244,341
24/05/2021,755,3,146,645,791
24/05/2021,475,3,173,528,701
24/05/2021,519,3,87,285,372
24/05/2021,228,3,31,124,155
24/05/2021,183,3,37,129,166
24/05/2021,451,3,194,788,982
24/05/2021,865,3,30,92,122
24/05/2021,617,3,54,168,222
24/05/2021,594,3,130,634,764
24/05/2021,848,3,75,232,307
24/05/2021,704,3,30,98,128
24/05/2021,47,3,80,192,272
24/05/2021,879,3,1,30,31
24/05/2021,242,3,150,624,774
24/05/2021,236,3,36,175,211
24/05/2021,18,3,74,266,340
24/05/2021,154,3,92,347,439
24/05/2021,488,3,57,176,233
24/05/2021,759,3,30,159,189
24/05/2021,221,3,72,226,298
24/05/2021,765,3,88,252,340
24/05/2021,826,3,142,412,554
24/05/2021,751,3,14,2,16
24/05/2021,46,3,72,162,234
24/05/2021,442,3,46,195,241
24/05/2021,448,3,196,756,952
24/05/2021,231,3,54,193,247
24/05/2021,687,3,102,348,450
24/05/2021,200,3,44,108,152
24/05/2021,652,3,21,88,109
24/05/2021,353,3,27,96,123
24/05/2021,581,3,98,277,375
24/05/2021,444,3,75,259,334
24/05/2021,904,3,84,353,437
24/05/2021,922,3,0,4,4
24/05/2021,591,3,97,199,296
24/05/2021,555,3,209,579,788
24/05/2021,792,3,125,290,415
24/05/2021,25,3,74,250,324
24/05/2021,507,3,96,473,569
24/05/2021,145,3,90,327,417
24/05/2021,677,3,26,146,172
24/05/2021,245,3,32,145,177
24/05/2021,608,3,226,973,1199
24/05/2021,133,3,32,106,138
24/05/2021,809,3,55,113,168
24/05/2021,119,3,82,227,309
24/05/2021,883,3,12,90,102
24/05/2021,858,3,187,583,770
24/05/2021,795,3,86,228,314
24/05/2021,504,3,34,90,124
24/05/2021,586,3,98,391,489
24/05/2021,903,3,0,1,1
24/05/2021,406,3,150,385,535
24/05/2021,93,3,80,293,373
24/05/2021,477,3,38,141,179
24/05/2021,69,3,86,297,383
24/05/2021,613,3,23,118,141
24/05/2021,378,3,42,174,216
24/05/2021,558,3,41,120,161
24/05/2021,889,3,0,9,9
24/05/2021,492,3,33,84,117
24/05/2021,398,3,13,21,34
24/05/2021,537,3,147,405,552
24/05/2021,702,3,66,232,298
24/05/2021,175,3,58,167,225
24/05/2021,693,3,59,192,251
24/05/2021,367,3,107,459,566
24/05/2021,727,3,83,240,323
24/05/2021,908,3,97,422,519
24/05/2021,914,3,2,9,11
24/05/2021,536,3,57,152,209
24/05/2021,387,3,91,242,333
24/05/2021,302,3,99,404,503
24/05/2021,926,3,11,51,62
24/05/2021,96,3,50,205,255
24/05/2021,818,3,77,287,364
24/05/2021,486,3,76,322,398
24/05/2021,820,3,63,205,268
24/05/2021,386,3,252,920,1172
24/05/2021,531,3,90,301,391
24/05/2021,830,3,375,1202,1577
24/05/2021,2,3,27,154,181
24/05/2021,53,3,101,282,383
24/05/2021,490,3,35,104,139
24/05/2021,327,3,247,805,1052
24/05/2021,256,3,119,290,409
24/05/2021,203,3,86,271,357
24/05/2021,921,3,0,6,6
24/05/2021,643,3,78,264,342
24/05/2021,757,3,143,418,561
24/05/2021,339,3,65,226,291
24/05/2021,410,3,88,476,564
24/05/2021,732,3,31,101,132
24/05/2021,441,3,149,562,711
24/05/2021,791,3,61,244,305
24/05/2021,158,3,35,127,162
24/05/2021,416,3,24,133,157
24/05/2021,784,3,264,902,1166
24/05/2021,401,3,39,124,163
24/05/2021,182,3,50,164,214
24/05/2021,666,3,102,327,429
24/05/2021,446,3,52,179,231
24/05/2021,450,3,55,241,296
24/05/2021,522,3,62,203,265
24/05/2021,239,3,46,222,268
24/05/2021,296,3,42,137,179
24/05/2021,707,3,156,376,532
24/05/2021,882,3,1,27,28
24/05/2021,790,3,59,282,341
24/05/2021,66,3,108,278,386
24/05/2021,920,3,0,2,2
24/05/2021,267,3,59,162,221
24/05/2021,491,3,87,394,481
24/05/2021,281,3,56,233,289
24/05/2021,577,3,57,248,305
24/05/2021,532,3,354,1501,1855
24/05/2021,874,3,60,207,267
24/05/2021,719,3,48,110,158
24/05/2021,876,3,0,11,11
24/05/2021,44,3,131,431,562
24/05/2021,595,3,48,159,207
24/05/2021,842,3,14,24,38
24/05/2021,604,3,207,524,731
24/05/2021,289,3,45,171,216
24/05/2021,850,3,290,524,814
24/05/2021,61,3,110,298,408
24/05/2021,30,3,145,359,504
24/05/2021,144,3,72,275,347
24/05/2021,185,3,63,161,224
24/05/2021,124,3,51,168,219
24/05/2021,843,3,33,145,178
24/05/2021,892,3,5,12,17
24/05/2021,454,3,60,320,380
24/05/2021,288,3,18,88,106
24/05/2021,328,3,61,253,314
24/05/2021,359,3,101,248,349
24/05/2021,261,3,377,1494,1871
24/05/2021,910,3,11,87,98
24/05/2021,495,3,40,119,159
24/05/2021,82,3,141,384,525
24/05/2021,453,3,80,230,310
24/05/2021,840,3,55,201,256
24/05/2021,140,3,55,161,216
24/05/2021,457,3,35,108,143
24/05/2021,635,3,78,355,433
24/05/2021,692,3,95,296,391
24/05/2021,463,3,148,592,740
24/05/2021,877,3,5,45,50
24/05/2021,663,3,92,290,382
24/05/2021,655,3,119,363,482
24/05/2021,6,3,26,151,177
24/05/2021,325,3,58,261,319
24/05/2021,787,3,375,1336,1711
24/05/2021,521,3,31,125,156
24/05/2021,799,3,17,49,66
24/05/2021,234,3,34,100,134
24/05/2021,925,3,0,3,3
24/05/2021,49,3,32,100,132
24/05/2021,118,3,79,224,303
24/05/2021,938,3,0,3,3
24/05/2021,284,3,44,101,145
24/05/2021,539,3,132,404,536
24/05/2021,230,3,66,197,263
24/05/2021,734,3,34,107,141
24/05/2021,364,3,102,304,406
24/05/2021,258,3,355,1427,1782
24/05/2021,923,3,1,0,1
24/05/2021,873,3,104,315,419
24/05/2021,658,3,47,191,238
24/05/2021,918,3,1,9,10
24/05/2021,235,3,64,226,290
24/05/2021,900,3,9,50,59
24/05/2021,863,3,59,230,289
24/05/2021,752,3,156,537,693
24/05/2021,675,3,42,145,187
24/05/2021,632,3,17,53,70
24/05/2021,924,3,2,8,10
24/05/2021,194,3,1,2,3
24/05/2021,681,3,104,243,347
24/05/2021,418,3,21,74,95
24/05/2021,383,3,205,825,1030
24/05/2021,534,3,66,220,286
24/05/2021,60,3,31,72,103
24/05/2021,649,3,95,214,309
24/05/2021,747,3,70,170,240
24/05/2021,871,3,118,374,492
24/05/2021,726,3,51,178,229
24/05/2021,548,3,58,124,182
24/05/2021,315,3,16,66,82
24/05/2021,297,3,80,350,430
24/05/2021,720,3,53,143,196
24/05/2021,169,3,85,349,434
24/05/2021,443,3,62,254,316
24/05/2021,473,3,36,116,152
24/05/2021,95,3,170,575,745
24/05/2021,161,3,359,751,1110
24/05/2021,37,3,59,125,184
24/05/2021,309,3,34,71,105
24/05/2021,244,3,41,213,254
24/05/2021,59,3,48,133,181
24/05/2021,802,3,203,786,989
24/05/2021,195,3,46,121,167
24/05/2021,57,3,108,313,421
24/05/2021,67,3,92,263,355
24/05/2021,437,3,72,235,307
24/05/2021,368,3,112,447,559
24/05/2021,226,3,96,234,330
24/05/2021,915,3,1,18,19
24/05/2021,657,3,150,461,611
24/05/2021,525,3,95,359,454
24/05/2021,498,3,40,115,155
24/05/2021,806,3,149,466,615
24/05/2021,152,3,73,258,331
24/05/2021,560,3,217,597,814
24/05/2021,669,3,67,252,319
24/05/2021,211,3,86,349,435
24/05/2021,4,3,45,201,246
24/05/2021,571,3,62,157,219
24/05/2021,147,3,66,243,309
24/05/2021,607,3,208,902,1110
24/05/2021,153,3,96,335,431
24/05/2021,864,3,48,121,169
24/05/2021,198,3,101,302,403
24/05/2021,361,3,98,297,395
24/05/2021,888,3,7,43,50
24/05/2021,17,3,44,158,202
24/05/2021,776,3,56,262,318
24/05/2021,648,3,66,193,259
24/05/2021,42,3,69,153,222
24/05/2021,332,3,49,182,231
24/05/2021,287,3,129,542,671
24/05/2021,413,3,123,643,766
24/05/2021,589,3,83,177,260
24/05/2021,573,3,61,185,246
24/05/2021,849,3,107,293,400
24/05/2021,847,3,7,56,63
24/05/2021,470,3,71,240,311
24/05/2021,379,3,87,342,429
24/05/2021,801,3,73,255,328
24/05/2021,819,3,93,322,415
24/05/2021,896,3,372,1260,1632
24/05/2021,23,3,11,51,62
24/05/2021,50,3,34,104,138
24/05/2021,553,3,42,74,116
24/05/2021,156,3,82,302,384
24/05/2021,641,3,71,227,298
24/05/2021,343,3,34,163,197
24/05/2021,494,3,56,209,265
24/05/2021,414,3,143,734,877
24/05/2021,653,3,19,72,91
24/05/2021,179,3,50,165,215
24/05/2021,358,3,264,894,1158
24/05/2021,445,3,79,254,333
24/05/2021,201,3,43,138,181
24/05/2021,562,3,25,78,103
24/05/2021,621,3,45,172,217
24/05/2021,828,3,124,334,458
24/05/2021,741,3,27,139,166
24/05/2021,455,3,47,183,230
24/05/2021,905,3,0,4,4
24/05/2021,55,3,60,127,187
24/05/2021,724,3,340,1147,1487
24/05/2021,814,3,64,187,251
24/05/2021,550,3,140,416,556
24/05/2021,319,3,28,77,105
24/05/2021,808,3,157,495,652
24/05/2021,891,3,69,186,255
24/05/2021,98,3,143,504,647
24/05/2021,913,3,123,501,624
24/05/2021,459,3,82,232,314
24/05/2021,301,3,112,434,546
24/05/2021,716,3,46,187,233
24/05/2021,313,3,37,130,167
24/05/2021,329,3,259,844,1103
24/05/2021,844,3,40,147,187
24/05/2021,508,3,79,336,415
24/05/2021,337,3,26,111,137
24/05/2021,911,3,66,326,392
24/05/2021,181,3,70,180,250
24/05/2021,856,3,158,489,647
24/05/2021,299,3,43,153,196
24/05/2021,698,3,58,217,275
24/05/2021,634,3,77,198,275
24/05/2021,440,3,96,405,501
24/05/2021,511,3,26,153,179
24/05/2021,583,3,30,131,161
24/05/2021,841,3,14,123,137
24/05/2021,86,3,54,187,241
24/05/2021,216,3,61,192,253
24/05/2021,748,3,40,126,166
24/05/2021,233,3,110,259,369
24/05/2021,624,3,20,88,108
24/05/2021,731,3,41,127,168
24/05/2021,487,3,65,167,232
24/05/2021,369,3,222,655,877
24/05/2021,685,3,90,243,333
24/05/2021,263,3,62,205,267
24/05/2021,381,3,4,1,5
24/05/2021,703,3,44,164,208
24/05/2021,786,3,163,642,805
24/05/2021,279,3,59,254,313
24/05/2021,788,3,368,1332,1700
24/05/2021,178,3,95,277,372
24/05/2021,565,3,239,613,852
24/05/2021,478,3,139,213,352
24/05/2021,54,3,91,165,256
24/05/2021,489,3,11,22,33
24/05/2021,155,3,123,429,552
24/05/2021,735,3,30,127,157
24/05/2021,237,3,140,552,692
24/05/2021,318,3,161,462,623
24/05/2021,628,3,55,185,240
24/05/2021,528,3,52,110,162
24/05/2021,458,3,83,257,340
24/05/2021,706,3,183,470,653
24/05/2021,930,3,1,18,19
24/05/2021,510,3,80,415,495
24/05/2021,126,3,109,338,447
24/05/2021,134,3,129,366,495
24/05/2021,543,3,360,1214,1574
24/05/2021,102,3,144,439,583
24/05/2021,45,3,53,144,197
24/05/2021,412,3,29,218,247
24/05/2021,743,3,36,143,179
24/05/2021,199,3,35,100,135
24/05/2021,582,3,321,1313,1634
24/05/2021,39,3,78,276,354
24/05/2021,341,3,287,1008,1295
24/05/2021,391,3,183,475,658
24/05/2021,823,3,49,182,231
24/05/2021,660,3,43,153,196
24/05/2021,878,3,7,43,50
24/05/2021,265,3,43,149,192
24/05/2021,514,3,18,100,118
24/05/2021,111,3,163,472,635
24/05/2021,701,3,58,210,268
24/05/2021,1,3,26,154,180
24/05/2021,371,3,99,318,417
24/05/2021,131,3,74,234,308
24/05/2021,271,3,61,140,201
24/05/2021,342,3,44,203,247
24/05/2021,184,3,43,130,173
24/05/2021,689,3,107,320,427
24/05/2021,593,3,242,1013,1255
24/05/2021,243,3,152,681,833
24/05/2021,817,3,95,324,419
24/05/2021,365,3,70,165,235
24/05/2021,526,3,51,112,163
24/05/2021,151,3,37,165,202
24/05/2021,778,3,142,348,490
24/05/2021,255,3,13,17,30
24/05/2021,259,3,300,1076,1376
24/05/2021,939,3,0,5,5
24/05/2021,190,3,93,276,369
24/05/2021,420,3,193,542,735
24/05/2021,12,3,27,93,120
24/05/2021,142,3,53,111,164
24/05/2021,529,3,81,167,248
24/05/2021,527,3,65,133,198
24/05/2021,496,3,19,94,113
24/05/2021,881,3,2,11,13
24/05/2021,816,3,220,734,954
24/05/2021,433,3,174,673,847
24/05/2021,390,3,164,490,654
24/05/2021,394,3,42,151,193
24/05/2021,862,3,114,294,408
24/05/2021,209,3,21,90,111
24/05/2021,467,3,45,237,282
24/05/2021,739,3,28,117,145
24/05/2021,167,3,133,423,556
24/05/2021,173,3,66,158,224
24/05/2021,125,3,76,217,293
24/05/2021,941,3,0,2,2
24/05/2021,7,3,25,150,175
24/05/2021,798,3,167,489,656
24/05/2021,196,3,62,191,253
24/05/2021,497,3,78,380,458
24/05/2021,298,3,123,537,660
24/05/2021,585,3,159,499,658
24/05/2021,157,3,103,265,368
24/05/2021,646,3,63,268,331
24/05/2021,774,3,67,178,245
24/05/2021,123,3,60,205,265
24/05/2021,935,3,0,1,1
24/05/2021,166,3,44,207,251
24/05/2021,105,3,109,330,439
24/05/2021,569,3,73,192,265
24/05/2021,373,3,81,188,269
24/05/2021,758,3,87,315,402
24/05/2021,563,3,69,170,239
24/05/2021,650,3,79,271,350
24/05/2021,872,3,57,175,232
24/05/2021,575,3,27,79,106
24/05/2021,137,3,71,230,301
24/05/2021,551,3,160,497,657
24/05/2021,430,3,64,200,264
24/05/2021,113,3,43,123,166
24/05/2021,538,3,91,321,412
24/05/2021,839,3,60,206,266
24/05/2021,901,3,5,15,20
24/05/2021,112,3,71,157,228
24/05/2021,248,3,46,148,194
24/05/2021,104,3,114,339,453
24/05/2021,402,3,129,386,515
24/05/2021,264,3,38,126,164
24/05/2021,83,3,473,1269,1742
24/05/2021,934,3,1,14,15
24/05/2021,899,3,207,796,1003
24/05/2021,535,3,82,224,306
24/05/2021,272,3,99,322,421
24/05/2021,688,3,83,248,331
24/05/2021,408,3,143,731,874
24/05/2021,804,3,153,598,751
24/05/2021,479,3,59,113,172
24/05/2021,377,3,121,265,386
24/05/2021,405,3,32,103,135
24/05/2021,395,3,38,137,175
24/05/2021,36,3,64,208,272
24/05/2021,503,3,82,368,450
24/05/2021,336,3,291,975,1266
24/05/2021,640,3,70,216,286
24/05/2021,468,3,53,201,254
24/05/2021,599,3,338,1170,1508
24/05/2021,605,3,192,610,802
24/05/2021,273,3,62,321,383
24/05/2021,283,3,72,210,282
24/05/2021,13,3,66,175,241
24/05/2021,363,3,105,310,415
24/05/2021,346,3,46,134,180
24/05/2021,160,3,3,20,23
24/05/2021,845,3,66,226,292
24/05/2021,725,3,60,175,235
24/05/2021,31,3,63,214,277
24/05/2021,225,3,94,284,378
24/05/2021,483,3,96,262,358
24/05/2021,618,3,64,252,316
24/05/2021,21,3,88,303,391
24/05/2021,214,3,90,356,446
24/05/2021,664,3,138,406,544
24/05/2021,827,3,186,527,713
24/05/2021,880,3,1,16,17
24/05/2021,208,3,29,99,128
24/05/2021,388,3,165,446,611
24/05/2021,351,3,240,812,1052
24/05/2021,606,3,115,379,494
24/05/2021,645,3,69,243,312
24/05/2021,773,3,59,156,215
24/05/2021,291,3,98,413,511
24/05/2021,331,3,75,211,286
24/05/2021,116,3,84,223,307
24/05/2021,552,3,151,458,609
24/05/2021,81,3,25,131,156
24/05/2021,771,3,73,365,438
24/05/2021,745,3,47,191,238
24/05/2021,700,3,58,226,284
24/05/2021,852,3,150,435,585
24/05/2021,89,3,147,361,508
24/05/2021,171,3,11,61,72
24/05/2021,615,3,103,317,420
24/05/2021,753,3,79,350,429
24/05/2021,122,3,96,272,368
24/05/2021,370,3,105,450,555
24/05/2021,100,3,199,716,915
24/05/2021,710,3,46,203,249
24/05/2021,71,3,52,205,257
24/05/2021,278,3,55,191,246
24/05/2021,824,3,145,555,700
24/05/2021,637,3,218,803,1021
24/05/2021,333,3,78,475,553
24/05/2021,217,3,83,341,424
24/05/2021,356,3,193,667,860
24/05/2021,846,3,8,70,78
24/05/2021,360,3,58,211,269
24/05/2021,280,3,25,61,86
24/05/2021,797,3,130,406,536
24/05/2021,43,3,81,266,347
24/05/2021,465,3,45,195,240
24/05/2021,311,3,99,344,443
24/05/2021,712,3,47,208,255
24/05/2021,293,3,64,290,354
24/05/2021,500,3,14,81,95
24/05/2021,907,3,165,470,635
24/05/2021,79,3,96,229,325
24/05/2021,114,3,119,318,437
24/05/2021,566,3,42,115,157
24/05/2021,783,3,141,650,791
24/05/2021,323,3,53,151,204
24/05/2021,564,3,115,355,470
24/05/2021,349,3,43,132,175
24/05/2021,384,3,99,289,388
24/05/2021,633,3,41,162,203
24/05/2021,219,3,34,160,194
24/05/2021,77,3,144,645,789
24/05/2021,544,3,115,332,447
24/05/2021,556,3,242,637,879
24/05/2021,887,3,1,21,22
24/05/2021,619,3,67,194,261
24/05/2021,75,3,149,631,780
24/05/2021,215,3,46,147,193
24/05/2021,578,3,17,61,78
24/05/2021,680,3,50,160,210
24/05/2021,461,3,80,350,430
24/05/2021,469,3,45,221,266
24/05/2021,517,3,48,136,184
24/05/2021,651,3,71,243,314
24/05/2021,421,3,146,365,511
24/05/2021,260,3,379,1535,1914
24/05/2021,580,3,76,252,328
24/05/2021,24,3,13,50,63
24/05/2021,661,3,147,426,573
24/05/2021,425,3,63,312,375
24/05/2021,694,3,56,172,228
24/05/2021,207,3,37,135,172
24/05/2021,869,3,94,292,386
24/05/2021,224,3,29,129,158
24/05/2021,789,3,95,303,398
24/05/2021,676,3,37,109,146
24/05/2021,396,3,43,108,151
24/05/2021,335,3,64,187,251
24/05/2021,419,3,103,409,512
24/05/2021,592,3,105,411,516
24/05/2021,629,3,70,215,285
24/05/2021,779,3,61,141,202
24/05/2021,20,3,61,124,185
24/05/2021,867,3,77,202,279
24/05/2021,515,3,39,93,132
24/05/2021,282,3,50,181,231
24/05/2021,347,3,340,644,984
24/05/2021,130,3,156,469,625
24/05/2021,254,3,30,126,156
24/05/2021,781,3,148,496,644
24/05/2021,65,3,101,281,382
24/05/2021,407,3,86,481,567
24/05/2021,668,3,29,106,135
24/05/2021,357,3,209,758,967
24/05/2021,290,3,110,464,574
24/05/2021,316,3,58,193,251
24/05/2021,559,3,227,616,843
24/05/2021,5,3,28,150,178
24/05/2021,679,3,62,193,255
24/05/2021,174,3,42,118,160
24/05/2021,38,3,73,248,321
24/05/2021,530,3,40,137,177
24/05/2021,821,3,102,396,498
24/05/2021,107,3,212,714,926
24/05/2021,476,3,37,159,196
24/05/2021,714,3,104,300,404
24/05/2021,484,3,70,193,263
24/05/2021,647,3,49,144,193
24/05/2021,404,3,203,723,926
24/05/2021,136,3,134,372,506
24/05/2021,598,3,364,1200,1564
24/05/2021,110,3,52,166,218
24/05/2021,832,3,70,200,270
24/05/2021,584,3,236,988,1224
24/05/2021,352,3,118,308,426
24/05/2021,728,3,80,241,321
24/05/2021,431,3,57,161,218
24/05/2021,506,3,104,444,548
24/05/2021,838,3,67,203,270
24/05/2021,439,3,36,151,187
24/05/2021,574,3,81,210,291
24/05/2021,362,3,108,313,421
24/05/2021,382,3,0,1,1
24/05/2021,686,3,47,187,234
24/05/2021,851,3,85,292,377
24/05/2021,249,3,156,688,844
24/05/2021,670,3,413,1363,1776
24/05/2021,300,3,109,506,615
24/05/2021,833,3,37,92,129
24/05/2021,853,3,43,197,240
24/05/2021,312,3,71,176,247
24/05/2021,48,3,32,103,135
24/05/2021,397,3,32,92,124
24/05/2021,348,3,37,135,172
24/05/2021,768,3,93,394,487
24/05/2021,557,3,51,147,198
24/05/2021,898,3,65,175,240
24/05/2021,540,3,159,484,643
24/05/2021,546,3,161,498,659
24/05/2021,682,3,24,94,118
24/05/2021,761,3,29,146,175
24/05/2021,730,3,54,154,208
24/05/2021,447,3,54,149,203
24/05/2021,22,3,60,256,316
24/05/2021,268,3,145,477,622
24/05/2021,303,3,90,373,463
24/05/2021,471,3,62,157,219
24/05/2021,800,3,79,207,286
24/05/2021,8,3,63,201,264
25/05/2021,8,3,65,183,248
25/05/2021,268,3,150,479,629
25/05/2021,22,3,67,296,363
25/05/2021,800,3,103,228,331
25/05/2021,730,3,52,150,202
25/05/2021,447,3,47,147,194
25/05/2021,546,3,155,445,600
25/05/2021,761,3,29,110,139
25/05/2021,682,3,27,88,115
25/05/2021,471,3,51,136,187
25/05/2021,303,3,81,340,421
25/05/2021,799,3,28,57,85
25/05/2021,6,3,33,176,209
25/05/2021,258,3,355,1356,1711
25/05/2021,734,3,38,116,154
25/05/2021,118,3,95,230,325
25/05/2021,364,3,96,325,421
25/05/2021,938,3,0,6,6
25/05/2021,925,3,0,1,1
25/05/2021,49,3,41,131,172
25/05/2021,234,3,36,107,143
25/05/2021,325,3,56,278,334
25/05/2021,521,3,35,123,158
25/05/2021,787,3,365,1363,1728
25/05/2021,230,3,70,195,265
25/05/2021,539,3,127,353,480
25/05/2021,284,3,42,96,138
25/05/2021,873,3,105,331,436
25/05/2021,923,3,2,0,2
25/05/2021,58,3,95,550,645
25/05/2021,438,3,56,149,205
25/05/2021,403,3,136,394,530
25/05/2021,603,3,181,518,699
25/05/2021,472,3,183,703,886
25/05/2021,509,3,78,332,410
25/05/2021,764,3,21,79,100
25/05/2021,715,3,162,402,564
25/05/2021,218,3,79,319,398
25/05/2021,579,3,45,192,237
25/05/2021,308,3,94,349,443
25/05/2021,322,3,105,248,353
25/05/2021,711,3,64,199,263
25/05/2021,705,3,27,95,122
25/05/2021,11,3,59,189,248
25/05/2021,409,3,32,87,119
25/05/2021,614,3,38,172,210
25/05/2021,424,3,110,592,702
25/05/2021,829,3,148,547,695
25/05/2021,866,3,148,548,696
25/05/2021,717,3,52,215,267
25/05/2021,170,3,87,421,508
25/05/2021,70,3,106,540,646
25/05/2021,638,3,135,339,474
25/05/2021,780,3,234,631,865
25/05/2021,782,3,128,514,642
25/05/2021,3,3,33,164,197
25/05/2021,642,3,96,235,331
25/05/2021,139,3,78,198,276
25/05/2021,754,3,106,302,408
25/05/2021,760,3,85,319,404
25/05/2021,292,3,122,481,603
25/05/2021,202,3,152,667,819
25/05/2021,204,3,91,222,313
25/05/2021,622,3,221,521,742
25/05/2021,464,3,79,342,421
25/05/2021,92,3,73,201,274
25/05/2021,422,3,54,164,218
25/05/2021,72,3,116,548,664
25/05/2021,518,3,29,138,167
25/05/2021,813,3,69,175,244
25/05/2021,481,3,90,232,322
25/05/2021,906,3,18,16,34
25/05/2021,227,3,35,124,159
25/05/2021,861,3,144,391,535
25/05/2021,452,3,67,250,317
25/05/2021,612,3,143,712,855
25/05/2021,127,3,55,170,225
25/05/2021,742,3,84,210,294
25/05/2021,222,3,71,185,256
25/05/2021,326,3,17,90,107
25/05/2021,310,3,297,1106,1403
25/05/2021,691,3,56,228,284
25/05/2021,275,3,75,283,358
25/05/2021,52,3,101,345,446
25/05/2021,772,3,118,381,499
25/05/2021,426,3,51,180,231
25/05/2021,385,3,99,219,318
25/05/2021,180,3,63,237,300
25/05/2021,220,3,72,207,279
25/05/2021,699,3,42,191,233
25/05/2021,886,3,1,30,31
25/05/2021,432,3,52,259,311
25/05/2021,805,3,66,152,218
25/05/2021,76,3,125,609,734
25/05/2021,84,3,331,660,991
25/05/2021,34,3,50,142,192
25/05/2021,143,3,145,442,587
25/05/2021,857,3,82,170,252
25/05/2021,294,3,152,477,629
25/05/2021,206,3,5,11,16
25/05/2021,285,3,50,177,227
25/05/2021,626,3,43,141,184
25/05/2021,750,3,78,386,464
25/05/2021,665,3,56,193,249
25/05/2021,295,3,36,136,172
25/05/2021,674,3,68,211,279
25/05/2021,372,3,200,595,795
25/05/2021,376,3,10,36,46
25/05/2021,270,3,36,203,239
25/05/2021,85,3,445,1122,1567
25/05/2021,639,3,68,184,252
25/05/2021,35,3,102,291,393
25/05/2021,919,3,102,305,407
25/05/2021,197,3,79,252,331
25/05/2021,659,3,51,176,227
25/05/2021,554,3,83,272,355
25/05/2021,307,3,121,427,548
25/05/2021,627,3,38,126,164
25/05/2021,520,3,75,219,294
25/05/2021,88,3,52,256,308
25/05/2021,738,3,73,258,331
25/05/2021,803,3,92,344,436
25/05/2021,101,3,62,233,295
25/05/2021,172,3,76,391,467
25/05/2021,19,3,122,394,516
25/05/2021,890,3,57,304,361
25/05/2021,815,3,391,951,1342
25/05/2021,466,3,62,229,291
25/05/2021,460,3,46,206,252
25/05/2021,64,3,33,130,163
25/05/2021,868,3,262,882,1144
25/05/2021,485,3,83,217,300
25/05/2021,99,3,184,699,883
25/05/2021,334,3,236,575,811
25/05/2021,723,3,77,262,339
25/05/2021,875,3,60,157,217
25/05/2021,128,3,54,163,217
25/05/2021,427,3,203,823,1026
25/05/2021,600,3,321,833,1154
25/05/2021,163,3,64,228,292
25/05/2021,936,3,18,53,71
25/05/2021,138,3,84,209,293
25/05/2021,354,3,2,4,6
25/05/2021,684,3,99,371,470
25/05/2021,909,3,0,4,4
25/05/2021,252,3,45,115,160
25/05/2021,51,3,260,903,1163
25/05/2021,417,3,123,656,779
25/05/2021,321,3,34,99,133
25/05/2021,213,3,83,337,420
25/05/2021,836,3,91,531,622
25/05/2021,266,3,45,150,195
25/05/2021,570,3,66,193,259
25/05/2021,423,3,95,569,664
25/05/2021,785,3,312,1192,1504
25/05/2021,400,3,41,121,162
25/05/2021,238,3,165,575,740
25/05/2021,187,3,52,161,213
25/05/2021,276,3,68,250,318
25/05/2021,189,3,32,159,191
25/05/2021,895,3,70,177,247
25/05/2021,28,3,44,154,198
25/05/2021,286,3,23,93,116
25/05/2021,380,3,78,275,353
25/05/2021,777,3,76,210,286
25/05/2021,897,3,55,194,249
25/05/2021,305,3,96,352,448
25/05/2021,696,3,91,284,375
25/05/2021,671,3,63,273,336
25/05/2021,775,3,49,163,212
25/05/2021,722,3,13,133,146
25/05/2021,793,3,83,288,371
25/05/2021,928,3,1,7,8
25/05/2021,449,3,67,293,360
25/05/2021,41,3,65,215,280
25/05/2021,602,3,234,713,947
25/05/2021,810,3,63,286,349
25/05/2021,942,3,0,1,1
25/05/2021,513,3,21,80,101
25/05/2021,345,3,66,196,262
25/05/2021,812,3,57,230,287
25/05/2021,26,3,86,288,374
25/05/2021,148,3,51,150,201
25/05/2021,240,3,164,586,750
25/05/2021,317,3,184,528,712
25/05/2021,146,3,178,557,735
25/05/2021,63,3,37,113,150
25/05/2021,576,3,6,49,55
25/05/2021,825,3,129,403,532
25/05/2021,192,3,54,167,221
25/05/2021,253,3,30,150,180
25/05/2021,683,3,71,224,295
25/05/2021,393,3,37,115,152
25/05/2021,186,3,40,104,144
25/05/2021,512,3,17,84,101
25/05/2021,162,3,359,781,1140
25/05/2021,436,3,58,212,270
25/05/2021,269,3,46,162,208
25/05/2021,474,3,43,167,210
25/05/2021,399,3,173,526,699
25/05/2021,56,3,121,304,425
25/05/2021,462,3,48,249,297
25/05/2021,597,3,65,202,267
25/05/2021,15,3,151,350,501
25/05/2021,247,3,86,356,442
25/05/2021,654,3,38,230,268
25/05/2021,350,3,59,160,219
25/05/2021,251,3,51,169,220
25/05/2021,9,3,91,270,361
25/05/2021,542,3,93,281,374
25/05/2021,344,3,84,264,348
25/05/2021,129,3,97,251,348
25/05/2021,115,3,27,113,140
25/05/2021,135,3,139,398,537
25/05/2021,428,3,31,190,221
25/05/2021,68,3,117,312,429
25/05/2021,884,3,11,73,84
25/05/2021,756,3,126,614,740
25/05/2021,662,3,146,439,585
25/05/2021,616,3,116,349,465
25/05/2021,933,3,0,2,2
25/05/2021,90,3,45,195,240
25/05/2021,159,3,81,287,368
25/05/2021,713,3,93,663,756
25/05/2021,721,3,369,1444,1813
25/05/2021,567,3,95,243,338
25/05/2021,746,3,54,219,273
25/05/2021,770,3,217,629,846
25/05/2021,736,3,26,78,104
25/05/2021,587,3,11,56,67
25/05/2021,229,3,142,390,532
25/05/2021,456,3,57,216,273
25/05/2021,937,3,1,1,2
25/05/2021,811,3,40,132,172
25/05/2021,547,3,375,1238,1613
25/05/2021,794,3,156,561,717
25/05/2021,27,3,224,540,764
25/05/2021,524,3,119,371,490
25/05/2021,931,3,0,1,1
25/05/2021,673,3,73,296,369
25/05/2021,149,3,99,285,384
25/05/2021,168,3,48,174,222
25/05/2021,164,3,63,315,378
25/05/2021,561,3,47,125,172
25/05/2021,205,3,73,208,281
25/05/2021,87,3,169,479,648
25/05/2021,631,3,11,46,57
25/05/2021,533,3,80,249,329
25/05/2021,737,3,34,105,139
25/05/2021,91,3,68,318,386
25/05/2021,374,3,38,102,140
25/05/2021,435,3,37,144,181
25/05/2021,246,3,174,630,804
25/05/2021,572,3,93,205,298
25/05/2021,749,3,47,148,195
25/05/2021,625,3,58,191,249
25/05/2021,463,3,150,596,746
25/05/2021,663,3,88,300,388
25/05/2021,140,3,53,197,250
25/05/2021,692,3,87,287,374
25/05/2021,877,3,4,45,49
25/05/2021,635,3,85,304,389
25/05/2021,655,3,111,366,477
25/05/2021,453,3,73,250,323
25/05/2021,457,3,36,125,161
25/05/2021,840,3,56,177,233
25/05/2021,608,3,211,974,1185
25/05/2021,507,3,107,465,572
25/05/2021,687,3,115,378,493
25/05/2021,677,3,32,112,144
25/05/2021,200,3,39,140,179
25/05/2021,591,3,98,201,299
25/05/2021,448,3,196,773,969
25/05/2021,25,3,59,262,321
25/05/2021,353,3,29,101,130
25/05/2021,555,3,202,576,778
25/05/2021,442,3,56,234,290
25/05/2021,904,3,85,361,446
25/05/2021,245,3,33,130,163
25/05/2021,444,3,83,236,319
25/05/2021,652,3,26,93,119
25/05/2021,46,3,83,167,250
25/05/2021,792,3,118,322,440
25/05/2021,145,3,99,355,454
25/05/2021,231,3,68,243,311
25/05/2021,133,3,38,146,184
25/05/2021,809,3,42,131,173
25/05/2021,922,3,0,7,7
25/05/2021,119,3,97,231,328
25/05/2021,581,3,97,300,397
25/05/2021,855,3,79,284,363
25/05/2021,831,3,83,251,334
25/05/2021,837,3,93,355,448
25/05/2021,257,3,320,1150,1470
25/05/2021,505,3,21,82,103
25/05/2021,709,3,180,537,717
25/05/2021,277,3,85,255,340
25/05/2021,434,3,15,64,79
25/05/2021,121,3,331,1063,1394
25/05/2021,176,3,82,290,372
25/05/2021,314,3,33,130,163
25/05/2021,835,3,102,351,453
25/05/2021,103,3,212,459,671
25/05/2021,32,3,79,240,319
25/05/2021,389,3,135,448,583
25/05/2021,859,3,14,25,39
25/05/2021,610,3,148,698,846
25/05/2021,697,3,56,212,268
25/05/2021,355,3,42,141,183
25/05/2021,501,3,101,434,535
25/05/2021,870,3,20,81,101
25/05/2021,499,3,44,145,189
25/05/2021,656,3,50,250,300
25/05/2021,636,3,65,196,261
25/05/2021,894,3,99,247,346
25/05/2021,97,3,133,454,587
25/05/2021,80,3,27,114,141
25/05/2021,601,3,56,208,264
25/05/2021,733,3,48,148,196
25/05/2021,188,3,102,370,472
25/05/2021,340,3,86,278,364
25/05/2021,117,3,210,490,700
25/05/2021,78,3,337,1165,1502
25/05/2021,807,3,80,166,246
25/05/2021,411,3,123,674,797
25/05/2021,212,3,89,357,446
25/05/2021,902,3,103,218,321
25/05/2021,330,3,72,233,305
25/05/2021,304,3,116,393,509
25/05/2021,338,3,79,300,379
25/05/2021,210,3,65,157,222
25/05/2021,493,3,75,154,229
25/05/2021,704,3,32,106,138
25/05/2021,879,3,1,40,41
25/05/2021,18,3,79,271,350
25/05/2021,47,3,102,197,299
25/05/2021,826,3,121,387,508
25/05/2021,765,3,81,283,364
25/05/2021,751,3,16,5,21
25/05/2021,236,3,39,165,204
25/05/2021,759,3,32,139,171
25/05/2021,154,3,101,371,472
25/05/2021,242,3,163,594,757
25/05/2021,221,3,76,208,284
25/05/2021,488,3,66,185,251
25/05/2021,854,3,133,565,698
25/05/2021,392,3,43,155,198
25/05/2021,250,3,82,268,350
25/05/2021,274,3,1,18,19
25/05/2021,366,3,69,176,245
25/05/2021,588,3,85,193,278
25/05/2021,767,3,199,604,803
25/05/2021,232,3,89,253,342
25/05/2021,480,3,55,111,166
25/05/2021,33,3,75,179,254
25/05/2021,860,3,115,217,332
25/05/2021,120,3,97,266,363
25/05/2021,177,3,31,111,142
25/05/2021,108,3,38,113,151
25/05/2021,429,3,83,269,352
25/05/2021,885,3,11,78,89
25/05/2021,623,3,114,316,430
25/05/2021,228,3,35,104,139
25/05/2021,475,3,175,531,706
25/05/2021,932,3,1,19,20
25/05/2021,755,3,141,606,747
25/05/2021,617,3,54,168,222
25/05/2021,193,3,93,265,358
25/05/2021,451,3,204,841,1045
25/05/2021,519,3,92,274,366
25/05/2021,917,3,7,44,51
25/05/2021,865,3,35,123,158
25/05/2021,106,3,116,484,600
25/05/2021,848,3,91,227,318
25/05/2021,262,3,42,102,144
25/05/2021,183,3,40,136,176
25/05/2021,594,3,155,543,698
25/05/2021,261,3,375,1426,1801
25/05/2021,288,3,18,78,96
25/05/2021,495,3,48,138,186
25/05/2021,910,3,11,76,87
25/05/2021,82,3,141,364,505
25/05/2021,454,3,53,299,352
25/05/2021,843,3,40,168,208
25/05/2021,892,3,3,10,13
25/05/2021,359,3,118,273,391
25/05/2021,328,3,70,278,348
25/05/2021,410,3,80,459,539
25/05/2021,441,3,157,588,745
25/05/2021,96,3,46,198,244
25/05/2021,53,3,85,276,361
25/05/2021,2,3,34,168,202
25/05/2021,830,3,368,1155,1523
25/05/2021,490,3,36,126,162
25/05/2021,531,3,92,299,391
25/05/2021,386,3,232,919,1151
25/05/2021,643,3,104,307,411
25/05/2021,158,3,42,124,166
25/05/2021,820,3,56,212,268
25/05/2021,327,3,216,769,985
25/05/2021,256,3,96,280,376
25/05/2021,818,3,86,315,401
25/05/2021,339,3,80,267,347
25/05/2021,203,3,85,245,330
25/05/2021,757,3,144,394,538
25/05/2021,486,3,65,326,391
25/05/2021,732,3,32,98,130
25/05/2021,791,3,69,278,347
25/05/2021,921,3,0,10,10
25/05/2021,93,3,92,267,359
25/05/2021,492,3,34,105,139
25/05/2021,613,3,26,110,136
25/05/2021,702,3,70,241,311
25/05/2021,69,3,84,299,383
25/05/2021,586,3,90,356,446
25/05/2021,175,3,50,178,228
25/05/2021,858,3,179,546,725
25/05/2021,406,3,158,385,543
25/05/2021,889,3,0,9,9
25/05/2021,795,3,74,214,288
25/05/2021,504,3,40,93,133
25/05/2021,378,3,51,208,259
25/05/2021,903,3,0,4,4
25/05/2021,398,3,24,48,72
25/05/2021,558,3,47,150,197
25/05/2021,883,3,12,80,92
25/05/2021,537,3,151,431,582
25/05/2021,477,3,46,189,235
25/05/2021,914,3,3,7,10
25/05/2021,536,3,58,178,236
25/05/2021,908,3,124,421,545
25/05/2021,302,3,85,361,446
25/05/2021,727,3,83,205,288
25/05/2021,926,3,14,48,62
25/05/2021,387,3,77,220,297
25/05/2021,367,3,96,479,575
25/05/2021,693,3,53,166,219
25/05/2021,604,3,206,506,712
25/05/2021,185,3,51,164,215
25/05/2021,124,3,45,180,225
25/05/2021,842,3,12,31,43
25/05/2021,30,3,129,361,490
25/05/2021,289,3,44,143,187
25/05/2021,850,3,303,574,877
25/05/2021,144,3,70,255,325
25/05/2021,61,3,109,297,406
25/05/2021,920,3,0,1,1
25/05/2021,401,3,45,136,181
25/05/2021,882,3,2,27,29
25/05/2021,784,3,244,946,1190
25/05/2021,416,3,23,104,127
25/05/2021,450,3,62,210,272
25/05/2021,239,3,61,208,269
25/05/2021,707,3,147,403,550
25/05/2021,666,3,103,286,389
25/05/2021,182,3,51,168,219
25/05/2021,522,3,68,198,266
25/05/2021,446,3,45,170,215
25/05/2021,296,3,42,111,153
25/05/2021,790,3,54,283,337
25/05/2021,491,3,87,384,471
25/05/2021,66,3,112,267,379
25/05/2021,281,3,68,259,327
25/05/2021,267,3,49,135,184
25/05/2021,532,3,364,1396,1760
25/05/2021,874,3,61,187,248
25/05/2021,719,3,48,153,201
25/05/2021,595,3,57,181,238
25/05/2021,44,3,122,458,580
25/05/2021,876,3,0,9,9
25/05/2021,577,3,59,234,293
25/05/2021,833,3,43,133,176
25/05/2021,300,3,108,478,586
25/05/2021,768,3,92,375,467
25/05/2021,397,3,33,84,117
25/05/2021,670,3,410,1301,1711
25/05/2021,898,3,62,180,242
25/05/2021,312,3,90,197,287
25/05/2021,851,3,106,294,400
25/05/2021,557,3,56,184,240
25/05/2021,853,3,38,216,254
25/05/2021,48,3,43,135,178
25/05/2021,348,3,33,143,176
25/05/2021,540,3,151,431,582
25/05/2021,249,3,178,652,830
25/05/2021,125,3,84,211,295
25/05/2021,7,3,33,165,198
25/05/2021,123,3,53,232,285
25/05/2021,105,3,96,335,431
25/05/2021,646,3,81,258,339
25/05/2021,941,3,0,7,7
25/05/2021,157,3,110,253,363
25/05/2021,166,3,49,250,299
25/05/2021,774,3,48,186,234
25/05/2021,497,3,82,361,443
25/05/2021,298,3,112,481,593
25/05/2021,585,3,167,490,657
25/05/2021,196,3,62,206,268
25/05/2021,935,3,1,0,1
25/05/2021,798,3,181,487,668
25/05/2021,653,3,18,76,94
25/05/2021,414,3,129,711,840
25/05/2021,156,3,80,302,382
25/05/2021,455,3,38,166,204
25/05/2021,562,3,25,85,110
25/05/2021,445,3,85,245,330
25/05/2021,741,3,33,107,140
25/05/2021,641,3,98,238,336
25/05/2021,343,3,36,192,228
25/05/2021,179,3,54,178,232
25/05/2021,828,3,126,351,477
25/05/2021,494,3,67,208,275
25/05/2021,621,3,61,186,247
25/05/2021,358,3,259,897,1156
25/05/2021,201,3,54,200,254
25/05/2021,905,3,0,4,4
25/05/2021,195,3,50,138,188
25/05/2021,473,3,40,124,164
25/05/2021,309,3,23,58,81
25/05/2021,802,3,199,837,1036
25/05/2021,244,3,51,203,254
25/05/2021,37,3,53,135,188
25/05/2021,161,3,363,777,1140
25/05/2021,443,3,55,236,291
25/05/2021,59,3,53,144,197
25/05/2021,95,3,174,583,757
25/05/2021,900,3,6,28,34
25/05/2021,383,3,195,788,983
25/05/2021,632,3,22,57,79
25/05/2021,194,3,1,2,3
25/05/2021,752,3,162,541,703
25/05/2021,418,3,32,79,111
25/05/2021,60,3,27,79,106
25/05/2021,658,3,51,183,234
25/05/2021,863,3,52,250,302
25/05/2021,918,3,1,8,9
25/05/2021,675,3,47,159,206
25/05/2021,681,3,123,254,377
25/05/2021,924,3,0,6,6
25/05/2021,534,3,81,221,302
25/05/2021,235,3,65,208,273
25/05/2021,871,3,132,410,542
25/05/2021,720,3,54,184,238
25/05/2021,649,3,87,210,297
25/05/2021,726,3,59,188,247
25/05/2021,297,3,81,329,410
25/05/2021,548,3,73,140,213
25/05/2021,315,3,12,62,74
25/05/2021,747,3,72,169,241
25/05/2021,169,3,73,347,420
25/05/2021,553,3,37,62,99
25/05/2021,573,3,68,192,260
25/05/2021,470,3,62,210,272
25/05/2021,23,3,13,45,58
25/05/2021,801,3,87,242,329
25/05/2021,849,3,108,281,389
25/05/2021,896,3,376,1238,1614
25/05/2021,379,3,80,349,429
25/05/2021,819,3,87,328,415
25/05/2021,50,3,41,132,173
25/05/2021,847,3,7,61,68
25/05/2021,915,3,1,25,26
25/05/2021,226,3,94,260,354
25/05/2021,560,3,206,597,803
25/05/2021,57,3,117,313,430
25/05/2021,437,3,76,225,301
25/05/2021,806,3,128,474,602
25/05/2021,211,3,81,317,398
25/05/2021,4,3,56,221,277
25/05/2021,67,3,96,268,364
25/05/2021,525,3,99,360,459
25/05/2021,152,3,69,240,309
25/05/2021,498,3,40,126,166
25/05/2021,368,3,103,475,578
25/05/2021,657,3,154,438,592
25/05/2021,669,3,69,221,290
25/05/2021,17,3,30,149,179
25/05/2021,287,3,119,485,604
25/05/2021,42,3,58,153,211
25/05/2021,361,3,94,320,414
25/05/2021,147,3,66,229,295
25/05/2021,413,3,109,607,716
25/05/2021,589,3,80,186,266
25/05/2021,153,3,100,376,476
25/05/2021,607,3,186,889,1075
25/05/2021,776,3,74,268,342
25/05/2021,198,3,104,299,403
25/05/2021,864,3,45,131,176
25/05/2021,648,3,68,215,283
25/05/2021,571,3,70,174,244
25/05/2021,888,3,7,51,58
25/05/2021,332,3,58,210,268
25/05/2021,816,3,236,764,1000
25/05/2021,390,3,145,478,623
25/05/2021,739,3,34,120,154
25/05/2021,433,3,169,672,841
25/05/2021,394,3,41,151,192
25/05/2021,467,3,44,228,272
25/05/2021,881,3,1,13,14
25/05/2021,142,3,51,122,173
25/05/2021,167,3,130,410,540
25/05/2021,12,3,34,114,148
25/05/2021,173,3,71,170,241
25/05/2021,529,3,80,156,236
25/05/2021,862,3,119,350,469
25/05/2021,496,3,18,86,104
25/05/2021,209,3,20,85,105
25/05/2021,527,3,55,137,192
25/05/2021,318,3,163,460,623
25/05/2021,565,3,214,598,812
25/05/2021,786,3,161,649,810
25/05/2021,237,3,151,527,678
25/05/2021,279,3,68,279,347
25/05/2021,178,3,83,279,362
25/05/2021,458,3,78,248,326
25/05/2021,735,3,30,110,140
25/05/2021,155,3,119,390,509
25/05/2021,54,3,84,175,259
25/05/2021,788,3,355,1363,1718
25/05/2021,478,3,145,221,366
25/05/2021,628,3,61,186,247
25/05/2021,489,3,4,24,28
25/05/2021,528,3,44,119,163
25/05/2021,550,3,131,369,500
25/05/2021,808,3,143,527,670
25/05/2021,301,3,105,392,497
25/05/2021,891,3,63,211,274
25/05/2021,55,3,56,120,176
25/05/2021,459,3,78,238,316
25/05/2021,181,3,63,169,232
25/05/2021,313,3,32,125,157
25/05/2021,716,3,49,194,243
25/05/2021,814,3,65,178,243
25/05/2021,337,3,30,85,115
25/05/2021,724,3,339,1120,1459
25/05/2021,844,3,34,140,174
25/05/2021,329,3,233,845,1078
25/05/2021,698,3,55,201,256
25/05/2021,856,3,166,471,637
25/05/2021,508,3,82,340,422
25/05/2021,911,3,75,329,404
25/05/2021,913,3,150,542,692
25/05/2021,319,3,21,78,99
25/05/2021,98,3,129,510,639
25/05/2021,299,3,28,131,159
25/05/2021,748,3,38,138,176
25/05/2021,263,3,66,190,256
25/05/2021,624,3,15,88,103
25/05/2021,731,3,45,127,172
25/05/2021,685,3,83,200,283
25/05/2021,216,3,58,237,295
25/05/2021,511,3,28,136,164
25/05/2021,583,3,30,113,143
25/05/2021,487,3,70,192,262
25/05/2021,703,3,51,162,213
25/05/2021,841,3,14,108,122
25/05/2021,369,3,204,643,847
25/05/2021,233,3,128,279,407
25/05/2021,381,3,4,1,5
25/05/2021,634,3,75,196,271
25/05/2021,86,3,45,183,228
25/05/2021,440,3,94,406,500
25/05/2021,593,3,242,888,1130
25/05/2021,778,3,148,337,485
25/05/2021,259,3,297,1118,1415
25/05/2021,151,3,42,183,225
25/05/2021,817,3,100,352,452
25/05/2021,342,3,48,246,294
25/05/2021,271,3,50,147,197
25/05/2021,420,3,223,517,740
25/05/2021,255,3,9,14,23
25/05/2021,184,3,45,137,182
25/05/2021,689,3,97,305,402
25/05/2021,131,3,92,246,338
25/05/2021,190,3,98,303,401
25/05/2021,526,3,46,110,156
25/05/2021,939,3,0,5,5
25/05/2021,365,3,64,158,222
25/05/2021,243,3,174,641,815
25/05/2021,510,3,83,399,482
25/05/2021,45,3,51,165,216
25/05/2021,126,3,113,330,443
25/05/2021,412,3,33,206,239
25/05/2021,341,3,282,940,1222
25/05/2021,582,3,326,1228,1554
25/05/2021,706,3,176,511,687
25/05/2021,39,3,82,262,344
25/05/2021,743,3,45,153,198
25/05/2021,930,3,1,25,26
25/05/2021,102,3,135,446,581
25/05/2021,199,3,42,157,199
25/05/2021,134,3,127,360,487
25/05/2021,543,3,357,1175,1532
25/05/2021,1,3,33,166,199
25/05/2021,660,3,38,155,193
25/05/2021,371,3,81,301,382
25/05/2021,823,3,63,182,245
25/05/2021,701,3,57,235,292
25/05/2021,878,3,8,80,88
25/05/2021,111,3,160,457,617
25/05/2021,265,3,46,132,178
25/05/2021,391,3,151,445,596
25/05/2021,514,3,18,92,110
25/05/2021,584,3,235,933,1168
25/05/2021,574,3,93,227,320
25/05/2021,598,3,372,1183,1555
25/05/2021,404,3,213,692,905
25/05/2021,647,3,51,181,232
25/05/2021,136,3,132,371,503
25/05/2021,686,3,55,168,223
25/05/2021,506,3,100,415,515
25/05/2021,484,3,76,202,278
25/05/2021,110,3,57,173,230
25/05/2021,832,3,71,214,285
25/05/2021,714,3,105,320,425
25/05/2021,838,3,64,200,264
25/05/2021,431,3,54,182,236
25/05/2021,728,3,81,242,323
25/05/2021,352,3,131,316,447
25/05/2021,439,3,43,178,221
25/05/2021,362,3,102,330,432
25/05/2021,382,3,0,1,1
25/05/2021,333,3,85,476,561
25/05/2021,360,3,59,202,261
25/05/2021,566,3,49,144,193
25/05/2021,712,3,65,206,271
25/05/2021,356,3,193,636,829
25/05/2021,311,3,106,330,436
25/05/2021,280,3,27,81,108
25/05/2021,217,3,78,303,381
25/05/2021,846,3,9,84,93
25/05/2021,907,3,169,509,678
25/05/2021,797,3,125,388,513
25/05/2021,824,3,148,555,703
25/05/2021,43,3,82,239,321
25/05/2021,293,3,72,263,335
25/05/2021,79,3,104,222,326
25/05/2021,465,3,53,202,255
25/05/2021,783,3,138,636,774
25/05/2021,114,3,99,326,425
25/05/2021,637,3,217,778,995
25/05/2021,500,3,17,81,98
25/05/2021,273,3,63,320,383
25/05/2021,599,3,345,1146,1491
25/05/2021,468,3,56,189,245
25/05/2021,336,3,293,961,1254
25/05/2021,405,3,40,134,174
25/05/2021,13,3,63,184,247
25/05/2021,283,3,68,215,283
25/05/2021,377,3,106,294,400
25/05/2021,640,3,94,212,306
25/05/2021,36,3,77,237,314
25/05/2021,503,3,85,357,442
25/05/2021,605,3,200,590,790
25/05/2021,395,3,41,133,174
25/05/2021,839,3,54,214,268
25/05/2021,113,3,45,136,181
25/05/2021,575,3,24,79,103
25/05/2021,569,3,82,204,286
25/05/2021,137,3,93,238,331
25/05/2021,373,3,84,210,294
25/05/2021,872,3,62,186,248
25/05/2021,758,3,96,301,397
25/05/2021,650,3,86,283,369
25/05/2021,551,3,151,450,601
25/05/2021,430,3,58,182,240
25/05/2021,538,3,90,330,420
25/05/2021,563,3,73,200,273
25/05/2021,934,3,1,21,22
25/05/2021,264,3,46,111,157
25/05/2021,535,3,75,183,258
25/05/2021,901,3,5,19,24
25/05/2021,104,3,97,358,455
25/05/2021,248,3,63,142,205
25/05/2021,112,3,67,166,233
25/05/2021,272,3,106,310,416
25/05/2021,899,3,210,775,985
25/05/2021,83,3,478,1244,1722
25/05/2021,688,3,85,211,296
25/05/2021,402,3,139,393,532
25/05/2021,479,3,63,102,165
25/05/2021,804,3,166,556,722
25/05/2021,408,3,132,710,842
25/05/2021,745,3,57,223,280
25/05/2021,278,3,65,210,275
25/05/2021,700,3,55,223,278
25/05/2021,100,3,184,718,902
25/05/2021,122,3,96,282,378
25/05/2021,71,3,48,210,258
25/05/2021,89,3,140,372,512
25/05/2021,753,3,79,331,410
25/05/2021,370,3,97,471,568
25/05/2021,171,3,20,77,97
25/05/2021,615,3,103,298,401
25/05/2021,710,3,62,208,270
25/05/2021,852,3,185,426,611
25/05/2021,618,3,62,287,349
25/05/2021,880,3,1,23,24
25/05/2021,31,3,78,256,334
25/05/2021,725,3,69,201,270
25/05/2021,483,3,106,284,390
25/05/2021,827,3,221,527,748
25/05/2021,21,3,88,317,405
25/05/2021,214,3,83,317,400
25/05/2021,346,3,41,163,204
25/05/2021,664,3,135,425,560
25/05/2021,208,3,35,95,130
25/05/2021,225,3,92,304,396
25/05/2021,160,3,1,21,22
25/05/2021,363,3,101,328,429
25/05/2021,845,3,61,238,299
25/05/2021,116,3,91,209,300
25/05/2021,81,3,30,101,131
25/05/2021,645,3,81,235,316
25/05/2021,606,3,111,362,473
25/05/2021,552,3,147,406,553
25/05/2021,351,3,240,831,1071
25/05/2021,771,3,56,368,424
25/05/2021,388,3,158,437,595
25/05/2021,291,3,84,372,456
25/05/2021,773,3,46,181,227
25/05/2021,331,3,63,194,257
25/05/2021,476,3,51,189,240
25/05/2021,821,3,112,370,482
25/05/2021,668,3,28,119,147
25/05/2021,679,3,62,176,238
25/05/2021,530,3,48,146,194
25/05/2021,407,3,77,448,525
25/05/2021,174,3,44,128,172
25/05/2021,559,3,216,604,820
25/05/2021,357,3,209,713,922
25/05/2021,316,3,69,181,250
25/05/2021,38,3,76,221,297
25/05/2021,290,3,99,420,519
25/05/2021,5,3,35,168,203
25/05/2021,107,3,200,720,920
25/05/2021,578,3,18,56,74
25/05/2021,421,3,162,317,479
25/05/2021,24,3,13,45,58
25/05/2021,517,3,48,131,179
25/05/2021,469,3,46,210,256
25/05/2021,580,3,101,258,359
25/05/2021,425,3,57,302,359
25/05/2021,680,3,49,139,188
25/05/2021,461,3,80,356,436
25/05/2021,651,3,65,245,310
25/05/2021,661,3,149,440,589
25/05/2021,694,3,52,174,226
25/05/2021,260,3,378,1450,1828
25/05/2021,323,3,51,152,203
25/05/2021,349,3,40,134,174
25/05/2021,544,3,101,278,379
25/05/2021,564,3,112,320,432
25/05/2021,215,3,46,178,224
25/05/2021,75,3,130,617,747
25/05/2021,77,3,134,649,783
25/05/2021,384,3,90,289,379
25/05/2021,633,3,51,136,187
25/05/2021,219,3,44,200,244
25/05/2021,619,3,53,194,247
25/05/2021,556,3,222,633,855
25/05/2021,887,3,1,28,29
25/05/2021,867,3,90,165,255
25/05/2021,224,3,33,111,144
25/05/2021,130,3,160,469,629
25/05/2021,592,3,114,401,515
25/05/2021,65,3,102,275,377
25/05/2021,282,3,66,209,275
25/05/2021,254,3,43,148,191
25/05/2021,781,3,161,487,648
25/05/2021,396,3,37,98,135
25/05/2021,676,3,44,108,152
25/05/2021,335,3,82,225,307
25/05/2021,419,3,110,395,505
25/05/2021,207,3,36,123,159
25/05/2021,779,3,61,149,210
25/05/2021,629,3,88,262,350
25/05/2021,347,3,347,703,1050
25/05/2021,869,3,90,311,401
25/05/2021,515,3,43,107,150
25/05/2021,789,3,97,301,398
25/05/2021,20,3,58,103,161
26/05/2021,867,3,81,146,227
26/05/2021,869,3,92,304,396
26/05/2021,781,3,155,484,639
26/05/2021,20,3,50,93,143
26/05/2021,676,3,34,123,157
26/05/2021,347,3,315,716,1031
26/05/2021,779,3,63,176,239
26/05/2021,789,3,96,325,421
26/05/2021,629,3,87,249,336
26/05/2021,396,3,31,105,136
26/05/2021,282,3,61,239,300
26/05/2021,65,3,94,319,413
26/05/2021,224,3,36,124,160
26/05/2021,419,3,126,424,550
26/05/2021,254,3,43,147,190
26/05/2021,592,3,105,388,493
26/05/2021,335,3,86,235,321
26/05/2021,515,3,39,114,153
26/05/2021,130,3,138,471,609
26/05/2021,207,3,35,138,173
26/05/2021,239,3,55,233,288
26/05/2021,296,3,36,115,151
26/05/2021,450,3,59,205,264
26/05/2021,267,3,37,120,157
26/05/2021,416,3,36,117,153
26/05/2021,882,3,2,32,34
26/05/2021,666,3,99,273,372
26/05/2021,281,3,71,278,349
26/05/2021,182,3,59,203,262
26/05/2021,401,3,36,149,185
26/05/2021,784,3,220,929,1149
26/05/2021,522,3,64,192,256
26/05/2021,491,3,97,458,555
26/05/2021,790,3,55,293,348
26/05/2021,707,3,135,395,530
26/05/2021,446,3,36,177,213
26/05/2021,66,3,101,311,412
26/05/2021,933,3,0,1,1
26/05/2021,756,3,117,641,758
26/05/2021,9,3,93,297,390
26/05/2021,616,3,111,345,456
26/05/2021,68,3,100,359,459
26/05/2021,428,3,39,180,219
26/05/2021,129,3,102,282,384
26/05/2021,135,3,118,414,532
26/05/2021,344,3,73,246,319
26/05/2021,884,3,10,84,94
26/05/2021,662,3,138,422,560
26/05/2021,115,3,26,123,149
26/05/2021,542,3,97,259,356
26/05/2021,143,3,147,478,625
26/05/2021,34,3,55,143,198
26/05/2021,857,3,89,210,299
26/05/2021,886,3,0,30,30
26/05/2021,84,3,290,651,941
26/05/2021,285,3,52,168,220
26/05/2021,294,3,154,452,606
26/05/2021,750,3,60,407,467
26/05/2021,432,3,47,278,325
26/05/2021,699,3,47,177,224
26/05/2021,626,3,45,162,207
26/05/2021,805,3,66,152,218
26/05/2021,180,3,68,264,332
26/05/2021,206,3,6,13,19
26/05/2021,76,3,125,601,726
26/05/2021,220,3,61,231,292
26/05/2021,385,3,99,268,367
26/05/2021,403,3,144,401,545
26/05/2021,509,3,77,386,463
26/05/2021,322,3,87,230,317
26/05/2021,579,3,38,185,223
26/05/2021,308,3,85,331,416
26/05/2021,603,3,165,554,719
26/05/2021,715,3,168,388,556
26/05/2021,438,3,57,141,198
26/05/2021,764,3,30,102,132
26/05/2021,218,3,92,322,414
26/05/2021,58,3,86,542,628
26/05/2021,472,3,197,735,932
26/05/2021,447,3,39,125,164
26/05/2021,800,3,100,254,354
26/05/2021,682,3,33,98,131
26/05/2021,471,3,58,139,197
26/05/2021,8,3,68,187,255
26/05/2021,22,3,69,313,382
26/05/2021,303,3,97,336,433
26/05/2021,761,3,40,132,172
26/05/2021,268,3,132,490,622
26/05/2021,546,3,138,405,543
26/05/2021,730,3,55,170,225
26/05/2021,234,3,35,100,135
26/05/2021,787,3,337,1354,1691
26/05/2021,230,3,70,195,265
26/05/2021,6,3,33,170,203
26/05/2021,873,3,112,362,474
26/05/2021,521,3,48,143,191
26/05/2021,799,3,27,64,91
26/05/2021,325,3,61,265,326
26/05/2021,118,3,96,257,353
26/05/2021,938,3,0,5,5
26/05/2021,539,3,112,323,435
26/05/2021,734,3,35,98,133
26/05/2021,925,3,0,1,1
26/05/2021,258,3,336,1353,1689
26/05/2021,284,3,46,93,139
26/05/2021,49,3,35,147,182
26/05/2021,923,3,2,1,3
26/05/2021,364,3,95,311,406
26/05/2021,772,3,109,391,500
26/05/2021,326,3,25,70,95
26/05/2021,691,3,58,226,284
26/05/2021,612,3,134,717,851
26/05/2021,426,3,45,153,198
26/05/2021,481,3,98,222,320
26/05/2021,222,3,55,206,261
26/05/2021,906,3,14,26,40
26/05/2021,861,3,128,339,467
26/05/2021,127,3,43,168,211
26/05/2021,52,3,111,380,491
26/05/2021,275,3,82,280,362
26/05/2021,742,3,77,223,300
26/05/2021,310,3,281,1080,1361
26/05/2021,452,3,65,206,271
26/05/2021,227,3,34,128,162
26/05/2021,638,3,140,338,478
26/05/2021,780,3,223,658,881
26/05/2021,11,3,44,187,231
26/05/2021,866,3,130,580,710
26/05/2021,614,3,40,182,222
26/05/2021,829,3,124,566,690
26/05/2021,717,3,49,222,271
26/05/2021,409,3,30,96,126
26/05/2021,705,3,21,85,106
26/05/2021,170,3,94,382,476
26/05/2021,424,3,105,601,706
26/05/2021,70,3,98,556,654
26/05/2021,711,3,62,183,245
26/05/2021,292,3,118,523,641
26/05/2021,754,3,107,357,464
26/05/2021,139,3,74,243,317
26/05/2021,202,3,142,662,804
26/05/2021,3,3,33,159,192
26/05/2021,813,3,62,197,259
26/05/2021,72,3,105,549,654
26/05/2021,760,3,68,339,407
26/05/2021,518,3,17,87,104
26/05/2021,464,3,79,337,416
26/05/2021,422,3,64,184,248
26/05/2021,622,3,194,542,736
26/05/2021,204,3,78,229,307
26/05/2021,92,3,69,240,309
26/05/2021,782,3,123,538,661
26/05/2021,642,3,96,240,336
26/05/2021,247,3,103,357,460
26/05/2021,462,3,39,256,295
26/05/2021,512,3,16,84,100
26/05/2021,56,3,112,364,476
26/05/2021,186,3,41,105,146
26/05/2021,192,3,52,166,218
26/05/2021,393,3,37,119,156
26/05/2021,597,3,63,159,222
26/05/2021,162,3,332,775,1107
26/05/2021,15,3,147,341,488
26/05/2021,269,3,37,166,203
26/05/2021,654,3,41,221,262
26/05/2021,683,3,65,229,294
26/05/2021,350,3,54,180,234
26/05/2021,251,3,41,159,200
26/05/2021,825,3,132,404,536
26/05/2021,436,3,51,210,261
26/05/2021,399,3,168,502,670
26/05/2021,253,3,31,146,177
26/05/2021,474,3,48,181,229
26/05/2021,427,3,203,865,1068
26/05/2021,213,3,97,335,432
26/05/2021,163,3,66,229,295
26/05/2021,128,3,40,146,186
26/05/2021,875,3,47,161,208
26/05/2021,354,3,1,3,4
26/05/2021,600,3,300,804,1104
26/05/2021,684,3,88,368,456
26/05/2021,266,3,41,161,202
26/05/2021,138,3,90,232,322
26/05/2021,51,3,258,897,1155
26/05/2021,936,3,15,46,61
26/05/2021,252,3,52,108,160
26/05/2021,836,3,79,498,577
26/05/2021,909,3,1,2,3
26/05/2021,321,3,44,110,154
26/05/2021,417,3,106,616,722
26/05/2021,197,3,73,263,336
26/05/2021,659,3,37,201,238
26/05/2021,665,3,43,228,271
26/05/2021,376,3,15,46,61
26/05/2021,372,3,172,599,771
26/05/2021,554,3,74,318,392
26/05/2021,35,3,102,274,376
26/05/2021,627,3,39,139,178
26/05/2021,295,3,36,169,205
26/05/2021,639,3,74,179,253
26/05/2021,85,3,403,1114,1517
26/05/2021,919,3,102,329,431
26/05/2021,270,3,39,194,233
26/05/2021,307,3,108,415,523
26/05/2021,674,3,71,249,320
26/05/2021,460,3,45,183,228
26/05/2021,723,3,59,222,281
26/05/2021,738,3,83,316,399
26/05/2021,172,3,86,353,439
26/05/2021,99,3,182,743,925
26/05/2021,803,3,99,313,412
26/05/2021,466,3,69,212,281
26/05/2021,334,3,225,613,838
26/05/2021,88,3,50,211,261
26/05/2021,101,3,64,269,333
26/05/2021,890,3,57,319,376
26/05/2021,868,3,253,916,1169
26/05/2021,485,3,89,216,305
26/05/2021,64,3,30,141,171
26/05/2021,520,3,66,205,271
26/05/2021,815,3,356,914,1270
26/05/2021,19,3,106,388,494
26/05/2021,317,3,187,527,714
26/05/2021,576,3,19,50,69
26/05/2021,812,3,57,209,266
26/05/2021,148,3,46,124,170
26/05/2021,26,3,83,324,407
26/05/2021,240,3,146,632,778
26/05/2021,63,3,38,126,164
26/05/2021,345,3,59,187,246
26/05/2021,942,3,0,1,1
26/05/2021,513,3,36,85,121
26/05/2021,146,3,159,544,703
26/05/2021,810,3,65,281,346
26/05/2021,696,3,93,287,380
26/05/2021,276,3,70,272,342
26/05/2021,305,3,86,327,413
26/05/2021,423,3,95,573,668
26/05/2021,286,3,32,88,120
26/05/2021,28,3,52,163,215
26/05/2021,238,3,150,618,768
26/05/2021,380,3,78,253,331
26/05/2021,895,3,66,185,251
26/05/2021,785,3,294,1199,1493
26/05/2021,400,3,33,127,160
26/05/2021,777,3,80,215,295
26/05/2021,897,3,63,273,336
26/05/2021,187,3,43,141,184
26/05/2021,189,3,35,147,182
26/05/2021,570,3,65,194,259
26/05/2021,449,3,62,284,346
26/05/2021,671,3,70,274,344
26/05/2021,722,3,20,133,153
26/05/2021,793,3,74,298,372
26/05/2021,41,3,51,260,311
26/05/2021,602,3,215,733,948
26/05/2021,775,3,48,177,225
26/05/2021,928,3,0,2,2
26/05/2021,124,3,41,182,223
26/05/2021,842,3,10,29,39
26/05/2021,30,3,116,410,526
26/05/2021,289,3,40,154,194
26/05/2021,185,3,45,157,202
26/05/2021,850,3,294,584,878
26/05/2021,144,3,60,264,324
26/05/2021,61,3,106,337,443
26/05/2021,604,3,197,534,731
26/05/2021,304,3,99,387,486
26/05/2021,212,3,104,353,457
26/05/2021,411,3,100,628,728
26/05/2021,78,3,319,1122,1441
26/05/2021,338,3,98,303,401
26/05/2021,210,3,52,184,236
26/05/2021,902,3,100,217,317
26/05/2021,117,3,185,508,693
26/05/2021,493,3,73,159,232
26/05/2021,330,3,59,229,288
26/05/2021,807,3,78,176,254
26/05/2021,453,3,69,237,306
26/05/2021,663,3,85,317,402
26/05/2021,463,3,162,619,781
26/05/2021,655,3,118,350,468
26/05/2021,140,3,60,169,229
26/05/2021,457,3,35,110,145
26/05/2021,877,3,4,53,57
26/05/2021,840,3,51,189,240
26/05/2021,635,3,85,344,429
26/05/2021,692,3,91,303,394
26/05/2021,168,3,35,149,184
26/05/2021,561,3,35,125,160
26/05/2021,770,3,201,655,856
26/05/2021,27,3,198,565,763
26/05/2021,713,3,94,655,749
26/05/2021,746,3,45,226,271
26/05/2021,567,3,104,275,379
26/05/2021,794,3,167,589,756
26/05/2021,811,3,43,125,168
26/05/2021,547,3,354,1174,1528
26/05/2021,229,3,138,382,520
26/05/2021,456,3,55,210,265
26/05/2021,90,3,55,185,240
26/05/2021,149,3,101,276,377
26/05/2021,164,3,64,264,328
26/05/2021,587,3,23,71,94
26/05/2021,159,3,70,318,388
26/05/2021,721,3,334,1435,1769
26/05/2021,524,3,103,368,471
26/05/2021,937,3,1,0,1
26/05/2021,736,3,33,92,125
26/05/2021,673,3,61,327,388
26/05/2021,631,3,16,58,74
26/05/2021,749,3,37,154,191
26/05/2021,572,3,93,213,306
26/05/2021,737,3,46,138,184
26/05/2021,246,3,148,676,824
26/05/2021,205,3,63,212,275
26/05/2021,435,3,43,151,194
26/05/2021,374,3,46,117,163
26/05/2021,91,3,67,290,357
26/05/2021,87,3,157,508,665
26/05/2021,533,3,68,241,309
26/05/2021,625,3,63,179,242
26/05/2021,870,3,25,61,86
26/05/2021,80,3,30,126,156
26/05/2021,499,3,56,161,217
26/05/2021,697,3,50,220,270
26/05/2021,340,3,95,302,397
26/05/2021,601,3,50,228,278
26/05/2021,636,3,74,201,275
26/05/2021,188,3,90,369,459
26/05/2021,894,3,72,250,322
26/05/2021,501,3,105,508,613
26/05/2021,656,3,36,232,268
26/05/2021,610,3,144,720,864
26/05/2021,97,3,136,485,621
26/05/2021,355,3,35,131,166
26/05/2021,859,3,10,31,41
26/05/2021,733,3,35,162,197
26/05/2021,46,3,73,172,245
26/05/2021,145,3,91,349,440
26/05/2021,353,3,25,92,117
26/05/2021,200,3,44,143,187
26/05/2021,507,3,104,541,645
26/05/2021,442,3,51,199,250
26/05/2021,652,3,16,101,117
26/05/2021,245,3,34,135,169
26/05/2021,581,3,95,316,411
26/05/2021,792,3,106,339,445
26/05/2021,608,3,192,960,1152
26/05/2021,809,3,41,99,140
26/05/2021,687,3,101,370,471
26/05/2021,904,3,84,364,448
26/05/2021,25,3,59,268,327
26/05/2021,119,3,97,240,337
26/05/2021,591,3,98,195,293
26/05/2021,448,3,207,800,1007
26/05/2021,444,3,90,234,324
26/05/2021,133,3,34,163,197
26/05/2021,677,3,37,130,167
26/05/2021,555,3,200,563,763
26/05/2021,231,3,70,277,347
26/05/2021,922,3,0,5,5
26/05/2021,505,3,36,92,128
26/05/2021,32,3,77,242,319
26/05/2021,176,3,78,316,394
26/05/2021,277,3,70,247,317
26/05/2021,389,3,130,482,612
26/05/2021,837,3,97,391,488
26/05/2021,434,3,11,64,75
26/05/2021,709,3,169,522,691
26/05/2021,314,3,38,120,158
26/05/2021,835,3,91,347,438
26/05/2021,855,3,83,260,343
26/05/2021,103,3,208,449,657
26/05/2021,831,3,90,271,361
26/05/2021,257,3,300,1144,1444
26/05/2021,121,3,314,1001,1315
26/05/2021,914,3,4,9,13
26/05/2021,727,3,88,245,333
26/05/2021,908,3,105,479,584
26/05/2021,693,3,49,177,226
26/05/2021,367,3,105,435,540
26/05/2021,926,3,15,57,72
26/05/2021,302,3,85,395,480
26/05/2021,387,3,72,205,277
26/05/2021,536,3,48,166,214
26/05/2021,848,3,96,259,355
26/05/2021,451,3,217,863,1080
26/05/2021,106,3,112,506,618
26/05/2021,865,3,33,138,171
26/05/2021,262,3,46,106,152
26/05/2021,755,3,129,616,745
26/05/2021,617,3,49,154,203
26/05/2021,475,3,178,523,701
26/05/2021,183,3,43,124,167
26/05/2021,228,3,37,115,152
26/05/2021,594,3,139,599,738
26/05/2021,519,3,84,263,347
26/05/2021,917,3,4,44,48
26/05/2021,193,3,80,265,345
26/05/2021,932,3,0,26,26
26/05/2021,154,3,94,352,446
26/05/2021,242,3,138,637,775
26/05/2021,759,3,41,150,191
26/05/2021,879,3,2,34,36
26/05/2021,704,3,25,95,120
26/05/2021,18,3,66,252,318
26/05/2021,47,3,102,222,324
26/05/2021,751,3,12,3,15
26/05/2021,765,3,77,267,344
26/05/2021,221,3,60,223,283
26/05/2021,488,3,62,188,250
26/05/2021,236,3,39,170,209
26/05/2021,826,3,123,422,545
26/05/2021,854,3,148,588,736
26/05/2021,33,3,73,223,296
26/05/2021,623,3,106,291,397
26/05/2021,767,3,185,634,819
26/05/2021,588,3,81,193,274
26/05/2021,429,3,87,272,359
26/05/2021,480,3,61,117,178
26/05/2021,274,3,1,27,28
26/05/2021,250,3,82,255,337
26/05/2021,177,3,31,114,145
26/05/2021,860,3,106,226,332
26/05/2021,108,3,34,134,168
26/05/2021,885,3,10,88,98
26/05/2021,392,3,48,160,208
26/05/2021,120,3,99,273,372
26/05/2021,366,3,65,192,257
26/05/2021,232,3,88,257,345
26/05/2021,586,3,105,356,461
26/05/2021,795,3,80,200,280
26/05/2021,406,3,148,343,491
26/05/2021,537,3,149,424,573
26/05/2021,504,3,42,98,140
26/05/2021,613,3,18,138,156
26/05/2021,903,3,1,4,5
26/05/2021,702,3,64,240,304
26/05/2021,492,3,28,112,140
26/05/2021,858,3,174,548,722
26/05/2021,93,3,93,282,375
26/05/2021,378,3,46,226,272
26/05/2021,558,3,41,151,192
26/05/2021,883,3,10,92,102
26/05/2021,398,3,23,60,83
26/05/2021,69,3,73,287,360
26/05/2021,175,3,48,195,243
26/05/2021,889,3,0,8,8
26/05/2021,477,3,39,193,232
26/05/2021,892,3,2,10,12
26/05/2021,288,3,21,76,97
26/05/2021,328,3,59,277,336
26/05/2021,359,3,122,279,401
26/05/2021,495,3,50,152,202
26/05/2021,261,3,349,1452,1801
26/05/2021,454,3,44,326,370
26/05/2021,82,3,156,376,532
26/05/2021,843,3,42,162,204
26/05/2021,910,3,10,88,98
26/05/2021,490,3,39,134,173
26/05/2021,158,3,46,120,166
26/05/2021,256,3,97,310,407
26/05/2021,791,3,66,235,301
26/05/2021,410,3,77,447,524
26/05/2021,830,3,363,1107,1470
26/05/2021,96,3,41,218,259
26/05/2021,531,3,105,317,422
26/05/2021,339,3,97,264,361
26/05/2021,486,3,64,330,394
26/05/2021,820,3,54,234,288
26/05/2021,818,3,74,350,424
26/05/2021,757,3,115,416,531
26/05/2021,732,3,26,113,139
26/05/2021,643,3,109,284,393
26/05/2021,2,3,33,159,192
26/05/2021,53,3,79,318,397
26/05/2021,203,3,70,238,308
26/05/2021,386,3,221,975,1196
26/05/2021,441,3,171,595,766
26/05/2021,921,3,0,8,8
26/05/2021,327,3,205,801,1006
26/05/2021,77,3,124,652,776
26/05/2021,215,3,39,195,234
26/05/2021,219,3,36,228,264
26/05/2021,75,3,127,650,777
26/05/2021,349,3,39,137,176
26/05/2021,633,3,43,169,212
26/05/2021,619,3,56,210,266
26/05/2021,556,3,230,628,858
26/05/2021,384,3,98,327,425
26/05/2021,887,3,1,27,28
26/05/2021,544,3,86,262,348
26/05/2021,564,3,100,292,392
26/05/2021,323,3,35,124,159
26/05/2021,778,3,150,338,488
26/05/2021,259,3,281,1111,1392
26/05/2021,243,3,153,734,887
26/05/2021,689,3,101,327,428
26/05/2021,365,3,59,175,234
26/05/2021,817,3,85,336,421
26/05/2021,131,3,89,267,356
26/05/2021,151,3,37,166,203
26/05/2021,939,3,1,6,7
26/05/2021,255,3,8,17,25
26/05/2021,342,3,44,269,313
26/05/2021,593,3,199,792,991
26/05/2021,190,3,93,286,379
26/05/2021,420,3,189,535,724
26/05/2021,184,3,41,114,155
26/05/2021,271,3,43,157,200
26/05/2021,526,3,41,107,148
26/05/2021,720,3,57,174,231
26/05/2021,726,3,63,175,238
26/05/2021,548,3,71,139,210
26/05/2021,871,3,144,435,579
26/05/2021,649,3,88,210,298
26/05/2021,297,3,73,378,451
26/05/2021,315,3,14,72,86
26/05/2021,169,3,82,323,405
26/05/2021,747,3,56,174,230
26/05/2021,105,3,95,351,446
26/05/2021,646,3,84,244,328
26/05/2021,585,3,143,500,643
26/05/2021,157,3,107,240,347
26/05/2021,298,3,119,525,644
26/05/2021,166,3,50,214,264
26/05/2021,196,3,53,198,251
26/05/2021,123,3,47,218,265
26/05/2021,7,3,34,156,190
26/05/2021,941,3,0,7,7
26/05/2021,497,3,96,438,534
26/05/2021,935,3,1,0,1
26/05/2021,125,3,80,207,287
26/05/2021,798,3,153,486,639
26/05/2021,774,3,45,163,208
26/05/2021,44,3,132,471,603
26/05/2021,577,3,60,291,351
26/05/2021,719,3,54,158,212
26/05/2021,874,3,67,174,241
26/05/2021,876,3,0,10,10
26/05/2021,595,3,51,169,220
26/05/2021,532,3,326,1365,1691
26/05/2021,540,3,132,390,522
26/05/2021,768,3,82,410,492
26/05/2021,300,3,112,518,630
26/05/2021,853,3,45,210,255
26/05/2021,833,3,47,104,151
26/05/2021,397,3,28,83,111
26/05/2021,312,3,95,204,299
26/05/2021,851,3,106,292,398
26/05/2021,898,3,58,186,244
26/05/2021,249,3,157,694,851
26/05/2021,557,3,50,180,230
26/05/2021,670,3,391,1249,1640
26/05/2021,348,3,31,149,180
26/05/2021,48,3,39,148,187
26/05/2021,418,3,31,91,122
26/05/2021,675,3,45,164,209
26/05/2021,900,3,16,20,36
26/05/2021,752,3,148,560,708
26/05/2021,534,3,75,217,292
26/05/2021,681,3,123,287,410
26/05/2021,632,3,25,65,90
26/05/2021,863,3,52,241,293
26/05/2021,383,3,192,794,986
26/05/2021,235,3,54,219,273
26/05/2021,60,3,23,73,96
26/05/2021,918,3,1,6,7
26/05/2021,658,3,39,198,237
26/05/2021,924,3,0,11,11
26/05/2021,194,3,0,1,1
26/05/2021,358,3,257,900,1157
26/05/2021,494,3,67,183,250
26/05/2021,641,3,96,251,347
26/05/2021,414,3,106,662,768
26/05/2021,179,3,55,196,251
26/05/2021,828,3,127,325,452
26/05/2021,156,3,81,326,407
26/05/2021,343,3,35,202,237
26/05/2021,201,3,48,169,217
26/05/2021,653,3,12,86,98
26/05/2021,455,3,31,180,211
26/05/2021,741,3,43,128,171
26/05/2021,562,3,26,99,125
26/05/2021,621,3,59,211,270
26/05/2021,905,3,0,2,2
26/05/2021,445,3,72,252,324
26/05/2021,309,3,17,56,73
26/05/2021,443,3,54,241,295
26/05/2021,473,3,46,122,168
26/05/2021,802,3,171,811,982
26/05/2021,244,3,43,219,262
26/05/2021,195,3,44,136,180
26/05/2021,95,3,159,614,773
26/05/2021,59,3,43,156,199
26/05/2021,161,3,330,760,1090
26/05/2021,37,3,56,142,198
26/05/2021,841,3,14,116,130
26/05/2021,634,3,79,196,275
26/05/2021,440,3,96,422,518
26/05/2021,369,3,203,596,799
26/05/2021,263,3,67,186,253
26/05/2021,233,3,130,301,431
26/05/2021,86,3,54,175,229
26/05/2021,703,3,46,183,229
26/05/2021,487,3,78,189,267
26/05/2021,731,3,46,108,154
26/05/2021,685,3,99,254,353
26/05/2021,216,3,59,249,308
26/05/2021,624,3,22,76,98
26/05/2021,583,3,33,134,167
26/05/2021,748,3,30,155,185
26/05/2021,511,3,42,149,191
26/05/2021,381,3,3,0,3
26/05/2021,648,3,67,198,265
26/05/2021,776,3,64,249,313
26/05/2021,607,3,166,890,1056
26/05/2021,42,3,55,150,205
26/05/2021,589,3,82,203,285
26/05/2021,147,3,58,237,295
26/05/2021,153,3,93,367,460
26/05/2021,864,3,48,128,176
26/05/2021,571,3,72,187,259
26/05/2021,198,3,104,308,412
26/05/2021,888,3,4,49,53
26/05/2021,17,3,34,153,187
26/05/2021,332,3,46,234,280
26/05/2021,287,3,127,536,663
26/05/2021,361,3,93,306,399
26/05/2021,413,3,93,574,667
26/05/2021,849,3,103,330,433
26/05/2021,470,3,79,254,333
26/05/2021,50,3,36,155,191
26/05/2021,847,3,4,60,64
26/05/2021,801,3,90,243,333
26/05/2021,379,3,77,339,416
26/05/2021,553,3,24,59,83
26/05/2021,573,3,82,212,294
26/05/2021,23,3,15,50,65
26/05/2021,896,3,353,1151,1504
26/05/2021,819,3,86,291,377
26/05/2021,669,3,74,267,341
26/05/2021,152,3,61,247,308
26/05/2021,525,3,85,335,420
26/05/2021,915,3,2,22,24
26/05/2021,211,3,92,322,414
26/05/2021,560,3,204,596,800
26/05/2021,437,3,71,244,315
26/05/2021,498,3,45,146,191
26/05/2021,57,3,99,341,440
26/05/2021,4,3,47,230,277
26/05/2021,657,3,141,480,621
26/05/2021,67,3,87,299,386
26/05/2021,806,3,138,525,663
26/05/2021,226,3,90,258,348
26/05/2021,368,3,109,437,546
26/05/2021,337,3,42,119,161
26/05/2021,299,3,36,117,153
26/05/2021,913,3,142,560,702
26/05/2021,844,3,26,164,190
26/05/2021,319,3,12,62,74
26/05/2021,508,3,84,392,476
26/05/2021,98,3,124,560,684
26/05/2021,856,3,148,512,660
26/05/2021,911,3,70,396,466
26/05/2021,716,3,46,206,252
26/05/2021,313,3,38,111,149
26/05/2021,181,3,78,200,278
26/05/2021,55,3,56,134,190
26/05/2021,329,3,219,874,1093
26/05/2021,459,3,85,215,300
26/05/2021,724,3,319,1039,1358
26/05/2021,814,3,58,151,209
26/05/2021,550,3,107,334,441
26/05/2021,891,3,60,208,268
26/05/2021,301,3,95,436,531
26/05/2021,698,3,50,209,259
26/05/2021,808,3,153,517,670
26/05/2021,209,3,20,100,120
26/05/2021,394,3,46,154,200
26/05/2021,433,3,179,708,887
26/05/2021,529,3,66,191,257
26/05/2021,390,3,140,524,664
26/05/2021,467,3,35,242,277
26/05/2021,167,3,128,415,543
26/05/2021,816,3,211,745,956
26/05/2021,496,3,17,88,105
26/05/2021,739,3,45,135,180
26/05/2021,173,3,61,167,228
26/05/2021,862,3,123,358,481
26/05/2021,142,3,45,115,160
26/05/2021,12,3,20,111,131
26/05/2021,527,3,49,151,200
26/05/2021,881,3,1,17,18
26/05/2021,54,3,81,171,252
26/05/2021,478,3,134,239,373
26/05/2021,458,3,74,229,303
26/05/2021,788,3,329,1355,1684
26/05/2021,178,3,88,309,397
26/05/2021,237,3,131,559,690
26/05/2021,628,3,45,181,226
26/05/2021,786,3,147,646,793
26/05/2021,489,3,7,31,38
26/05/2021,279,3,74,303,377
26/05/2021,318,3,165,462,627
26/05/2021,735,3,31,116,147
26/05/2021,155,3,122,427,549
26/05/2021,565,3,222,602,824
26/05/2021,528,3,41,136,177
26/05/2021,425,3,46,316,362
26/05/2021,421,3,139,400,539
26/05/2021,651,3,64,269,333
26/05/2021,580,3,95,234,329
26/05/2021,260,3,347,1453,1800
26/05/2021,694,3,56,179,235
26/05/2021,680,3,49,151,200
26/05/2021,661,3,159,460,619
26/05/2021,461,3,74,374,448
26/05/2021,517,3,45,137,182
26/05/2021,578,3,28,63,91
26/05/2021,24,3,14,52,66
26/05/2021,469,3,40,209,249
26/05/2021,688,3,100,250,350
26/05/2021,402,3,140,393,533
26/05/2021,804,3,142,588,730
26/05/2021,264,3,45,114,159
26/05/2021,112,3,56,162,218
26/05/2021,408,3,111,663,774
26/05/2021,248,3,58,173,231
26/05/2021,83,3,429,1251,1680
26/05/2021,479,3,61,102,163
26/05/2021,899,3,194,776,970
26/05/2021,934,3,2,17,19
26/05/2021,535,3,89,233,322
26/05/2021,104,3,107,380,487
26/05/2021,901,3,3,15,18
26/05/2021,272,3,90,304,394
26/05/2021,728,3,86,284,370
26/05/2021,404,3,199,713,912
26/05/2021,110,3,41,152,193
26/05/2021,352,3,133,328,461
26/05/2021,647,3,51,197,248
26/05/2021,439,3,43,161,204
26/05/2021,686,3,56,185,241
26/05/2021,431,3,56,159,215
26/05/2021,838,3,69,190,259
26/05/2021,832,3,70,207,277
26/05/2021,598,3,334,1202,1536
26/05/2021,584,3,200,928,1128
26/05/2021,714,3,98,330,428
26/05/2021,506,3,112,499,611
26/05/2021,484,3,82,191,273
26/05/2021,382,3,0,6,6
26/05/2021,136,3,112,379,491
26/05/2021,574,3,95,239,334
26/05/2021,362,3,99,315,414
26/05/2021,45,3,53,163,216
26/05/2021,412,3,35,190,225
26/05/2021,543,3,346,1117,1463
26/05/2021,743,3,37,155,192
26/05/2021,102,3,136,436,572
26/05/2021,199,3,37,123,160
26/05/2021,341,3,271,917,1188
26/05/2021,510,3,92,464,556
26/05/2021,930,3,1,23,24
26/05/2021,582,3,290,1238,1528
26/05/2021,126,3,100,325,425
26/05/2021,39,3,67,302,369
26/05/2021,706,3,159,478,637
26/05/2021,134,3,107,378,485
26/05/2021,371,3,80,285,365
26/05/2021,391,3,146,482,628
26/05/2021,514,3,20,85,105
26/05/2021,265,3,49,132,181
26/05/2021,111,3,162,470,632
26/05/2021,1,3,33,160,193
26/05/2021,823,3,54,161,215
26/05/2021,660,3,37,164,201
26/05/2021,701,3,56,230,286
26/05/2021,878,3,9,76,85
26/05/2021,137,3,95,259,354
26/05/2021,650,3,91,295,386
26/05/2021,575,3,23,76,99
26/05/2021,430,3,55,160,215
26/05/2021,758,3,87,285,372
26/05/2021,569,3,89,230,319
26/05/2021,538,3,74,331,405
26/05/2021,839,3,56,198,254
26/05/2021,872,3,52,152,204
26/05/2021,373,3,62,198,260
26/05/2021,563,3,67,215,282
26/05/2021,113,3,38,145,183
26/05/2021,551,3,130,425,555
26/05/2021,846,3,7,86,93
26/05/2021,907,3,172,510,682
26/05/2021,783,3,135,644,779
26/05/2021,566,3,49,156,205
26/05/2021,500,3,12,74,86
26/05/2021,465,3,42,191,233
26/05/2021,114,3,100,314,414
26/05/2021,293,3,68,319,387
26/05/2021,637,3,199,788,987
26/05/2021,360,3,63,219,282
26/05/2021,797,3,115,417,532
26/05/2021,43,3,61,278,339
26/05/2021,217,3,92,310,402
26/05/2021,79,3,97,201,298
26/05/2021,356,3,200,640,840
26/05/2021,280,3,31,80,111
26/05/2021,311,3,95,354,449
26/05/2021,333,3,85,478,563
26/05/2021,824,3,161,577,738
26/05/2021,712,3,64,189,253
26/05/2021,503,3,85,429,514
26/05/2021,405,3,35,150,185
26/05/2021,13,3,62,186,248
26/05/2021,273,3,54,354,408
26/05/2021,36,3,82,234,316
26/05/2021,283,3,74,209,283
26/05/2021,599,3,314,1158,1472
26/05/2021,605,3,183,621,804
26/05/2021,640,3,95,237,332
26/05/2021,336,3,291,894,1185
26/05/2021,377,3,119,265,384
26/05/2021,395,3,44,142,186
26/05/2021,468,3,55,196,251
26/05/2021,559,3,222,603,825
26/05/2021,679,3,60,164,224
26/05/2021,407,3,76,432,508
26/05/2021,916,3,0,1,1
26/05/2021,290,3,102,467,569
26/05/2021,668,3,33,91,124
26/05/2021,530,3,37,145,182
26/05/2021,5,3,35,157,192
26/05/2021,107,3,204,769,973
26/05/2021,821,3,108,363,471
26/05/2021,38,3,61,258,319
26/05/2021,174,3,36,131,167
26/05/2021,357,3,223,736,959
26/05/2021,316,3,56,207,263
26/05/2021,476,3,38,207,245
26/05/2021,618,3,61,264,325
26/05/2021,827,3,190,540,730
26/05/2021,21,3,77,314,391
26/05/2021,160,3,0,14,14
26/05/2021,225,3,87,313,400
26/05/2021,208,3,31,108,139
26/05/2021,880,3,2,19,21
26/05/2021,31,3,79,243,322
26/05/2021,664,3,143,426,569
26/05/2021,725,3,82,196,278
26/05/2021,214,3,96,323,419
26/05/2021,346,3,35,165,200
26/05/2021,845,3,62,223,285
26/05/2021,363,3,99,320,419
26/05/2021,483,3,111,281,392
26/05/2021,71,3,36,216,252
26/05/2021,753,3,64,353,417
26/05/2021,278,3,70,242,312
26/05/2021,89,3,130,382,512
26/05/2021,171,3,12,74,86
26/05/2021,700,3,49,232,281
26/05/2021,710,3,61,188,249
26/05/2021,122,3,104,290,394
26/05/2021,370,3,105,427,532
26/05/2021,615,3,89,282,371
26/05/2021,852,3,166,424,590
26/05/2021,100,3,181,789,970
26/05/2021,745,3,44,236,280
26/05/2021,291,3,88,399,487
26/05/2021,351,3,244,841,1085
26/05/2021,606,3,99,387,486
26/05/2021,773,3,38,157,195
26/05/2021,645,3,85,215,300
26/05/2021,552,3,129,372,501
26/05/2021,116,3,81,205,286
26/05/2021,771,3,51,353,404
26/05/2021,331,3,59,168,227
26/05/2021,81,3,31,108,139
26/05/2021,388,3,154,463,617
27/05/2021,773,3,35,191,226
27/05/2021,645,3,72,230,302
27/05/2021,291,3,89,425,514
27/05/2021,351,3,261,1005,1266
27/05/2021,331,3,67,238,305
27/05/2021,388,3,147,546,693
27/05/2021,81,3,36,151,187
27/05/2021,552,3,155,468,623
27/05/2021,606,3,107,482,589
27/05/2021,771,3,72,449,521
27/05/2021,116,3,81,253,334
27/05/2021,843,3,43,230,273
27/05/2021,261,3,367,1628,1995
27/05/2021,892,3,7,12,19
27/05/2021,495,3,49,193,242
27/05/2021,910,3,7,116,123
27/05/2021,328,3,57,299,356
27/05/2021,359,3,110,293,403
27/05/2021,288,3,22,95,117
27/05/2021,454,3,83,433,516
27/05/2021,82,3,155,480,635
27/05/2021,513,3,45,120,165
27/05/2021,812,3,65,311,376
27/05/2021,942,3,0,2,2
27/05/2021,576,3,24,86,110
27/05/2021,26,3,112,389,501
27/05/2021,810,3,75,293,368
27/05/2021,148,3,40,115,155
27/05/2021,240,3,150,746,896
27/05/2021,345,3,60,193,253
27/05/2021,146,3,171,610,781
27/05/2021,63,3,58,170,228
27/05/2021,317,3,191,565,756
27/05/2021,258,3,357,1507,1864
27/05/2021,230,3,67,233,300
27/05/2021,49,3,56,172,228
27/05/2021,938,3,0,6,6
27/05/2021,539,3,146,396,542
27/05/2021,364,3,103,314,417
27/05/2021,234,3,48,154,202
27/05/2021,6,3,31,163,194
27/05/2021,799,3,24,74,98
27/05/2021,734,3,31,131,162
27/05/2021,925,3,0,3,3
27/05/2021,873,3,111,454,565
27/05/2021,923,3,1,0,1
27/05/2021,787,3,327,1362,1689
27/05/2021,284,3,42,95,137
27/05/2021,521,3,60,187,247
27/05/2021,118,3,105,318,423
27/05/2021,325,3,59,321,380
27/05/2021,115,3,44,135,179
27/05/2021,129,3,106,365,471
27/05/2021,9,3,85,331,416
27/05/2021,933,3,0,4,4
27/05/2021,542,3,106,303,409
27/05/2021,135,3,142,556,698
27/05/2021,756,3,113,706,819
27/05/2021,662,3,165,571,736
27/05/2021,428,3,41,202,243
27/05/2021,68,3,83,399,482
27/05/2021,344,3,76,294,370
27/05/2021,884,3,7,116,123
27/05/2021,616,3,110,422,532
27/05/2021,419,3,141,443,584
27/05/2021,869,3,98,300,398
27/05/2021,207,3,53,182,235
27/05/2021,282,3,68,310,378
27/05/2021,396,3,40,134,174
27/05/2021,130,3,165,659,824
27/05/2021,676,3,23,138,161
27/05/2021,224,3,43,152,195
27/05/2021,779,3,86,214,300
27/05/2021,20,3,57,138,195
27/05/2021,65,3,78,371,449
27/05/2021,590,3,0,1,1
27/05/2021,347,3,304,710,1014
27/05/2021,254,3,42,191,233
27/05/2021,781,3,159,628,787
27/05/2021,867,3,87,184,271
27/05/2021,335,3,66,302,368
27/05/2021,789,3,98,409,507
27/05/2021,629,3,82,263,345
27/05/2021,592,3,134,523,657
27/05/2021,515,3,48,163,211
27/05/2021,296,3,40,147,187
27/05/2021,784,3,245,987,1232
27/05/2021,882,3,1,26,27
27/05/2021,66,3,76,354,430
27/05/2021,401,3,54,206,260
27/05/2021,182,3,66,225,291
27/05/2021,491,3,128,552,680
27/05/2021,522,3,74,224,298
27/05/2021,446,3,49,227,276
27/05/2021,920,3,2,8,10
27/05/2021,707,3,157,497,654
27/05/2021,790,3,83,356,439
27/05/2021,267,3,35,185,220
27/05/2021,416,3,51,183,234
27/05/2021,666,3,102,340,442
27/05/2021,450,3,52,221,273
27/05/2021,281,3,77,376,453
27/05/2021,239,3,64,296,360
27/05/2021,471,3,63,155,218
27/05/2021,268,3,154,685,839
27/05/2021,546,3,159,492,651
27/05/2021,8,3,80,240,320
27/05/2021,730,3,48,232,280
27/05/2021,800,3,76,256,332
27/05/2021,22,3,81,396,477
27/05/2021,447,3,40,146,186
27/05/2021,682,3,48,146,194
27/05/2021,303,3,112,441,553
27/05/2021,761,3,43,174,217
27/05/2021,143,3,164,574,738
27/05/2021,750,3,55,475,530
27/05/2021,206,3,7,13,20
27/05/2021,84,3,242,493,735
27/05/2021,294,3,156,617,773
27/05/2021,76,3,138,725,863
27/05/2021,220,3,56,235,291
27/05/2021,805,3,65,190,255
27/05/2021,699,3,49,172,221
27/05/2021,285,3,63,191,254
27/05/2021,180,3,74,346,420
27/05/2021,626,3,46,187,233
27/05/2021,432,3,81,369,450
27/05/2021,886,3,0,45,45
27/05/2021,385,3,97,316,413
27/05/2021,34,3,71,183,254
27/05/2021,857,3,82,288,370
27/05/2021,472,3,218,783,1001
27/05/2021,218,3,108,402,510
27/05/2021,509,3,108,431,539
27/05/2021,438,3,66,176,242
27/05/2021,715,3,181,452,633
27/05/2021,403,3,157,485,642
27/05/2021,322,3,81,243,324
27/05/2021,603,3,160,628,788
27/05/2021,579,3,42,229,271
27/05/2021,308,3,84,382,466
27/05/2021,764,3,35,139,174
27/05/2021,58,3,112,704,816
27/05/2021,803,3,88,361,449
27/05/2021,460,3,50,197,247
27/05/2021,466,3,69,303,372
27/05/2021,334,3,225,718,943
27/05/2021,99,3,198,931,1129
27/05/2021,815,3,344,937,1281
27/05/2021,64,3,44,172,216
27/05/2021,101,3,65,348,413
27/05/2021,890,3,73,428,501
27/05/2021,19,3,100,482,582
27/05/2021,172,3,78,365,443
27/05/2021,738,3,109,401,510
27/05/2021,868,3,294,1131,1425
27/05/2021,520,3,63,204,267
27/05/2021,723,3,80,385,465
27/05/2021,88,3,66,257,323
27/05/2021,485,3,94,266,360
27/05/2021,813,3,66,225,291
27/05/2021,464,3,91,380,471
27/05/2021,782,3,115,629,744
27/05/2021,422,3,79,271,350
27/05/2021,139,3,72,315,387
27/05/2021,642,3,90,257,347
27/05/2021,202,3,139,771,910
27/05/2021,292,3,134,602,736
27/05/2021,760,3,79,436,515
27/05/2021,754,3,79,389,468
27/05/2021,3,3,32,148,180
27/05/2021,92,3,64,305,369
27/05/2021,518,3,19,84,103
27/05/2021,72,3,129,703,832
27/05/2021,204,3,77,311,388
27/05/2021,622,3,186,586,772
27/05/2021,227,3,40,153,193
27/05/2021,861,3,135,380,515
27/05/2021,127,3,45,211,256
27/05/2021,612,3,151,835,986
27/05/2021,310,3,281,1122,1403
27/05/2021,691,3,57,275,332
27/05/2021,52,3,110,482,592
27/05/2021,906,3,9,24,33
27/05/2021,742,3,79,277,356
27/05/2021,275,3,82,372,454
27/05/2021,772,3,115,482,597
27/05/2021,426,3,56,177,233
27/05/2021,481,3,102,246,348
27/05/2021,452,3,64,215,279
27/05/2021,326,3,22,113,135
27/05/2021,222,3,52,217,269
27/05/2021,717,3,53,238,291
27/05/2021,866,3,162,726,888
27/05/2021,424,3,104,676,780
27/05/2021,70,3,120,673,793
27/05/2021,829,3,129,670,799
27/05/2021,780,3,230,783,1013
27/05/2021,170,3,88,415,503
27/05/2021,11,3,41,228,269
27/05/2021,614,3,41,193,234
27/05/2021,409,3,48,156,204
27/05/2021,638,3,135,365,500
27/05/2021,711,3,51,184,235
27/05/2021,705,3,28,102,130
27/05/2021,372,3,188,795,983
27/05/2021,554,3,85,376,461
27/05/2021,376,3,27,61,88
27/05/2021,35,3,88,330,418
27/05/2021,270,3,40,211,251
27/05/2021,197,3,91,331,422
27/05/2021,674,3,82,338,420
27/05/2021,627,3,41,145,186
27/05/2021,665,3,43,285,328
27/05/2021,307,3,108,493,601
27/05/2021,639,3,77,188,265
27/05/2021,919,3,101,399,500
27/05/2021,659,3,34,250,284
27/05/2021,85,3,367,1120,1487
27/05/2021,295,3,60,239,299
27/05/2021,56,3,98,439,537
27/05/2021,436,3,69,277,346
27/05/2021,474,3,58,220,278
27/05/2021,683,3,60,275,335
27/05/2021,825,3,161,593,754
27/05/2021,186,3,45,132,177
27/05/2021,462,3,71,304,375
27/05/2021,597,3,74,257,331
27/05/2021,654,3,59,266,325
27/05/2021,251,3,47,179,226
27/05/2021,162,3,325,771,1096
27/05/2021,269,3,43,188,231
27/05/2021,393,3,40,160,200
27/05/2021,253,3,28,214,242
27/05/2021,399,3,156,554,710
27/05/2021,192,3,59,196,255
27/05/2021,350,3,42,200,242
27/05/2021,247,3,141,505,646
27/05/2021,512,3,27,83,110
27/05/2021,15,3,147,378,525
27/05/2021,354,3,1,4,5
27/05/2021,252,3,59,164,223
27/05/2021,684,3,82,391,473
27/05/2021,138,3,86,292,378
27/05/2021,417,3,122,772,894
27/05/2021,836,3,91,610,701
27/05/2021,266,3,32,191,223
27/05/2021,128,3,31,129,160
27/05/2021,600,3,286,1011,1297
27/05/2021,875,3,49,204,253
27/05/2021,909,3,2,4,6
27/05/2021,163,3,61,261,322
27/05/2021,321,3,63,165,228
27/05/2021,936,3,21,55,76
27/05/2021,427,3,233,923,1156
27/05/2021,213,3,114,412,526
27/05/2021,51,3,248,920,1168
27/05/2021,504,3,40,135,175
27/05/2021,889,3,0,10,10
27/05/2021,613,3,23,139,162
27/05/2021,69,3,70,296,366
27/05/2021,175,3,72,248,320
27/05/2021,858,3,173,577,750
27/05/2021,558,3,40,182,222
27/05/2021,795,3,77,245,322
27/05/2021,492,3,34,137,171
27/05/2021,586,3,119,446,565
27/05/2021,702,3,63,289,352
27/05/2021,378,3,39,257,296
27/05/2021,406,3,146,350,496
27/05/2021,398,3,24,99,123
27/05/2021,477,3,43,258,301
27/05/2021,903,3,1,5,6
27/05/2021,537,3,136,488,624
27/05/2021,883,3,8,123,131
27/05/2021,93,3,77,365,442
27/05/2021,572,3,92,266,358
27/05/2021,87,3,159,630,789
27/05/2021,374,3,57,142,199
27/05/2021,625,3,69,215,284
27/05/2021,737,3,52,208,260
27/05/2021,246,3,159,784,943
27/05/2021,533,3,106,323,429
27/05/2021,205,3,63,275,338
27/05/2021,91,3,91,389,480
27/05/2021,631,3,24,102,126
27/05/2021,749,3,37,195,232
27/05/2021,435,3,46,164,210
27/05/2021,61,3,84,379,463
27/05/2021,604,3,214,670,884
27/05/2021,850,3,282,703,985
27/05/2021,289,3,49,196,245
27/05/2021,185,3,45,184,229
27/05/2021,30,3,132,480,612
27/05/2021,144,3,58,360,418
27/05/2021,842,3,10,39,49
27/05/2021,124,3,45,195,240
27/05/2021,276,3,75,352,427
27/05/2021,380,3,83,389,472
27/05/2021,777,3,93,258,351
27/05/2021,696,3,93,341,434
27/05/2021,305,3,79,365,444
27/05/2021,238,3,149,722,871
27/05/2021,286,3,31,94,125
27/05/2021,785,3,318,1340,1658
27/05/2021,187,3,62,174,236
27/05/2021,897,3,94,430,524
27/05/2021,895,3,63,184,247
27/05/2021,423,3,101,667,768
27/05/2021,189,3,37,156,193
27/05/2021,400,3,39,142,181
27/05/2021,570,3,72,235,307
27/05/2021,28,3,45,200,245
27/05/2021,928,3,2,11,13
27/05/2021,41,3,48,327,375
27/05/2021,449,3,75,326,401
27/05/2021,793,3,110,480,590
27/05/2021,775,3,50,222,272
27/05/2021,602,3,222,878,1100
27/05/2021,671,3,73,288,361
27/05/2021,722,3,18,133,151
27/05/2021,713,3,94,735,829
27/05/2021,746,3,49,253,302
27/05/2021,811,3,55,171,226
27/05/2021,168,3,40,261,301
27/05/2021,547,3,449,1366,1815
27/05/2021,159,3,77,440,517
27/05/2021,90,3,57,242,299
27/05/2021,229,3,127,443,570
27/05/2021,770,3,212,733,945
27/05/2021,567,3,106,301,407
27/05/2021,736,3,38,104,142
27/05/2021,794,3,175,606,781
27/05/2021,561,3,31,146,177
27/05/2021,524,3,102,382,484
27/05/2021,673,3,56,359,415
27/05/2021,587,3,23,112,135
27/05/2021,164,3,65,304,369
27/05/2021,937,3,0,2,2
27/05/2021,27,3,190,610,800
27/05/2021,149,3,100,289,389
27/05/2021,721,3,367,1604,1971
27/05/2021,456,3,52,208,260
27/05/2021,338,3,111,489,600
27/05/2021,304,3,111,424,535
27/05/2021,210,3,78,312,390
27/05/2021,330,3,68,296,364
27/05/2021,807,3,69,214,283
27/05/2021,78,3,406,1324,1730
27/05/2021,902,3,97,256,353
27/05/2021,212,3,124,490,614
27/05/2021,493,3,64,190,254
27/05/2021,411,3,120,759,879
27/05/2021,117,3,174,533,707
27/05/2021,457,3,41,118,159
27/05/2021,453,3,81,327,408
27/05/2021,692,3,108,375,483
27/05/2021,635,3,105,443,548
27/05/2021,840,3,41,229,270
27/05/2021,663,3,119,489,608
27/05/2021,463,3,172,659,831
27/05/2021,877,3,5,56,61
27/05/2021,140,3,58,218,276
27/05/2021,655,3,123,457,580
27/05/2021,33,3,67,274,341
27/05/2021,480,3,54,138,192
27/05/2021,885,3,8,119,127
27/05/2021,366,3,58,200,258
27/05/2021,623,3,108,320,428
27/05/2021,120,3,95,283,378
27/05/2021,108,3,59,174,233
27/05/2021,392,3,63,214,277
27/05/2021,250,3,91,251,342
27/05/2021,854,3,165,615,780
27/05/2021,232,3,78,275,353
27/05/2021,767,3,209,726,935
27/05/2021,274,3,1,27,28
27/05/2021,429,3,77,351,428
27/05/2021,177,3,48,174,222
27/05/2021,588,3,80,220,300
27/05/2021,860,3,113,269,382
27/05/2021,277,3,104,318,422
27/05/2021,32,3,69,334,403
27/05/2021,855,3,97,371,468
27/05/2021,176,3,115,391,506
27/05/2021,505,3,42,138,180
27/05/2021,434,3,14,83,97
27/05/2021,103,3,190,458,648
27/05/2021,389,3,154,663,817
27/05/2021,709,3,190,671,861
27/05/2021,257,3,289,1234,1523
27/05/2021,835,3,90,364,454
27/05/2021,314,3,40,127,167
27/05/2021,837,3,109,430,539
27/05/2021,831,3,91,395,486
27/05/2021,121,3,400,1187,1587
27/05/2021,636,3,83,323,406
27/05/2021,188,3,84,376,460
27/05/2021,501,3,140,607,747
27/05/2021,656,3,39,287,326
27/05/2021,355,3,31,174,205
27/05/2021,733,3,56,207,263
27/05/2021,610,3,170,849,1019
27/05/2021,697,3,52,261,313
27/05/2021,894,3,81,301,382
27/05/2021,340,3,103,472,575
27/05/2021,97,3,150,590,740
27/05/2021,499,3,67,177,244
27/05/2021,601,3,56,274,330
27/05/2021,859,3,9,30,39
27/05/2021,870,3,19,99,118
27/05/2021,80,3,38,180,218
27/05/2021,119,3,109,318,427
27/05/2021,792,3,133,427,560
27/05/2021,444,3,69,273,342
27/05/2021,687,3,94,387,481
27/05/2021,809,3,38,172,210
27/05/2021,245,3,37,144,181
27/05/2021,904,3,102,414,516
27/05/2021,353,3,18,119,137
27/05/2021,507,3,144,648,792
27/05/2021,555,3,202,593,795
27/05/2021,608,3,220,1197,1417
27/05/2021,200,3,38,139,177
27/05/2021,591,3,90,242,332
27/05/2021,25,3,82,319,401
27/05/2021,442,3,53,214,267
27/05/2021,581,3,96,393,489
27/05/2021,231,3,77,347,424
27/05/2021,677,3,50,185,235
27/05/2021,922,3,0,6,6
27/05/2021,46,3,65,179,244
27/05/2021,448,3,234,847,1081
27/05/2021,652,3,25,118,143
27/05/2021,133,3,59,184,243
27/05/2021,145,3,90,428,518
27/05/2021,221,3,55,241,296
27/05/2021,759,3,44,213,257
27/05/2021,751,3,4,10,14
27/05/2021,826,3,138,564,702
27/05/2021,236,3,75,318,393
27/05/2021,47,3,90,229,319
27/05/2021,704,3,30,107,137
27/05/2021,154,3,95,448,543
27/05/2021,488,3,79,221,300
27/05/2021,765,3,99,404,503
27/05/2021,879,3,1,49,50
27/05/2021,242,3,146,734,880
27/05/2021,18,3,56,323,379
27/05/2021,914,3,4,10,14
27/05/2021,302,3,96,437,533
27/05/2021,387,3,83,230,313
27/05/2021,693,3,58,230,288
27/05/2021,908,3,115,576,691
27/05/2021,536,3,65,243,308
27/05/2021,727,3,84,292,376
27/05/2021,926,3,24,144,168
27/05/2021,367,3,116,504,620
27/05/2021,228,3,48,149,197
27/05/2021,262,3,52,147,199
27/05/2021,755,3,119,701,820
27/05/2021,848,3,92,317,409
27/05/2021,451,3,224,863,1087
27/05/2021,106,3,107,639,746
27/05/2021,617,3,52,196,248
27/05/2021,183,3,36,155,191
27/05/2021,594,3,173,739,912
27/05/2021,932,3,0,41,41
27/05/2021,917,3,4,62,66
27/05/2021,519,3,77,315,392
27/05/2021,865,3,56,167,223
27/05/2021,193,3,83,296,379
27/05/2021,475,3,189,560,749
27/05/2021,89,3,127,446,573
27/05/2021,745,3,45,248,293
27/05/2021,753,3,72,430,502
27/05/2021,122,3,96,290,386
27/05/2021,370,3,117,502,619
27/05/2021,171,3,16,92,108
27/05/2021,615,3,85,351,436
27/05/2021,278,3,72,318,390
27/05/2021,700,3,50,284,334
27/05/2021,71,3,65,330,395
27/05/2021,100,3,202,990,1192
27/05/2021,852,3,154,446,600
27/05/2021,710,3,52,198,250
27/05/2021,55,3,41,156,197
27/05/2021,508,3,114,447,561
27/05/2021,550,3,140,407,547
27/05/2021,856,3,149,574,723
27/05/2021,329,3,227,908,1135
27/05/2021,913,3,147,580,727
27/05/2021,98,3,141,721,862
27/05/2021,724,3,409,1238,1647
27/05/2021,891,3,59,246,305
27/05/2021,716,3,42,218,260
27/05/2021,301,3,106,499,605
27/05/2021,814,3,57,190,247
27/05/2021,808,3,152,691,843
27/05/2021,313,3,39,113,152
27/05/2021,319,3,7,74,81
27/05/2021,459,3,67,271,338
27/05/2021,698,3,52,257,309
27/05/2021,911,3,93,484,577
27/05/2021,337,3,53,173,226
27/05/2021,844,3,43,178,221
27/05/2021,181,3,74,212,286
27/05/2021,299,3,35,137,172
27/05/2021,898,3,49,187,236
27/05/2021,397,3,31,126,157
27/05/2021,833,3,50,97,147
27/05/2021,48,3,60,179,239
27/05/2021,853,3,63,234,297
27/05/2021,557,3,49,235,284
27/05/2021,540,3,153,474,627
27/05/2021,300,3,121,595,716
27/05/2021,768,3,107,519,626
27/05/2021,670,3,478,1454,1932
27/05/2021,348,3,44,179,223
27/05/2021,312,3,100,283,383
27/05/2021,851,3,103,316,419
27/05/2021,249,3,161,776,937
27/05/2021,342,3,48,307,355
27/05/2021,259,3,297,1227,1524
27/05/2021,365,3,59,194,253
27/05/2021,689,3,118,389,507
27/05/2021,593,3,217,884,1101
27/05/2021,420,3,188,592,780
27/05/2021,131,3,85,311,396
27/05/2021,817,3,86,369,455
27/05/2021,255,3,6,20,26
27/05/2021,190,3,99,323,422
27/05/2021,151,3,38,204,242
27/05/2021,243,3,151,807,958
27/05/2021,271,3,40,202,242
27/05/2021,778,3,145,401,546
27/05/2021,184,3,43,137,180
27/05/2021,526,3,50,140,190
27/05/2021,939,3,0,6,6
27/05/2021,158,3,50,144,194
27/05/2021,757,3,136,547,683
27/05/2021,53,3,89,365,454
27/05/2021,339,3,75,367,442
27/05/2021,818,3,80,312,392
27/05/2021,96,3,50,272,322
27/05/2021,820,3,84,363,447
27/05/2021,256,3,128,384,512
27/05/2021,490,3,41,160,201
27/05/2021,327,3,204,807,1011
27/05/2021,441,3,182,630,812
27/05/2021,732,3,38,146,184
27/05/2021,2,3,31,152,183
27/05/2021,386,3,257,1147,1404
27/05/2021,921,3,0,7,7
27/05/2021,791,3,66,243,309
27/05/2021,410,3,92,571,663
27/05/2021,643,3,100,294,394
27/05/2021,203,3,70,314,384
27/05/2021,531,3,111,367,478
27/05/2021,830,3,433,1291,1724
27/05/2021,486,3,113,489,602
27/05/2021,349,3,50,198,248
27/05/2021,215,3,37,219,256
27/05/2021,633,3,65,248,313
27/05/2021,219,3,42,268,310
27/05/2021,323,3,34,133,167
27/05/2021,564,3,120,371,491
27/05/2021,544,3,121,339,460
27/05/2021,619,3,84,288,372
27/05/2021,384,3,121,394,515
27/05/2021,556,3,221,668,889
27/05/2021,75,3,150,773,923
27/05/2021,77,3,144,695,839
27/05/2021,887,3,2,33,35
27/05/2021,595,3,72,188,260
27/05/2021,719,3,44,125,169
27/05/2021,876,3,0,10,10
27/05/2021,874,3,64,194,258
27/05/2021,577,3,71,343,414
27/05/2021,44,3,131,613,744
27/05/2021,532,3,359,1536,1895
27/05/2021,315,3,21,106,127
27/05/2021,871,3,130,514,644
27/05/2021,726,3,59,240,299
27/05/2021,747,3,50,187,237
27/05/2021,649,3,75,255,330
27/05/2021,169,3,70,334,404
27/05/2021,720,3,55,182,237
27/05/2021,297,3,88,438,526
27/05/2021,548,3,71,207,278
27/05/2021,7,3,34,141,175
27/05/2021,105,3,115,456,571
27/05/2021,125,3,74,225,299
27/05/2021,774,3,54,250,304
27/05/2021,646,3,68,254,322
27/05/2021,123,3,59,270,329
27/05/2021,798,3,164,681,845
27/05/2021,298,3,145,617,762
27/05/2021,585,3,154,687,841
27/05/2021,196,3,61,238,299
27/05/2021,157,3,109,264,373
27/05/2021,941,3,0,7,7
27/05/2021,497,3,112,537,649
27/05/2021,166,3,41,232,273
27/05/2021,935,3,1,2,3
27/05/2021,226,3,78,284,362
27/05/2021,525,3,76,358,434
27/05/2021,498,3,47,174,221
27/05/2021,560,3,207,638,845
27/05/2021,368,3,117,503,620
27/05/2021,437,3,66,302,368
27/05/2021,211,3,107,398,505
27/05/2021,915,3,1,28,29
27/05/2021,67,3,66,334,400
27/05/2021,806,3,172,713,885
27/05/2021,657,3,147,525,672
27/05/2021,669,3,86,373,459
27/05/2021,4,3,44,244,288
27/05/2021,57,3,77,382,459
27/05/2021,152,3,58,347,405
27/05/2021,95,3,186,756,942
27/05/2021,309,3,15,70,85
27/05/2021,161,3,328,795,1123
27/05/2021,473,3,51,150,201
27/05/2021,802,3,178,901,1079
27/05/2021,244,3,72,310,382
27/05/2021,59,3,63,223,286
27/05/2021,443,3,78,309,387
27/05/2021,195,3,44,133,177
27/05/2021,37,3,47,173,220
27/05/2021,675,3,40,205,245
27/05/2021,383,3,194,954,1148
27/05/2021,418,3,52,160,212
27/05/2021,900,3,9,16,25
27/05/2021,918,3,1,7,8
27/05/2021,235,3,60,271,331
27/05/2021,632,3,32,121,153
27/05/2021,752,3,153,658,811
27/05/2021,681,3,95,274,369
27/05/2021,60,3,33,96,129
27/05/2021,863,3,70,288,358
27/05/2021,194,3,3,0,3
27/05/2021,534,3,66,251,317
27/05/2021,924,3,0,14,14
27/05/2021,658,3,36,233,269
27/05/2021,201,3,41,184,225
27/05/2021,414,3,123,783,906
27/05/2021,641,3,92,278,370
27/05/2021,828,3,126,423,549
27/05/2021,621,3,65,280,345
27/05/2021,358,3,253,952,1205
27/05/2021,455,3,53,200,253
27/05/2021,445,3,63,323,386
27/05/2021,494,3,64,197,261
27/05/2021,343,3,34,202,236
27/05/2021,179,3,75,284,359
27/05/2021,653,3,22,125,147
27/05/2021,562,3,27,131,158
27/05/2021,905,3,3,8,11
27/05/2021,156,3,96,433,529
27/05/2021,741,3,47,177,224
27/05/2021,573,3,84,261,345
27/05/2021,819,3,93,319,412
27/05/2021,553,3,24,69,93
27/05/2021,470,3,91,367,458
27/05/2021,849,3,78,362,440
27/05/2021,847,3,4,83,87
27/05/2021,801,3,71,325,396
27/05/2021,23,3,28,65,93
27/05/2021,896,3,444,1358,1802
27/05/2021,50,3,57,174,231
27/05/2021,379,3,92,372,464
27/05/2021,703,3,50,205,255
27/05/2021,748,3,26,188,214
27/05/2021,263,3,80,267,347
27/05/2021,216,3,58,272,330
27/05/2021,86,3,55,224,279
27/05/2021,381,3,3,7,10
27/05/2021,233,3,109,319,428
27/05/2021,369,3,201,667,868
27/05/2021,624,3,24,106,130
27/05/2021,583,3,47,178,225
27/05/2021,634,3,55,215,270
27/05/2021,440,3,102,463,565
27/05/2021,841,3,14,150,164
27/05/2021,487,3,77,208,285
27/05/2021,685,3,92,284,376
27/05/2021,511,3,42,218,260
27/05/2021,731,3,46,165,211
27/05/2021,413,3,115,718,833
27/05/2021,287,3,149,630,779
27/05/2021,153,3,97,469,566
27/05/2021,589,3,78,215,293
27/05/2021,648,3,77,250,327
27/05/2021,147,3,54,345,399
27/05/2021,888,3,4,65,69
27/05/2021,607,3,194,1024,1218
27/05/2021,571,3,79,229,308
27/05/2021,864,3,59,161,220
27/05/2021,361,3,100,319,419
27/05/2021,198,3,95,357,452
27/05/2021,17,3,35,164,199
27/05/2021,42,3,58,203,261
27/05/2021,332,3,45,267,312
27/05/2021,776,3,64,305,369
27/05/2021,94,3,1,2,3
27/05/2021,21,3,76,414,490
27/05/2021,160,3,3,13,16
27/05/2021,363,3,107,323,430
27/05/2021,664,3,169,615,784
27/05/2021,880,3,1,25,26
27/05/2021,346,3,40,177,217
27/05/2021,618,3,76,342,418
27/05/2021,31,3,77,281,358
27/05/2021,845,3,66,276,342
27/05/2021,214,3,108,407,515
27/05/2021,225,3,113,457,570
27/05/2021,208,3,36,162,198
27/05/2021,725,3,64,277,341
27/05/2021,483,3,111,327,438
27/05/2021,827,3,181,588,769
27/05/2021,391,3,164,619,783
27/05/2021,701,3,60,261,321
27/05/2021,265,3,57,181,238
27/05/2021,660,3,51,189,240
27/05/2021,371,3,82,340,422
27/05/2021,878,3,10,76,86
27/05/2021,111,3,155,533,688
27/05/2021,1,3,32,145,177
27/05/2021,823,3,59,155,214
27/05/2021,514,3,26,88,114
27/05/2021,461,3,85,426,511
27/05/2021,517,3,53,190,243
27/05/2021,580,3,75,300,375
27/05/2021,469,3,50,276,326
27/05/2021,578,3,32,90,122
27/05/2021,651,3,81,320,401
27/05/2021,661,3,179,660,839
27/05/2021,421,3,147,449,596
27/05/2021,694,3,75,313,388
27/05/2021,680,3,56,179,235
27/05/2021,260,3,370,1649,2019
27/05/2021,425,3,84,408,492
27/05/2021,24,3,26,61,87
27/05/2021,467,3,59,312,371
27/05/2021,173,3,59,194,253
27/05/2021,12,3,28,127,155
27/05/2021,209,3,26,123,149
27/05/2021,167,3,131,438,569
27/05/2021,739,3,55,184,239
27/05/2021,496,3,28,100,128
27/05/2021,142,3,50,138,188
27/05/2021,529,3,65,217,282
27/05/2021,527,3,39,111,150
27/05/2021,881,3,1,23,24
27/05/2021,816,3,163,584,747
27/05/2021,390,3,167,679,846
27/05/2021,862,3,120,371,491
27/05/2021,394,3,56,195,251
27/05/2021,433,3,204,740,944
27/05/2021,786,3,166,724,890
27/05/2021,279,3,83,391,474
27/05/2021,458,3,76,263,339
27/05/2021,155,3,151,564,715
27/05/2021,237,3,134,647,781
27/05/2021,54,3,81,181,262
27/05/2021,788,3,321,1362,1683
27/05/2021,178,3,114,371,485
27/05/2021,929,3,0,1,1
27/05/2021,735,3,39,175,214
27/05/2021,565,3,221,664,885
27/05/2021,489,3,7,40,47
27/05/2021,318,3,161,501,662
27/05/2021,528,3,48,162,210
27/05/2021,628,3,54,200,254
27/05/2021,478,3,108,141,249
27/05/2021,706,3,180,559,739
27/05/2021,45,3,68,216,284
27/05/2021,341,3,354,1098,1452
27/05/2021,102,3,136,505,641
27/05/2021,412,3,45,286,331
27/05/2021,543,3,432,1325,1757
27/05/2021,199,3,30,123,153
27/05/2021,126,3,98,422,520
27/05/2021,134,3,138,530,668
27/05/2021,39,3,64,382,446
27/05/2021,510,3,130,548,678
27/05/2021,743,3,39,175,214
27/05/2021,930,3,0,30,30
27/05/2021,582,3,311,1337,1648
27/05/2021,104,3,105,437,542
27/05/2021,901,3,2,24,26
27/05/2021,248,3,67,261,328
27/05/2021,112,3,59,161,220
27/05/2021,272,3,87,397,484
27/05/2021,899,3,188,828,1016
27/05/2021,479,3,53,122,175
27/05/2021,535,3,88,292,380
27/05/2021,83,3,405,1300,1705
27/05/2021,934,3,1,22,23
27/05/2021,402,3,144,457,601
27/05/2021,688,3,90,290,380
27/05/2021,408,3,126,819,945
27/05/2021,264,3,57,169,226
27/05/2021,804,3,143,681,824
27/05/2021,362,3,107,327,434
27/05/2021,598,3,317,1275,1592
27/05/2021,484,3,80,201,281
27/05/2021,352,3,131,376,507
27/05/2021,136,3,141,539,680
27/05/2021,404,3,236,875,1111
27/05/2021,728,3,94,396,490
27/05/2021,714,3,122,402,524
27/05/2021,110,3,56,187,243
27/05/2021,584,3,239,1061,1300
27/05/2021,431,3,57,178,235
27/05/2021,832,3,72,263,335
27/05/2021,838,3,73,357,430
27/05/2021,506,3,137,595,732
27/05/2021,439,3,50,173,223
27/05/2021,647,3,48,226,274
27/05/2021,574,3,102,318,420
27/05/2021,382,3,0,2,2
27/05/2021,686,3,46,222,268
27/05/2021,174,3,52,202,254
27/05/2021,357,3,223,831,1054
27/05/2021,290,3,125,554,679
27/05/2021,5,3,34,141,175
27/05/2021,38,3,59,328,387
27/05/2021,107,3,204,947,1151
27/05/2021,821,3,103,467,570
27/05/2021,679,3,67,196,263
27/05/2021,407,3,98,582,680
27/05/2021,668,3,29,114,143
27/05/2021,559,3,222,647,869
27/05/2021,476,3,47,242,289
27/05/2021,316,3,45,240,285
27/05/2021,530,3,42,176,218
27/05/2021,280,3,36,79,115
27/05/2021,797,3,129,488,617
27/05/2021,356,3,201,719,920
27/05/2021,311,3,111,489,600
27/05/2021,637,3,187,835,1022
27/05/2021,217,3,106,384,490
27/05/2021,907,3,158,567,725
27/05/2021,360,3,82,293,375
27/05/2021,114,3,110,337,447
27/05/2021,293,3,94,377,471
27/05/2021,566,3,49,223,272
27/05/2021,465,3,61,253,314
27/05/2021,500,3,20,96,116
27/05/2021,79,3,98,225,323
27/05/2021,712,3,57,199,256
27/05/2021,783,3,129,781,910
27/05/2021,824,3,170,603,773
27/05/2021,333,3,83,557,640
27/05/2021,846,3,6,109,115
27/05/2021,43,3,59,358,417
27/05/2021,839,3,80,386,466
27/05/2021,551,3,157,497,654
27/05/2021,137,3,92,347,439
27/05/2021,430,3,52,189,241
27/05/2021,373,3,57,221,278
27/05/2021,575,3,29,96,125
27/05/2021,113,3,49,163,212
27/05/2021,758,3,91,354,445
27/05/2021,538,3,75,338,413
27/05/2021,569,3,93,270,363
27/05/2021,872,3,54,174,228
27/05/2021,563,3,67,264,331
27/05/2021,650,3,95,409,504
27/05/2021,503,3,124,511,635
27/05/2021,13,3,76,266,342
27/05/2021,36,3,77,279,356
27/05/2021,283,3,82,255,337
27/05/2021,640,3,105,266,371
27/05/2021,273,3,64,323,387
27/05/2021,395,3,52,191,243
27/05/2021,599,3,303,1222,1525
27/05/2021,405,3,56,176,232
27/05/2021,605,3,180,734,914
27/05/2021,377,3,118,313,431
27/05/2021,468,3,70,261,331
27/05/2021,336,3,362,1047,1409
28/05/2021,405,3,88,459,547
28/05/2021,377,3,166,716,882
28/05/2021,273,3,100,588,688
28/05/2021,640,3,130,625,755
28/05/2021,36,3,106,670,776
28/05/2021,395,3,70,392,462
28/05/2021,13,3,180,867,1047
28/05/2021,283,3,139,714,853
28/05/2021,599,3,511,3018,3529
28/05/2021,468,3,94,506,600
28/05/2021,336,3,441,2266,2707
28/05/2021,503,3,257,1530,1787
28/05/2021,605,3,367,1859,2226
28/05/2021,302,3,140,803,943
28/05/2021,367,3,178,1238,1416
28/05/2021,926,3,101,1136,1237
28/05/2021,914,3,3,15,18
28/05/2021,387,3,121,587,708
28/05/2021,693,3,118,844,962
28/05/2021,727,3,54,268,322
28/05/2021,536,3,186,1156,1342
28/05/2021,908,3,134,1109,1243
28/05/2021,674,3,111,677,788
28/05/2021,919,3,142,701,843
28/05/2021,665,3,82,593,675
28/05/2021,659,3,64,401,465
28/05/2021,639,3,113,513,626
28/05/2021,307,3,196,1104,1300
28/05/2021,85,3,446,1955,2401
28/05/2021,372,3,324,1834,2158
28/05/2021,627,3,64,338,402
28/05/2021,295,3,131,878,1009
28/05/2021,35,3,126,958,1084
28/05/2021,197,3,179,797,976
28/05/2021,554,3,115,978,1093
28/05/2021,270,3,70,387,457
28/05/2021,376,3,45,187,232
28/05/2021,666,3,167,1105,1272
28/05/2021,784,3,286,1781,2067
28/05/2021,416,3,111,958,1069
28/05/2021,281,3,187,1065,1252
28/05/2021,920,3,1,8,9
28/05/2021,707,3,215,1095,1310
28/05/2021,267,3,74,402,476
28/05/2021,522,3,116,705,821
28/05/2021,401,3,122,543,665
28/05/2021,882,3,0,37,37
28/05/2021,296,3,85,599,684
28/05/2021,491,3,214,1276,1490
28/05/2021,66,3,127,1004,1131
28/05/2021,446,3,79,668,747
28/05/2021,450,3,68,457,525
28/05/2021,182,3,107,747,854
28/05/2021,239,3,137,991,1128
28/05/2021,790,3,122,1090,1212
28/05/2021,317,3,255,1504,1759
28/05/2021,63,3,66,387,453
28/05/2021,812,3,85,598,683
28/05/2021,513,3,109,543,652
28/05/2021,148,3,37,112,149
28/05/2021,810,3,77,500,577
28/05/2021,146,3,183,1284,1467
28/05/2021,240,3,228,1670,1898
28/05/2021,345,3,104,546,650
28/05/2021,26,3,161,898,1059
28/05/2021,576,3,48,335,383
28/05/2021,942,3,0,4,4
28/05/2021,606,3,232,1216,1448
28/05/2021,645,3,94,577,671
28/05/2021,81,3,127,813,940
28/05/2021,331,3,82,518,600
28/05/2021,552,3,176,1085,1261
28/05/2021,116,3,95,359,454
28/05/2021,773,3,64,365,429
28/05/2021,351,3,437,2418,2855
28/05/2021,291,3,107,607,714
28/05/2021,388,3,202,1788,1990
28/05/2021,771,3,171,1412,1583
28/05/2021,261,3,626,3713,4339
28/05/2021,454,3,167,1238,1405
28/05/2021,288,3,66,363,429
28/05/2021,359,3,122,538,660
28/05/2021,910,3,13,151,164
28/05/2021,843,3,63,420,483
28/05/2021,82,3,260,1299,1559
28/05/2021,495,3,116,660,776
28/05/2021,328,3,91,699,790
28/05/2021,892,3,5,28,33
28/05/2021,224,3,83,443,526
28/05/2021,335,3,107,597,704
28/05/2021,254,3,46,312,358
28/05/2021,282,3,121,675,796
28/05/2021,207,3,72,520,592
28/05/2021,592,3,253,1436,1689
28/05/2021,867,3,89,341,430
28/05/2021,515,3,90,526,616
28/05/2021,789,3,174,927,1101
28/05/2021,130,3,241,1406,1647
28/05/2021,347,3,355,1234,1589
28/05/2021,396,3,48,237,285
28/05/2021,65,3,114,964,1078
28/05/2021,869,3,162,588,750
28/05/2021,779,3,112,595,707
28/05/2021,419,3,261,1312,1573
28/05/2021,590,3,0,3,3
28/05/2021,20,3,75,317,392
28/05/2021,676,3,45,254,299
28/05/2021,629,3,122,697,819
28/05/2021,781,3,256,1865,2121
28/05/2021,230,3,127,551,678
28/05/2021,923,3,3,7,10
28/05/2021,325,3,91,855,946
28/05/2021,539,3,212,1223,1435
28/05/2021,873,3,180,897,1077
28/05/2021,258,3,627,3646,4273
28/05/2021,284,3,75,308,383
28/05/2021,6,3,63,341,404
28/05/2021,938,3,0,9,9
28/05/2021,364,3,169,614,783
28/05/2021,925,3,0,5,5
28/05/2021,521,3,77,302,379
28/05/2021,734,3,49,237,286
28/05/2021,234,3,115,744,859
28/05/2021,799,3,41,153,194
28/05/2021,49,3,91,456,547
28/05/2021,118,3,148,970,1118
28/05/2021,787,3,353,2498,2851
28/05/2021,616,3,138,789,927
28/05/2021,115,3,66,410,476
28/05/2021,129,3,183,1087,1270
28/05/2021,428,3,51,462,513
28/05/2021,756,3,178,1656,1834
28/05/2021,68,3,136,1113,1249
28/05/2021,344,3,103,656,759
28/05/2021,542,3,159,694,853
28/05/2021,662,3,292,1228,1520
28/05/2021,933,3,0,9,9
28/05/2021,135,3,218,1305,1523
28/05/2021,9,3,121,561,682
28/05/2021,884,3,13,160,173
28/05/2021,424,3,150,1866,2016
28/05/2021,705,3,47,201,248
28/05/2021,717,3,77,680,757
28/05/2021,70,3,222,1863,2085
28/05/2021,170,3,125,983,1108
28/05/2021,711,3,79,463,542
28/05/2021,829,3,209,1383,1592
28/05/2021,11,3,78,486,564
28/05/2021,614,3,52,495,547
28/05/2021,638,3,147,896,1043
28/05/2021,780,3,304,1969,2273
28/05/2021,409,3,93,726,819
28/05/2021,866,3,300,1968,2268
28/05/2021,764,3,98,694,792
28/05/2021,603,3,294,1533,1827
28/05/2021,509,3,226,1276,1502
28/05/2021,579,3,85,824,909
28/05/2021,218,3,159,991,1150
28/05/2021,472,3,384,1998,2382
28/05/2021,308,3,118,593,711
28/05/2021,322,3,78,590,668
28/05/2021,438,3,75,350,425
28/05/2021,403,3,235,1209,1444
28/05/2021,58,3,270,2230,2500
28/05/2021,715,3,222,1072,1294
28/05/2021,730,3,111,951,1062
28/05/2021,8,3,129,787,916
28/05/2021,471,3,66,363,429
28/05/2021,546,3,184,1178,1362
28/05/2021,22,3,123,766,889
28/05/2021,268,3,368,1994,2362
28/05/2021,761,3,133,972,1105
28/05/2021,447,3,60,336,396
28/05/2021,800,3,125,506,631
28/05/2021,682,3,66,412,478
28/05/2021,303,3,187,1215,1402
28/05/2021,220,3,99,603,702
28/05/2021,750,3,129,1201,1330
28/05/2021,34,3,71,360,431
28/05/2021,857,3,165,892,1057
28/05/2021,84,3,210,529,739
28/05/2021,385,3,117,567,684
28/05/2021,143,3,171,1351,1522
28/05/2021,76,3,244,2057,2301
28/05/2021,294,3,287,1943,2230
28/05/2021,432,3,122,971,1093
28/05/2021,805,3,116,435,551
28/05/2021,285,3,124,580,704
28/05/2021,626,3,75,503,578
28/05/2021,886,3,2,73,75
28/05/2021,699,3,71,385,456
28/05/2021,206,3,5,20,25
28/05/2021,180,3,147,778,925
28/05/2021,906,3,8,31,39
28/05/2021,275,3,194,1138,1332
28/05/2021,127,3,104,631,735
28/05/2021,310,3,357,2668,3025
28/05/2021,691,3,107,465,572
28/05/2021,222,3,77,538,615
28/05/2021,612,3,270,2000,2270
28/05/2021,481,3,165,747,912
28/05/2021,52,3,172,858,1030
28/05/2021,772,3,204,1054,1258
28/05/2021,861,3,138,752,890
28/05/2021,742,3,157,1091,1248
28/05/2021,452,3,73,453,526
28/05/2021,227,3,89,477,566
28/05/2021,426,3,82,377,459
28/05/2021,326,3,41,238,279
28/05/2021,485,3,157,796,953
28/05/2021,890,3,135,1326,1461
28/05/2021,334,3,388,1822,2210
28/05/2021,815,3,500,2093,2593
28/05/2021,520,3,80,367,447
28/05/2021,64,3,70,388,458
28/05/2021,466,3,90,597,687
28/05/2021,460,3,69,440,509
28/05/2021,723,3,179,1148,1327
28/05/2021,738,3,134,793,927
28/05/2021,803,3,199,1414,1613
28/05/2021,172,3,103,872,975
28/05/2021,88,3,61,333,394
28/05/2021,101,3,167,1146,1313
28/05/2021,19,3,189,1315,1504
28/05/2021,99,3,353,2437,2790
28/05/2021,868,3,495,2872,3367
28/05/2021,782,3,204,1509,1713
28/05/2021,464,3,187,1129,1316
28/05/2021,642,3,121,617,738
28/05/2021,3,3,61,319,380
28/05/2021,202,3,286,2273,2559
28/05/2021,754,3,136,1161,1297
28/05/2021,204,3,149,859,1008
28/05/2021,422,3,166,1011,1177
28/05/2021,139,3,163,1004,1167
28/05/2021,760,3,184,1481,1665
28/05/2021,292,3,227,1496,1723
28/05/2021,92,3,122,966,1088
28/05/2021,622,3,266,1566,1832
28/05/2021,72,3,332,2635,2967
28/05/2021,813,3,112,491,603
28/05/2021,518,3,25,97,122
28/05/2021,759,3,128,1066,1194
28/05/2021,879,3,4,63,67
28/05/2021,221,3,81,602,683
28/05/2021,236,3,192,1335,1527
28/05/2021,154,3,172,952,1124
28/05/2021,826,3,178,1354,1532
28/05/2021,765,3,184,913,1097
28/05/2021,704,3,53,219,272
28/05/2021,18,3,130,797,927
28/05/2021,488,3,110,572,682
28/05/2021,242,3,236,1655,1891
28/05/2021,47,3,116,419,535
28/05/2021,751,3,6,21,27
28/05/2021,775,3,90,670,760
28/05/2021,671,3,102,655,757
28/05/2021,41,3,97,766,863
28/05/2021,602,3,413,2052,2465
28/05/2021,449,3,104,743,847
28/05/2021,722,3,31,216,247
28/05/2021,928,3,17,70,87
28/05/2021,793,3,142,786,928
28/05/2021,858,3,235,1486,1721
28/05/2021,586,3,177,1068,1245
28/05/2021,702,3,129,731,860
28/05/2021,903,3,8,24,32
28/05/2021,889,3,0,10,10
28/05/2021,504,3,105,504,609
28/05/2021,398,3,47,259,306
28/05/2021,883,3,15,153,168
28/05/2021,477,3,45,351,396
28/05/2021,378,3,59,390,449
28/05/2021,175,3,127,653,780
28/05/2021,406,3,191,790,981
28/05/2021,93,3,156,979,1135
28/05/2021,613,3,32,194,226
28/05/2021,795,3,102,516,618
28/05/2021,69,3,98,655,753
28/05/2021,537,3,193,1054,1247
28/05/2021,492,3,74,402,476
28/05/2021,558,3,57,373,430
28/05/2021,56,3,108,915,1023
28/05/2021,253,3,44,289,333
28/05/2021,186,3,86,496,582
28/05/2021,350,3,65,373,438
28/05/2021,597,3,158,1429,1587
28/05/2021,251,3,64,374,438
28/05/2021,654,3,80,711,791
28/05/2021,462,3,91,640,731
28/05/2021,162,3,396,1388,1784
28/05/2021,825,3,361,1780,2141
28/05/2021,15,3,184,812,996
28/05/2021,512,3,61,352,413
28/05/2021,474,3,95,472,567
28/05/2021,247,3,246,1577,1823
28/05/2021,436,3,81,564,645
28/05/2021,393,3,66,337,403
28/05/2021,192,3,136,562,698
28/05/2021,683,3,125,710,835
28/05/2021,399,3,228,1252,1480
28/05/2021,269,3,71,383,454
28/05/2021,51,3,261,2032,2293
28/05/2021,354,3,2,9,11
28/05/2021,684,3,157,1054,1211
28/05/2021,427,3,408,2491,2899
28/05/2021,163,3,100,340,440
28/05/2021,213,3,166,1015,1181
28/05/2021,875,3,74,360,434
28/05/2021,321,3,87,443,530
28/05/2021,600,3,499,2551,3050
28/05/2021,909,3,6,11,17
28/05/2021,128,3,113,615,728
28/05/2021,252,3,64,317,381
28/05/2021,417,3,226,1910,2136
28/05/2021,266,3,57,334,391
28/05/2021,936,3,81,424,505
28/05/2021,836,3,182,1586,1768
28/05/2021,138,3,157,885,1042
28/05/2021,305,3,134,717,851
28/05/2021,570,3,132,640,772
28/05/2021,286,3,55,237,292
28/05/2021,777,3,146,751,897
28/05/2021,380,3,113,728,841
28/05/2021,276,3,152,853,1005
28/05/2021,696,3,164,1029,1193
28/05/2021,400,3,65,295,360
28/05/2021,897,3,230,1584,1814
28/05/2021,785,3,375,2539,2914
28/05/2021,189,3,55,412,467
28/05/2021,238,3,232,1622,1854
28/05/2021,423,3,150,1903,2053
28/05/2021,895,3,74,332,406
28/05/2021,28,3,93,392,485
28/05/2021,187,3,137,878,1015
28/05/2021,374,3,60,293,353
28/05/2021,87,3,210,1712,1922
28/05/2021,749,3,65,432,497
28/05/2021,246,3,240,1605,1845
28/05/2021,737,3,125,997,1122
28/05/2021,533,3,181,1166,1347
28/05/2021,625,3,124,566,690
28/05/2021,205,3,119,701,820
28/05/2021,435,3,47,367,414
28/05/2021,631,3,48,272,320
28/05/2021,572,3,135,536,671
28/05/2021,91,3,101,534,635
28/05/2021,850,3,445,1665,2110
28/05/2021,842,3,15,55,70
28/05/2021,144,3,129,861,990
28/05/2021,289,3,150,918,1068
28/05/2021,61,3,123,1007,1130
28/05/2021,604,3,364,1736,2100
28/05/2021,30,3,202,1135,1337
28/05/2021,185,3,66,441,507
28/05/2021,124,3,76,400,476
28/05/2021,231,3,138,705,843
28/05/2021,608,3,402,3263,3665
28/05/2021,581,3,161,769,930
28/05/2021,507,3,271,1693,1964
28/05/2021,591,3,109,445,554
28/05/2021,133,3,93,477,570
28/05/2021,119,3,184,1019,1203
28/05/2021,46,3,98,389,487
28/05/2021,25,3,62,310,372
28/05/2021,353,3,42,348,390
28/05/2021,652,3,50,351,401
28/05/2021,200,3,53,372,425
28/05/2021,555,3,290,1601,1891
28/05/2021,448,3,414,2172,2586
28/05/2021,904,3,211,1317,1528
28/05/2021,442,3,63,502,565
28/05/2021,245,3,82,344,426
28/05/2021,145,3,156,824,980
28/05/2021,809,3,52,306,358
28/05/2021,792,3,217,1336,1553
28/05/2021,677,3,93,789,882
28/05/2021,444,3,110,616,726
28/05/2021,922,3,0,10,10
28/05/2021,687,3,145,914,1059
28/05/2021,877,3,5,52,57
28/05/2021,635,3,193,1453,1646
28/05/2021,453,3,107,666,773
28/05/2021,655,3,183,741,924
28/05/2021,463,3,280,1476,1756
28/05/2021,457,3,68,266,334
28/05/2021,663,3,287,1569,1856
28/05/2021,840,3,73,520,593
28/05/2021,140,3,133,1100,1233
28/05/2021,692,3,108,592,700
28/05/2021,27,3,273,1546,1819
28/05/2021,736,3,39,313,352
28/05/2021,567,3,154,530,684
28/05/2021,587,3,58,409,467
28/05/2021,713,3,119,1718,1837
28/05/2021,794,3,282,1430,1712
28/05/2021,456,3,64,376,440
28/05/2021,524,3,141,899,1040
28/05/2021,673,3,87,595,682
28/05/2021,811,3,57,325,382
28/05/2021,770,3,244,1727,1971
28/05/2021,547,3,583,3078,3661
28/05/2021,159,3,197,1855,2052
28/05/2021,149,3,150,681,831
28/05/2021,721,3,574,3532,4106
28/05/2021,937,3,1,13,14
28/05/2021,746,3,64,383,447
28/05/2021,90,3,85,688,773
28/05/2021,229,3,203,1152,1355
28/05/2021,561,3,38,253,291
28/05/2021,164,3,94,800,894
28/05/2021,931,3,0,6,6
28/05/2021,168,3,61,420,481
28/05/2021,210,3,121,704,825
28/05/2021,78,3,564,2990,3554
28/05/2021,117,3,252,1374,1626
28/05/2021,902,3,106,484,590
28/05/2021,330,3,102,715,817
28/05/2021,212,3,222,1484,1706
28/05/2021,807,3,96,408,504
28/05/2021,411,3,203,1551,1754
28/05/2021,304,3,184,1045,1229
28/05/2021,338,3,158,900,1058
28/05/2021,493,3,131,650,781
28/05/2021,601,3,104,862,966
28/05/2021,894,3,191,1104,1295
28/05/2021,870,3,33,177,210
28/05/2021,80,3,146,984,1130
28/05/2021,859,3,18,102,120
28/05/2021,610,3,345,2614,2959
28/05/2021,499,3,194,740,934
28/05/2021,733,3,91,575,666
28/05/2021,97,3,294,1534,1828
28/05/2021,188,3,135,878,1013
28/05/2021,355,3,71,617,688
28/05/2021,656,3,72,757,829
28/05/2021,501,3,260,1575,1835
28/05/2021,340,3,157,893,1050
28/05/2021,697,3,107,794,901
28/05/2021,636,3,263,1523,1786
28/05/2021,232,3,89,546,635
28/05/2021,392,3,90,465,555
28/05/2021,767,3,265,1807,2072
28/05/2021,274,3,3,39,42
28/05/2021,885,3,14,159,173
28/05/2021,623,3,196,900,1096
28/05/2021,250,3,145,490,635
28/05/2021,588,3,78,402,480
28/05/2021,860,3,160,675,835
28/05/2021,366,3,98,438,536
28/05/2021,120,3,126,611,737
28/05/2021,480,3,96,411,507
28/05/2021,177,3,75,377,452
28/05/2021,33,3,139,889,1028
28/05/2021,429,3,149,929,1078
28/05/2021,854,3,239,1347,1586
28/05/2021,108,3,90,486,576
28/05/2021,277,3,170,1088,1258
28/05/2021,257,3,481,2746,3227
28/05/2021,314,3,67,297,364
28/05/2021,837,3,208,1308,1516
28/05/2021,709,3,338,1990,2328
28/05/2021,831,3,144,813,957
28/05/2021,434,3,22,204,226
28/05/2021,176,3,167,879,1046
28/05/2021,121,3,507,2637,3144
28/05/2021,505,3,104,522,626
28/05/2021,855,3,124,770,894
28/05/2021,835,3,139,687,826
28/05/2021,389,3,235,1948,2183
28/05/2021,32,3,132,809,941
28/05/2021,103,3,187,663,850
28/05/2021,137,3,197,1153,1350
28/05/2021,538,3,120,855,975
28/05/2021,551,3,221,1413,1634
28/05/2021,569,3,128,529,657
28/05/2021,839,3,107,591,698
28/05/2021,758,3,111,685,796
28/05/2021,373,3,66,461,527
28/05/2021,650,3,96,562,658
28/05/2021,430,3,70,385,455
28/05/2021,113,3,107,387,494
28/05/2021,563,3,110,514,624
28/05/2021,575,3,30,152,182
28/05/2021,872,3,94,495,589
28/05/2021,896,3,573,2969,3542
28/05/2021,819,3,162,897,1059
28/05/2021,23,3,44,185,229
28/05/2021,801,3,143,782,925
28/05/2021,50,3,92,473,565
28/05/2021,553,3,58,388,446
28/05/2021,470,3,138,711,849
28/05/2021,849,3,120,1055,1175
28/05/2021,379,3,130,890,1020
28/05/2021,573,3,111,471,582
28/05/2021,847,3,4,92,96
28/05/2021,633,3,119,526,645
28/05/2021,564,3,183,1188,1371
28/05/2021,219,3,54,390,444
28/05/2021,619,3,132,748,880
28/05/2021,349,3,92,481,573
28/05/2021,556,3,316,1814,2130
28/05/2021,323,3,32,206,238
28/05/2021,215,3,51,360,411
28/05/2021,887,3,2,57,59
28/05/2021,544,3,198,1217,1415
28/05/2021,77,3,215,1713,1928
28/05/2021,75,3,269,2124,2393
28/05/2021,384,3,129,758,887
28/05/2021,856,3,283,1345,1628
28/05/2021,724,3,521,2743,3264
28/05/2021,181,3,99,650,749
28/05/2021,808,3,279,1765,2044
28/05/2021,329,3,291,1947,2238
28/05/2021,98,3,280,1994,2274
28/05/2021,698,3,100,766,866
28/05/2021,913,3,236,1678,1914
28/05/2021,301,3,219,1393,1612
28/05/2021,55,3,65,363,428
28/05/2021,814,3,70,357,427
28/05/2021,337,3,130,922,1052
28/05/2021,550,3,179,1093,1272
28/05/2021,459,3,77,344,421
28/05/2021,891,3,92,382,474
28/05/2021,844,3,38,372,410
28/05/2021,319,3,29,172,201
28/05/2021,911,3,149,1153,1302
28/05/2021,313,3,75,293,368
28/05/2021,508,3,230,1249,1479
28/05/2021,299,3,85,380,465
28/05/2021,716,3,52,597,649
28/05/2021,193,3,159,788,947
28/05/2021,475,3,252,1494,1746
28/05/2021,183,3,53,380,433
28/05/2021,594,3,302,1894,2196
28/05/2021,932,3,2,59,61
28/05/2021,617,3,69,387,456
28/05/2021,262,3,87,585,672
28/05/2021,228,3,91,487,578
28/05/2021,917,3,4,75,79
28/05/2021,519,3,90,576,666
28/05/2021,755,3,218,1861,2079
28/05/2021,865,3,89,423,512
28/05/2021,451,3,305,2014,2319
28/05/2021,106,3,198,1519,1717
28/05/2021,848,3,158,936,1094
28/05/2021,745,3,69,425,494
28/05/2021,122,3,126,562,688
28/05/2021,615,3,134,793,927
28/05/2021,710,3,79,493,572
28/05/2021,700,3,102,767,869
28/05/2021,278,3,133,742,875
28/05/2021,753,3,133,1063,1196
28/05/2021,100,3,374,2551,2925
28/05/2021,852,3,219,1142,1361
28/05/2021,71,3,216,1701,1917
28/05/2021,370,3,175,1257,1432
28/05/2021,171,3,26,251,277
28/05/2021,89,3,165,1367,1532
28/05/2021,490,3,112,644,756
28/05/2021,921,3,0,17,17
28/05/2021,830,3,549,2804,3353
28/05/2021,327,3,288,1886,2174
28/05/2021,203,3,125,800,925
28/05/2021,820,3,85,535,620
28/05/2021,410,3,186,1571,1757
28/05/2021,643,3,135,687,822
28/05/2021,256,3,184,1015,1199
28/05/2021,96,3,99,799,898
28/05/2021,791,3,75,496,571
28/05/2021,2,3,63,317,380
28/05/2021,158,3,55,271,326
28/05/2021,531,3,150,1021,1171
28/05/2021,339,3,135,741,876
28/05/2021,441,3,267,1402,1669
28/05/2021,732,3,62,400,462
28/05/2021,386,3,330,2778,3108
28/05/2021,486,3,129,753,882
28/05/2021,53,3,168,884,1052
28/05/2021,818,3,130,585,715
28/05/2021,757,3,226,1333,1559
28/05/2021,397,3,68,361,429
28/05/2021,898,3,85,411,496
28/05/2021,851,3,162,834,996
28/05/2021,300,3,216,1477,1693
28/05/2021,853,3,86,418,504
28/05/2021,670,3,620,3231,3851
28/05/2021,348,3,50,342,392
28/05/2021,768,3,222,1762,1984
28/05/2021,833,3,78,302,380
28/05/2021,249,3,247,1576,1823
28/05/2021,540,3,176,1156,1332
28/05/2021,312,3,142,527,669
28/05/2021,48,3,92,482,574
28/05/2021,557,3,79,514,593
28/05/2021,151,3,43,272,315
28/05/2021,817,3,143,915,1058
28/05/2021,620,3,0,4,4
28/05/2021,342,3,74,454,528
28/05/2021,131,3,149,930,1079
28/05/2021,271,3,75,435,510
28/05/2021,190,3,136,771,907
28/05/2021,593,3,412,2603,3015
28/05/2021,243,3,224,1520,1744
28/05/2021,778,3,184,828,1012
28/05/2021,420,3,275,1491,1766
28/05/2021,689,3,120,667,787
28/05/2021,184,3,50,231,281
28/05/2021,259,3,392,2364,2756
28/05/2021,365,3,121,468,589
28/05/2021,255,3,8,44,52
28/05/2021,526,3,67,296,363
28/05/2021,939,3,0,12,12
28/05/2021,201,3,78,691,769
28/05/2021,562,3,65,580,645
28/05/2021,455,3,96,673,769
28/05/2021,414,3,189,1759,1948
28/05/2021,343,3,51,350,401
28/05/2021,494,3,118,578,696
28/05/2021,358,3,303,2393,2696
28/05/2021,621,3,101,544,645
28/05/2021,641,3,134,674,808
28/05/2021,905,3,5,17,22
28/05/2021,179,3,123,700,823
28/05/2021,828,3,171,862,1033
28/05/2021,445,3,121,806,927
28/05/2021,653,3,47,383,430
28/05/2021,156,3,252,1595,1847
28/05/2021,741,3,97,741,838
28/05/2021,196,3,177,780,957
28/05/2021,298,3,253,1569,1822
28/05/2021,166,3,42,551,593
28/05/2021,7,3,63,313,376
28/05/2021,497,3,204,1238,1442
28/05/2021,798,3,265,1556,1821
28/05/2021,157,3,149,616,765
28/05/2021,125,3,104,450,554
28/05/2021,941,3,4,37,41
28/05/2021,123,3,87,510,597
28/05/2021,935,3,1,3,4
28/05/2021,105,3,216,1211,1427
28/05/2021,774,3,98,492,590
28/05/2021,585,3,265,1564,1829
28/05/2021,646,3,95,581,676
28/05/2021,532,3,639,3964,4603
28/05/2021,874,3,72,413,485
28/05/2021,44,3,233,1346,1579
28/05/2021,876,3,2,22,24
28/05/2021,577,3,101,896,997
28/05/2021,719,3,82,393,475
28/05/2021,595,3,119,669,788
28/05/2021,315,3,40,222,262
28/05/2021,169,3,71,523,594
28/05/2021,720,3,86,548,634
28/05/2021,871,3,208,1155,1363
28/05/2021,548,3,115,378,493
28/05/2021,726,3,77,459,536
28/05/2021,747,3,46,337,383
28/05/2021,649,3,95,435,530
28/05/2021,297,3,180,1323,1503
28/05/2021,924,3,0,21,21
28/05/2021,60,3,42,190,232
28/05/2021,658,3,42,223,265
28/05/2021,675,3,76,395,471
28/05/2021,534,3,101,725,826
28/05/2021,194,3,3,4,7
28/05/2021,632,3,60,319,379
28/05/2021,418,3,105,823,928
28/05/2021,863,3,86,468,554
28/05/2021,900,3,19,75,94
28/05/2021,752,3,236,1540,1776
28/05/2021,681,3,119,495,614
28/05/2021,235,3,92,710,802
28/05/2021,383,3,334,2298,2632
28/05/2021,918,3,0,10,10
28/05/2021,437,3,121,776,897
28/05/2021,498,3,105,595,700
28/05/2021,67,3,91,833,924
28/05/2021,915,3,3,40,43
28/05/2021,806,3,222,1701,1923
28/05/2021,657,3,229,1103,1332
28/05/2021,560,3,305,1722,2027
28/05/2021,226,3,111,689,800
28/05/2021,57,3,110,889,999
28/05/2021,4,3,118,711,829
28/05/2021,525,3,149,1170,1319
28/05/2021,368,3,186,1294,1480
28/05/2021,152,3,125,893,1018
28/05/2021,211,3,162,977,1139
28/05/2021,669,3,129,786,915
28/05/2021,473,3,62,284,346
28/05/2021,443,3,106,613,719
28/05/2021,195,3,99,360,459
28/05/2021,95,3,297,2038,2335
28/05/2021,244,3,160,1069,1229
28/05/2021,309,3,16,39,55
28/05/2021,59,3,117,725,842
28/05/2021,161,3,433,1676,2109
28/05/2021,802,3,234,1894,2128
28/05/2021,37,3,95,491,586
28/05/2021,637,3,238,1873,2111
28/05/2021,79,3,121,483,604
28/05/2021,293,3,162,1058,1220
28/05/2021,360,3,95,611,706
28/05/2021,783,3,300,2465,2765
28/05/2021,500,3,62,378,440
28/05/2021,356,3,244,1957,2201
28/05/2021,465,3,92,462,554
28/05/2021,907,3,249,1370,1619
28/05/2021,114,3,169,801,970
28/05/2021,846,3,6,123,129
28/05/2021,311,3,286,1545,1831
28/05/2021,280,3,39,112,151
28/05/2021,797,3,211,1148,1359
28/05/2021,712,3,85,499,584
28/05/2021,217,3,153,928,1081
28/05/2021,824,3,281,1438,1719
28/05/2021,333,3,102,1500,1602
28/05/2021,43,3,112,813,925
28/05/2021,566,3,80,495,575
28/05/2021,628,3,107,602,709
28/05/2021,237,3,191,1271,1462
28/05/2021,318,3,218,1347,1565
28/05/2021,565,3,306,1765,2071
28/05/2021,735,3,94,845,939
28/05/2021,155,3,230,1773,2003
28/05/2021,178,3,152,918,1070
28/05/2021,54,3,99,560,659
28/05/2021,279,3,182,1048,1230
28/05/2021,786,3,242,1893,2135
28/05/2021,528,3,75,312,387
28/05/2021,478,3,107,121,228
28/05/2021,489,3,12,91,103
28/05/2021,929,3,0,1,1
28/05/2021,788,3,298,2184,2482
28/05/2021,458,3,117,614,731
28/05/2021,31,3,108,818,926
28/05/2021,664,3,331,1575,1906
28/05/2021,483,3,189,1034,1223
28/05/2021,214,3,164,995,1159
28/05/2021,94,3,18,102,120
28/05/2021,346,3,53,371,424
28/05/2021,160,3,15,66,81
28/05/2021,21,3,169,1136,1305
28/05/2021,845,3,104,519,623
28/05/2021,725,3,74,405,479
28/05/2021,208,3,56,413,469
28/05/2021,880,3,3,38,41
28/05/2021,363,3,177,642,819
28/05/2021,225,3,257,1269,1526
28/05/2021,618,3,120,679,799
28/05/2021,827,3,264,1488,1752
28/05/2021,381,3,12,106,118
28/05/2021,487,3,135,716,851
28/05/2021,583,3,84,482,566
28/05/2021,731,3,61,328,389
28/05/2021,216,3,81,455,536
28/05/2021,841,3,24,201,225
28/05/2021,233,3,144,656,800
28/05/2021,703,3,121,708,829
28/05/2021,624,3,36,211,247
28/05/2021,511,3,106,788,894
28/05/2021,263,3,146,965,1111
28/05/2021,685,3,84,458,542
28/05/2021,369,3,270,1632,1902
28/05/2021,440,3,198,1107,1305
28/05/2021,634,3,61,367,428
28/05/2021,748,3,57,323,380
28/05/2021,86,3,54,431,485
28/05/2021,361,3,162,603,765
28/05/2021,413,3,233,2031,2264
28/05/2021,648,3,140,785,925
28/05/2021,589,3,93,437,530
28/05/2021,147,3,123,856,979
28/05/2021,17,3,76,340,416
28/05/2021,287,3,263,1593,1856
28/05/2021,888,3,4,78,82
28/05/2021,571,3,114,466,580
28/05/2021,332,3,72,473,545
28/05/2021,607,3,329,2525,2854
28/05/2021,42,3,95,418,513
28/05/2021,153,3,164,859,1023
28/05/2021,864,3,69,315,384
28/05/2021,198,3,171,733,904
28/05/2021,776,3,111,837,948
28/05/2021,433,3,377,1948,2325
28/05/2021,527,3,84,302,386
28/05/2021,12,3,54,349,403
28/05/2021,881,3,1,24,25
28/05/2021,390,3,225,1780,2005
28/05/2021,142,3,78,297,375
28/05/2021,467,3,76,650,726
28/05/2021,209,3,37,227,264
28/05/2021,529,3,110,442,552
28/05/2021,173,3,72,407,479
28/05/2021,816,3,207,1619,1826
28/05/2021,862,3,164,908,1072
28/05/2021,167,3,186,1220,1406
28/05/2021,739,3,96,726,822
28/05/2021,496,3,61,359,420
28/05/2021,394,3,86,421,507
28/05/2021,371,3,137,868,1005
28/05/2021,514,3,59,335,394
28/05/2021,1,3,59,305,364
28/05/2021,701,3,112,624,736
28/05/2021,265,3,104,727,831
28/05/2021,111,3,237,1249,1486
28/05/2021,823,3,57,227,284
28/05/2021,391,3,239,1784,2023
28/05/2021,660,3,70,336,406
28/05/2021,878,3,14,63,77
28/05/2021,651,3,125,771,896
28/05/2021,461,3,189,1337,1526
28/05/2021,578,3,69,312,381
28/05/2021,421,3,238,1232,1470
28/05/2021,469,3,90,821,911
28/05/2021,260,3,637,3798,4435
28/05/2021,517,3,77,418,495
28/05/2021,24,3,40,173,213
28/05/2021,661,3,388,1908,2296
28/05/2021,580,3,96,679,775
28/05/2021,680,3,91,490,581
28/05/2021,425,3,129,1079,1208
28/05/2021,694,3,106,679,785
28/05/2021,357,3,285,2217,2502
28/05/2021,407,3,198,1744,1942
28/05/2021,316,3,95,607,702
28/05/2021,38,3,97,622,719
28/05/2021,821,3,192,1176,1368
28/05/2021,530,3,103,571,674
28/05/2021,290,3,215,1365,1580
28/05/2021,668,3,39,286,325
28/05/2021,5,3,59,307,366
28/05/2021,476,3,58,407,465
28/05/2021,174,3,91,469,560
28/05/2021,679,3,87,401,488
28/05/2021,559,3,322,1771,2093
28/05/2021,107,3,373,2557,2930
28/05/2021,916,3,0,8,8
28/05/2021,804,3,201,1289,1490
28/05/2021,408,3,238,2061,2299
28/05/2021,112,3,80,505,585
28/05/2021,934,3,3,37,40
28/05/2021,535,3,126,687,813
28/05/2021,264,3,96,620,716
28/05/2021,104,3,196,1080,1276
28/05/2021,402,3,211,1114,1325
28/05/2021,901,3,14,94,108
28/05/2021,899,3,250,1951,2201
28/05/2021,272,3,161,1009,1170
28/05/2021,688,3,88,504,592
28/05/2021,83,3,569,2772,3341
28/05/2021,479,3,98,410,508
28/05/2021,248,3,137,916,1053
28/05/2021,126,3,157,920,1077
28/05/2021,341,3,463,2500,2963
28/05/2021,743,3,53,295,348
28/05/2021,510,3,246,1541,1787
28/05/2021,930,3,1,49,50
28/05/2021,102,3,156,868,1024
28/05/2021,412,3,129,1233,1362
28/05/2021,45,3,74,448,522
28/05/2021,706,3,311,1671,1982
28/05/2021,543,3,567,3042,3609
28/05/2021,134,3,212,1228,1440
28/05/2021,199,3,54,375,429
28/05/2021,582,3,461,2758,3219
28/05/2021,39,3,117,899,1016
28/05/2021,686,3,91,594,685
28/05/2021,431,3,77,346,423
28/05/2021,832,3,137,637,774
28/05/2021,484,3,100,372,472
28/05/2021,136,3,211,1225,1436
28/05/2021,352,3,224,1027,1251
28/05/2021,574,3,142,580,722
28/05/2021,714,3,180,960,1140
28/05/2021,506,3,252,1533,1785
28/05/2021,439,3,68,384,452
28/05/2021,362,3,164,618,782
28/05/2021,584,3,397,2320,2717
28/05/2021,838,3,265,1630,1895
28/05/2021,728,3,170,1587,1757
28/05/2021,647,3,51,173,224
28/05/2021,110,3,129,528,657
28/05/2021,404,3,409,2527,2936
28/05/2021,382,3,0,4,4
28/05/2021,598,3,528,3022,3550
29/05/2021,484,3,116,385,501
29/05/2021,352,3,334,1726,2060
29/05/2021,832,3,266,1609,1875
29/05/2021,584,3,502,3011,3513
29/05/2021,598,3,811,5069,5880
29/05/2021,110,3,172,881,1053
29/05/2021,506,3,336,2370,2706
29/05/2021,431,3,114,543,657
29/05/2021,714,3,284,1786,2070
29/05/2021,136,3,290,1595,1885
29/05/2021,382,3,0,9,9
29/05/2021,647,3,76,335,411
29/05/2021,838,3,575,4211,4786
29/05/2021,574,3,183,879,1062
29/05/2021,728,3,378,3487,3865
29/05/2021,362,3,197,901,1098
29/05/2021,404,3,558,3599,4157
29/05/2021,439,3,101,560,661
29/05/2021,686,3,104,826,930
29/05/2021,480,3,100,440,540
29/05/2021,429,3,267,2211,2478
29/05/2021,623,3,300,1765,2065
29/05/2021,392,3,159,901,1060
29/05/2021,854,3,409,2391,2800
29/05/2021,250,3,169,713,882
29/05/2021,232,3,127,706,833
29/05/2021,860,3,260,1298,1558
29/05/2021,588,3,126,640,766
29/05/2021,274,3,1,46,47
29/05/2021,120,3,229,1161,1390
29/05/2021,33,3,233,1302,1535
29/05/2021,885,3,11,151,162
29/05/2021,177,3,136,701,837
29/05/2021,108,3,183,1137,1320
29/05/2021,366,3,203,1228,1431
29/05/2021,767,3,399,3388,3787
29/05/2021,222,3,117,755,872
29/05/2021,326,3,70,464,534
29/05/2021,906,3,10,35,45
29/05/2021,127,3,144,1074,1218
29/05/2021,227,3,123,939,1062
29/05/2021,742,3,295,2138,2433
29/05/2021,452,3,108,721,829
29/05/2021,861,3,208,1490,1698
29/05/2021,691,3,129,687,816
29/05/2021,275,3,302,1681,1983
29/05/2021,310,3,539,4058,4597
29/05/2021,481,3,267,1774,2041
29/05/2021,612,3,460,3995,4455
29/05/2021,426,3,108,484,592
29/05/2021,52,3,233,1309,1542
29/05/2021,772,3,263,1719,1982
29/05/2021,288,3,113,967,1080
29/05/2021,892,3,7,44,51
29/05/2021,261,3,925,5907,6832
29/05/2021,843,3,118,895,1013
29/05/2021,359,3,187,817,1004
29/05/2021,328,3,142,1097,1239
29/05/2021,495,3,224,1437,1661
29/05/2021,454,3,383,2664,3047
29/05/2021,82,3,403,2403,2806
29/05/2021,910,3,11,151,162
29/05/2021,270,3,95,621,716
29/05/2021,35,3,255,2357,2612
29/05/2021,376,3,57,254,311
29/05/2021,372,3,462,2665,3127
29/05/2021,627,3,112,897,1009
29/05/2021,665,3,115,1038,1153
29/05/2021,554,3,169,1481,1650
29/05/2021,639,3,152,816,968
29/05/2021,307,3,332,2029,2361
29/05/2021,919,3,134,776,910
29/05/2021,295,3,170,1277,1447
29/05/2021,197,3,286,1746,2032
29/05/2021,85,3,565,2723,3288
29/05/2021,674,3,155,834,989
29/05/2021,659,3,75,612,687
29/05/2021,468,3,131,730,861
29/05/2021,377,3,279,1407,1686
29/05/2021,395,3,124,721,845
29/05/2021,283,3,240,1466,1706
29/05/2021,13,3,391,2336,2727
29/05/2021,336,3,557,3808,4365
29/05/2021,36,3,169,1115,1284
29/05/2021,640,3,165,921,1086
29/05/2021,273,3,116,718,834
29/05/2021,599,3,782,5103,5885
29/05/2021,605,3,554,3019,3573
29/05/2021,503,3,385,2729,3114
29/05/2021,405,3,109,908,1017
29/05/2021,727,3,115,597,712
29/05/2021,693,3,250,1908,2158
29/05/2021,914,3,2,17,19
29/05/2021,926,3,355,3142,3497
29/05/2021,536,3,302,1868,2170
29/05/2021,908,3,97,895,992
29/05/2021,387,3,188,985,1173
29/05/2021,367,3,321,2457,2778
29/05/2021,302,3,170,1183,1353
29/05/2021,552,3,280,1699,1979
29/05/2021,771,3,218,1972,2190
29/05/2021,606,3,304,2150,2454
29/05/2021,773,3,94,466,560
29/05/2021,331,3,108,844,952
29/05/2021,81,3,245,2205,2450
29/05/2021,645,3,123,742,865
29/05/2021,116,3,121,746,867
29/05/2021,388,3,426,3762,4188
29/05/2021,351,3,584,3622,4206
29/05/2021,291,3,174,1204,1378
29/05/2021,920,3,3,38,41
29/05/2021,267,3,116,825,941
29/05/2021,401,3,178,1329,1507
29/05/2021,450,3,113,788,901
29/05/2021,707,3,368,2329,2697
29/05/2021,491,3,235,1714,1949
29/05/2021,790,3,281,2259,2540
29/05/2021,281,3,365,2460,2825
29/05/2021,522,3,162,1080,1242
29/05/2021,182,3,216,1384,1600
29/05/2021,882,3,2,31,33
29/05/2021,666,3,315,2020,2335
29/05/2021,296,3,154,1417,1571
29/05/2021,66,3,183,1810,1993
29/05/2021,239,3,270,1809,2079
29/05/2021,416,3,182,1990,2172
29/05/2021,784,3,316,2051,2367
29/05/2021,446,3,189,1663,1852
29/05/2021,63,3,106,731,837
29/05/2021,576,3,130,1014,1144
29/05/2021,810,3,122,858,980
29/05/2021,317,3,371,2558,2929
29/05/2021,148,3,52,305,357
29/05/2021,812,3,142,1035,1177
29/05/2021,942,3,3,21,24
29/05/2021,240,3,323,2100,2423
29/05/2021,146,3,224,1677,1901
29/05/2021,513,3,208,1497,1705
29/05/2021,26,3,269,1578,1847
29/05/2021,345,3,139,769,908
29/05/2021,206,3,3,26,29
29/05/2021,285,3,204,1266,1470
29/05/2021,220,3,149,1125,1274
29/05/2021,76,3,333,3217,3550
29/05/2021,626,3,128,1045,1173
29/05/2021,432,3,241,1944,2185
29/05/2021,699,3,101,512,613
29/05/2021,34,3,108,761,869
29/05/2021,143,3,253,2033,2286
29/05/2021,294,3,348,2599,2947
29/05/2021,857,3,309,1688,1997
29/05/2021,750,3,186,1820,2006
29/05/2021,180,3,302,1914,2216
29/05/2021,805,3,200,1038,1238
29/05/2021,84,3,311,1186,1497
29/05/2021,886,3,0,67,67
29/05/2021,385,3,129,687,816
29/05/2021,129,3,336,1864,2200
29/05/2021,884,3,10,156,166
29/05/2021,115,3,140,1036,1176
29/05/2021,135,3,303,1737,2040
29/05/2021,662,3,394,1998,2392
29/05/2021,933,3,0,9,9
29/05/2021,68,3,183,1818,2001
29/05/2021,344,3,153,914,1067
29/05/2021,616,3,248,1456,1704
29/05/2021,428,3,120,989,1109
29/05/2021,9,3,105,526,631
29/05/2021,542,3,280,1347,1627
29/05/2021,756,3,274,2633,2907
29/05/2021,207,3,115,1031,1146
29/05/2021,419,3,484,2495,2979
29/05/2021,396,3,82,484,566
29/05/2021,779,3,224,1419,1643
29/05/2021,335,3,238,1532,1770
29/05/2021,789,3,211,1220,1431
29/05/2021,224,3,115,796,911
29/05/2021,130,3,336,1889,2225
29/05/2021,676,3,88,449,537
29/05/2021,347,3,403,1410,1813
29/05/2021,867,3,98,550,648
29/05/2021,629,3,208,1308,1516
29/05/2021,20,3,114,547,661
29/05/2021,781,3,517,3945,4462
29/05/2021,254,3,93,594,687
29/05/2021,282,3,225,1441,1666
29/05/2021,592,3,314,1847,2161
29/05/2021,65,3,136,1329,1465
29/05/2021,515,3,182,1246,1428
29/05/2021,869,3,191,870,1061
29/05/2021,590,3,0,2,2
29/05/2021,799,3,62,231,293
29/05/2021,230,3,190,1002,1192
29/05/2021,787,3,467,3420,3887
29/05/2021,923,3,6,23,29
29/05/2021,284,3,128,971,1099
29/05/2021,734,3,36,137,173
29/05/2021,364,3,198,898,1096
29/05/2021,521,3,120,706,826
29/05/2021,49,3,114,910,1024
29/05/2021,325,3,186,1629,1815
29/05/2021,258,3,922,5821,6743
29/05/2021,873,3,262,1478,1740
29/05/2021,118,3,268,1571,1839
29/05/2021,938,3,1,13,14
29/05/2021,539,3,346,2000,2346
29/05/2021,925,3,0,13,13
29/05/2021,6,3,82,468,550
29/05/2021,234,3,229,1814,2043
29/05/2021,546,3,305,1817,2122
29/05/2021,682,3,116,722,838
29/05/2021,8,3,180,1206,1386
29/05/2021,761,3,258,2660,2918
29/05/2021,268,3,575,3537,4112
29/05/2021,447,3,81,472,553
29/05/2021,800,3,193,924,1117
29/05/2021,22,3,214,1316,1530
29/05/2021,730,3,302,2999,3301
29/05/2021,303,3,275,2211,2486
29/05/2021,471,3,76,482,558
29/05/2021,70,3,242,2488,2730
29/05/2021,711,3,98,618,716
29/05/2021,829,3,261,1662,1923
29/05/2021,614,3,122,1159,1281
29/05/2021,170,3,206,1616,1822
29/05/2021,638,3,267,1723,1990
29/05/2021,866,3,582,4450,5032
29/05/2021,705,3,58,359,417
29/05/2021,11,3,143,1005,1148
29/05/2021,780,3,497,3307,3804
29/05/2021,424,3,240,3004,3244
29/05/2021,717,3,190,1690,1880
29/05/2021,409,3,205,1763,1968
29/05/2021,603,3,425,2442,2867
29/05/2021,322,3,150,1336,1486
29/05/2021,579,3,153,1751,1904
29/05/2021,472,3,675,3468,4143
29/05/2021,58,3,378,3135,3513
29/05/2021,218,3,191,1490,1681
29/05/2021,308,3,170,882,1052
29/05/2021,764,3,184,1881,2065
29/05/2021,438,3,111,634,745
29/05/2021,509,3,307,2244,2551
29/05/2021,715,3,375,2037,2412
29/05/2021,403,3,369,2339,2708
29/05/2021,733,3,141,1333,1474
29/05/2021,656,3,98,1214,1312
29/05/2021,636,3,510,3484,3994
29/05/2021,188,3,191,1320,1511
29/05/2021,610,3,535,4972,5507
29/05/2021,894,3,357,2530,2887
29/05/2021,340,3,264,1671,1935
29/05/2021,501,3,323,2262,2585
29/05/2021,870,3,43,221,264
29/05/2021,355,3,204,2219,2423
29/05/2021,97,3,420,2136,2556
29/05/2021,601,3,177,1541,1718
29/05/2021,80,3,294,2755,3049
29/05/2021,697,3,161,1469,1630
29/05/2021,859,3,28,172,200
29/05/2021,499,3,313,1856,2169
29/05/2021,936,3,178,1219,1397
29/05/2021,163,3,236,1373,1609
29/05/2021,417,3,271,2294,2565
29/05/2021,321,3,128,816,944
29/05/2021,836,3,311,3102,3413
29/05/2021,252,3,98,539,637
29/05/2021,354,3,4,10,14
29/05/2021,600,3,681,3553,4234
29/05/2021,875,3,105,568,673
29/05/2021,51,3,525,4055,4580
29/05/2021,138,3,253,1230,1483
29/05/2021,684,3,260,1835,2095
29/05/2021,909,3,7,13,20
29/05/2021,128,3,166,1177,1343
29/05/2021,266,3,84,508,592
29/05/2021,427,3,810,4544,5354
29/05/2021,213,3,194,1431,1625
29/05/2021,18,3,191,1328,1519
29/05/2021,236,3,366,3104,3470
29/05/2021,47,3,157,676,833
29/05/2021,154,3,224,1330,1554
29/05/2021,759,3,268,2221,2489
29/05/2021,488,3,149,838,987
29/05/2021,221,3,125,887,1012
29/05/2021,704,3,54,337,391
29/05/2021,765,3,239,1311,1550
29/05/2021,879,3,5,86,91
29/05/2021,826,3,181,1397,1578
29/05/2021,751,3,11,23,34
29/05/2021,242,3,316,1942,2258
29/05/2021,101,3,279,2169,2448
29/05/2021,88,3,90,294,384
29/05/2021,738,3,218,1453,1671
29/05/2021,485,3,242,1763,2005
29/05/2021,803,3,270,1670,1940
29/05/2021,723,3,254,1389,1643
29/05/2021,99,3,514,3310,3824
29/05/2021,466,3,163,1198,1361
29/05/2021,172,3,152,1269,1421
29/05/2021,19,3,336,2676,3012
29/05/2021,868,3,749,4788,5537
29/05/2021,815,3,661,3064,3725
29/05/2021,460,3,122,862,984
29/05/2021,64,3,153,966,1119
29/05/2021,890,3,204,2197,2401
29/05/2021,334,3,554,3260,3814
29/05/2021,520,3,72,524,596
29/05/2021,3,3,78,428,506
29/05/2021,422,3,267,1565,1832
29/05/2021,204,3,226,1601,1827
29/05/2021,622,3,403,2719,3122
29/05/2021,202,3,496,3912,4408
29/05/2021,518,3,30,82,112
29/05/2021,782,3,462,3370,3832
29/05/2021,292,3,266,2161,2427
29/05/2021,92,3,225,1995,2220
29/05/2021,642,3,146,858,1004
29/05/2021,72,3,519,5171,5690
29/05/2021,139,3,285,1543,1828
29/05/2021,754,3,193,2136,2329
29/05/2021,760,3,327,3309,3636
29/05/2021,464,3,420,2438,2858
29/05/2021,813,3,167,901,1068
29/05/2021,162,3,450,1515,1965
29/05/2021,825,3,618,3696,4314
29/05/2021,436,3,140,1125,1265
29/05/2021,474,3,169,1058,1227
29/05/2021,399,3,306,1663,1969
29/05/2021,251,3,109,741,850
29/05/2021,192,3,199,1222,1421
29/05/2021,683,3,163,1078,1241
29/05/2021,654,3,173,1305,1478
29/05/2021,393,3,111,622,733
29/05/2021,253,3,72,582,654
29/05/2021,15,3,215,949,1164
29/05/2021,462,3,144,1125,1269
29/05/2021,350,3,118,795,913
29/05/2021,247,3,401,3061,3462
29/05/2021,269,3,129,887,1016
29/05/2021,512,3,91,495,586
29/05/2021,597,3,428,4007,4435
29/05/2021,186,3,129,968,1097
29/05/2021,56,3,163,1389,1552
29/05/2021,449,3,187,1357,1544
29/05/2021,722,3,46,346,392
29/05/2021,928,3,45,313,358
29/05/2021,41,3,150,1386,1536
29/05/2021,602,3,569,3369,3938
29/05/2021,775,3,163,1464,1627
29/05/2021,671,3,144,1093,1237
29/05/2021,793,3,204,1257,1461
29/05/2021,477,3,98,654,752
29/05/2021,702,3,249,1417,1666
29/05/2021,903,3,12,63,75
29/05/2021,858,3,358,2592,2950
29/05/2021,613,3,64,410,474
29/05/2021,889,3,0,12,12
29/05/2021,398,3,91,454,545
29/05/2021,492,3,117,652,769
29/05/2021,93,3,287,2359,2646
29/05/2021,406,3,231,850,1081
29/05/2021,175,3,252,1471,1723
29/05/2021,883,3,13,156,169
29/05/2021,558,3,93,600,693
29/05/2021,586,3,215,1579,1794
29/05/2021,69,3,151,986,1137
29/05/2021,537,3,276,1381,1657
29/05/2021,795,3,134,762,896
29/05/2021,504,3,187,1252,1439
29/05/2021,378,3,100,641,741
29/05/2021,330,3,174,1425,1599
29/05/2021,493,3,206,1321,1527
29/05/2021,212,3,340,2921,3261
29/05/2021,338,3,268,1719,1987
29/05/2021,117,3,349,2299,2648
29/05/2021,807,3,161,869,1030
29/05/2021,304,3,250,1488,1738
29/05/2021,78,3,746,4862,5608
29/05/2021,411,3,326,3094,3420
29/05/2021,902,3,180,920,1100
29/05/2021,210,3,140,786,926
29/05/2021,604,3,514,3070,3584
29/05/2021,124,3,105,736,841
29/05/2021,144,3,191,1553,1744
29/05/2021,30,3,243,1498,1741
29/05/2021,61,3,164,1681,1845
29/05/2021,185,3,140,1013,1153
29/05/2021,289,3,178,1460,1638
29/05/2021,842,3,16,81,97
29/05/2021,850,3,615,2554,3169
29/05/2021,286,3,62,316,378
29/05/2021,380,3,156,1000,1156
29/05/2021,189,3,111,787,898
29/05/2021,785,3,469,3412,3881
29/05/2021,276,3,314,2078,2392
29/05/2021,28,3,133,637,770
29/05/2021,897,3,363,2719,3082
29/05/2021,895,3,110,395,505
29/05/2021,423,3,244,3135,3379
29/05/2021,305,3,202,1220,1422
29/05/2021,696,3,313,2041,2354
29/05/2021,187,3,221,1409,1630
29/05/2021,570,3,206,1255,1461
29/05/2021,400,3,80,610,690
29/05/2021,238,3,353,2251,2604
29/05/2021,777,3,198,1037,1235
29/05/2021,374,3,79,340,419
29/05/2021,435,3,104,891,995
29/05/2021,625,3,199,1187,1386
29/05/2021,631,3,99,589,688
29/05/2021,572,3,166,744,910
29/05/2021,91,3,159,733,892
29/05/2021,533,3,350,2286,2636
29/05/2021,87,3,413,3814,4227
29/05/2021,246,3,293,1664,1957
29/05/2021,737,3,256,2789,3045
29/05/2021,205,3,187,1275,1462
29/05/2021,749,3,87,744,831
29/05/2021,811,3,95,577,672
29/05/2021,164,3,166,1370,1536
29/05/2021,713,3,193,2677,2870
29/05/2021,746,3,93,618,711
29/05/2021,673,3,144,929,1073
29/05/2021,567,3,196,925,1121
29/05/2021,547,3,722,4668,5390
29/05/2021,149,3,177,924,1101
29/05/2021,456,3,75,420,495
29/05/2021,159,3,403,4175,4578
29/05/2021,587,3,133,923,1056
29/05/2021,168,3,88,400,488
29/05/2021,90,3,163,1599,1762
29/05/2021,937,3,10,106,116
29/05/2021,27,3,403,2629,3032
29/05/2021,736,3,54,466,520
29/05/2021,524,3,183,1259,1442
29/05/2021,561,3,57,326,383
29/05/2021,229,3,314,1848,2162
29/05/2021,721,3,742,4903,5645
29/05/2021,794,3,470,2540,3010
29/05/2021,770,3,344,2847,3191
29/05/2021,931,3,0,3,3
29/05/2021,922,3,1,15,16
29/05/2021,145,3,240,1378,1618
29/05/2021,904,3,478,2726,3204
29/05/2021,809,3,82,357,439
29/05/2021,245,3,128,527,655
29/05/2021,133,3,110,912,1022
29/05/2021,119,3,271,1457,1728
29/05/2021,25,3,107,408,515
29/05/2021,231,3,226,1418,1644
29/05/2021,652,3,134,918,1052
29/05/2021,792,3,230,1335,1565
29/05/2021,46,3,160,826,986
29/05/2021,687,3,194,1324,1518
29/05/2021,448,3,762,3942,4704
29/05/2021,200,3,101,728,829
29/05/2021,677,3,135,1510,1645
29/05/2021,353,3,124,1199,1323
29/05/2021,507,3,365,2588,2953
29/05/2021,555,3,441,2892,3333
29/05/2021,591,3,189,897,1086
29/05/2021,442,3,117,931,1048
29/05/2021,608,3,565,5224,5789
29/05/2021,444,3,152,1066,1218
29/05/2021,581,3,203,1125,1328
29/05/2021,453,3,191,1241,1432
29/05/2021,140,3,349,2955,3304
29/05/2021,692,3,126,648,774
29/05/2021,655,3,472,2683,3155
29/05/2021,840,3,130,1116,1246
29/05/2021,463,3,467,2543,3010
29/05/2021,457,3,92,391,483
29/05/2021,877,3,5,70,75
29/05/2021,635,3,304,2399,2703
29/05/2021,663,3,522,3249,3771
29/05/2021,543,3,728,4959,5687
29/05/2021,126,3,218,1325,1543
29/05/2021,510,3,357,2562,2919
29/05/2021,412,3,235,2404,2639
29/05/2021,199,3,123,842,965
29/05/2021,134,3,287,1590,1877
29/05/2021,45,3,129,1037,1166
29/05/2021,102,3,265,1327,1592
29/05/2021,582,3,588,3768,4356
29/05/2021,706,3,579,3542,4121
29/05/2021,743,3,81,503,584
29/05/2021,39,3,188,1627,1815
29/05/2021,341,3,581,3895,4476
29/05/2021,930,3,2,59,61
29/05/2021,924,3,0,23,23
29/05/2021,60,3,34,253,287
29/05/2021,235,3,180,1531,1711
29/05/2021,534,3,145,1045,1190
29/05/2021,418,3,232,2087,2319
29/05/2021,681,3,161,704,865
29/05/2021,658,3,38,325,363
29/05/2021,383,3,524,4027,4551
29/05/2021,863,3,144,842,986
29/05/2021,900,3,34,112,146
29/05/2021,752,3,391,2912,3303
29/05/2021,632,3,131,782,913
29/05/2021,194,3,5,27,32
29/05/2021,675,3,131,832,963
29/05/2021,918,3,0,11,11
29/05/2021,100,3,634,4235,4869
29/05/2021,745,3,113,674,787
29/05/2021,171,3,40,407,447
29/05/2021,71,3,380,3757,4137
29/05/2021,615,3,203,1308,1511
29/05/2021,122,3,199,882,1081
29/05/2021,710,3,83,575,658
29/05/2021,700,3,140,1364,1504
29/05/2021,370,3,314,2576,2890
29/05/2021,852,3,323,1982,2305
29/05/2021,89,3,350,3447,3797
29/05/2021,278,3,274,1764,2038
29/05/2021,753,3,252,2248,2500
29/05/2021,819,3,245,1693,1938
29/05/2021,23,3,58,258,316
29/05/2021,50,3,113,927,1040
29/05/2021,553,3,95,605,700
29/05/2021,849,3,165,1875,2040
29/05/2021,379,3,254,1564,1818
29/05/2021,896,3,676,4315,4991
29/05/2021,801,3,245,1846,2091
29/05/2021,470,3,196,1028,1224
29/05/2021,573,3,133,592,725
29/05/2021,847,3,5,94,99
29/05/2021,709,3,501,2857,3358
29/05/2021,837,3,461,2734,3195
29/05/2021,277,3,303,2068,2371
29/05/2021,121,3,649,4312,4961
29/05/2021,32,3,204,1363,1567
29/05/2021,835,3,214,1181,1395
29/05/2021,505,3,213,1428,1641
29/05/2021,855,3,202,1380,1582
29/05/2021,831,3,259,1645,1904
29/05/2021,176,3,280,1637,1917
29/05/2021,257,3,772,5133,5905
29/05/2021,434,3,33,341,374
29/05/2021,103,3,196,519,715
29/05/2021,389,3,406,3270,3676
29/05/2021,314,3,94,569,663
29/05/2021,137,3,333,1795,2128
29/05/2021,563,3,182,935,1117
29/05/2021,538,3,199,1322,1521
29/05/2021,373,3,112,731,843
29/05/2021,569,3,160,752,912
29/05/2021,839,3,161,905,1066
29/05/2021,113,3,140,732,872
29/05/2021,650,3,114,573,687
29/05/2021,758,3,128,677,805
29/05/2021,551,3,348,2292,2640
29/05/2021,430,3,91,511,602
29/05/2021,575,3,68,345,413
29/05/2021,872,3,125,681,806
29/05/2021,519,3,122,712,834
29/05/2021,193,3,263,1546,1809
29/05/2021,865,3,104,825,929
29/05/2021,848,3,314,1695,2009
29/05/2021,106,3,295,2225,2520
29/05/2021,932,3,0,52,52
29/05/2021,755,3,346,2991,3337
29/05/2021,475,3,388,2686,3074
29/05/2021,594,3,426,2585,3011
29/05/2021,917,3,5,75,80
29/05/2021,451,3,467,2654,3121
29/05/2021,228,3,118,727,845
29/05/2021,617,3,134,809,943
29/05/2021,183,3,139,1053,1192
29/05/2021,262,3,168,1362,1530
29/05/2021,887,3,4,68,72
29/05/2021,384,3,168,1036,1204
29/05/2021,323,3,59,518,577
29/05/2021,75,3,328,2944,3272
29/05/2021,544,3,360,2196,2556
29/05/2021,556,3,518,3412,3930
29/05/2021,619,3,211,1382,1593
29/05/2021,77,3,255,2591,2846
29/05/2021,219,3,102,733,835
29/05/2021,349,3,161,874,1035
29/05/2021,215,3,103,769,872
29/05/2021,633,3,135,693,828
29/05/2021,564,3,312,2041,2353
29/05/2021,716,3,124,1266,1390
29/05/2021,911,3,202,1713,1915
29/05/2021,550,3,365,2399,2764
29/05/2021,55,3,65,571,636
29/05/2021,808,3,395,2261,2656
29/05/2021,181,3,189,1139,1328
29/05/2021,337,3,217,2141,2358
29/05/2021,299,3,112,500,612
29/05/2021,301,3,255,2044,2299
29/05/2021,844,3,68,650,718
29/05/2021,313,3,116,636,752
29/05/2021,698,3,159,1436,1595
29/05/2021,329,3,327,2262,2589
29/05/2021,724,3,665,4415,5080
29/05/2021,459,3,181,1264,1445
29/05/2021,98,3,557,3773,4330
29/05/2021,319,3,58,252,310
29/05/2021,814,3,112,533,645
29/05/2021,913,3,390,3217,3607
29/05/2021,508,3,296,1974,2270
29/05/2021,891,3,124,528,652
29/05/2021,856,3,431,2527,2958
29/05/2021,315,3,48,313,361
29/05/2021,747,3,62,365,427
29/05/2021,649,3,116,713,829
29/05/2021,169,3,111,851,962
29/05/2021,297,3,237,2127,2364
29/05/2021,726,3,106,645,751
29/05/2021,548,3,156,665,821
29/05/2021,871,3,304,1759,2063
29/05/2021,720,3,128,1156,1284
29/05/2021,420,3,407,2728,3135
29/05/2021,365,3,159,690,849
29/05/2021,190,3,202,1265,1467
29/05/2021,259,3,444,2820,3264
29/05/2021,255,3,19,84,103
29/05/2021,593,3,598,3936,4534
29/05/2021,184,3,80,371,451
29/05/2021,526,3,63,296,359
29/05/2021,271,3,107,876,983
29/05/2021,689,3,151,934,1085
29/05/2021,778,3,224,920,1144
29/05/2021,131,3,307,1729,2036
29/05/2021,342,3,124,834,958
29/05/2021,243,3,269,1460,1729
29/05/2021,151,3,78,570,648
29/05/2021,620,3,0,3,3
29/05/2021,939,3,0,19,19
29/05/2021,817,3,198,1384,1582
29/05/2021,757,3,337,1941,2278
29/05/2021,830,3,721,4752,5473
29/05/2021,386,3,508,4062,4570
29/05/2021,327,3,369,2567,2936
29/05/2021,921,3,1,21,22
29/05/2021,441,3,461,2441,2902
29/05/2021,818,3,149,754,903
29/05/2021,820,3,101,564,665
29/05/2021,53,3,201,1275,1476
29/05/2021,410,3,219,1814,2033
29/05/2021,158,3,61,369,430
29/05/2021,490,3,269,2066,2335
29/05/2021,486,3,180,980,1160
29/05/2021,732,3,107,1133,1240
29/05/2021,96,3,178,1524,1702
29/05/2021,531,3,258,1636,1894
29/05/2021,643,3,166,917,1083
29/05/2021,791,3,108,802,910
29/05/2021,339,3,242,1523,1765
29/05/2021,203,3,190,1377,1567
29/05/2021,2,3,81,433,514
29/05/2021,256,3,232,1260,1492
29/05/2021,557,3,142,814,956
29/05/2021,48,3,118,930,1048
29/05/2021,397,3,130,734,864
29/05/2021,853,3,141,910,1051
29/05/2021,312,3,225,1173,1398
29/05/2021,300,3,264,2168,2432
29/05/2021,768,3,347,3012,3359
29/05/2021,348,3,93,693,786
29/05/2021,851,3,248,1527,1775
29/05/2021,833,3,125,840,965
29/05/2021,670,3,763,4838,5601
29/05/2021,898,3,178,1094,1272
29/05/2021,540,3,296,1816,2112
29/05/2021,249,3,287,1533,1820
29/05/2021,719,3,114,788,902
29/05/2021,532,3,888,5868,6756
29/05/2021,874,3,115,700,815
29/05/2021,577,3,139,1603,1742
29/05/2021,44,3,272,1183,1455
29/05/2021,876,3,10,33,43
29/05/2021,595,3,204,1324,1528
29/05/2021,741,3,203,2036,2239
29/05/2021,828,3,233,1113,1346
29/05/2021,445,3,254,1995,2249
29/05/2021,641,3,182,1045,1227
29/05/2021,562,3,158,1282,1440
29/05/2021,455,3,201,1521,1722
29/05/2021,179,3,217,1300,1517
29/05/2021,494,3,207,1489,1696
29/05/2021,156,3,456,3001,3457
29/05/2021,414,3,220,1921,2141
29/05/2021,653,3,110,1005,1115
29/05/2021,621,3,188,1229,1417
29/05/2021,201,3,240,2386,2626
29/05/2021,905,3,16,98,114
29/05/2021,343,3,110,727,837
29/05/2021,358,3,574,4480,5054
29/05/2021,935,3,0,2,2
29/05/2021,798,3,382,2162,2544
29/05/2021,196,3,293,1761,2054
29/05/2021,585,3,391,2259,2650
29/05/2021,157,3,180,873,1053
29/05/2021,497,3,251,1704,1955
29/05/2021,298,3,322,2352,2674
29/05/2021,646,3,126,776,902
29/05/2021,774,3,182,1075,1257
29/05/2021,941,3,26,242,268
29/05/2021,7,3,82,423,505
29/05/2021,166,3,70,786,856
29/05/2021,125,3,182,793,975
29/05/2021,105,3,443,2814,3257
29/05/2021,123,3,155,1183,1338
29/05/2021,248,3,250,1753,2003
29/05/2021,899,3,447,3495,3942
29/05/2021,112,3,130,1263,1393
29/05/2021,688,3,124,584,708
29/05/2021,264,3,192,1558,1750
29/05/2021,272,3,258,1828,2086
29/05/2021,104,3,408,2175,2583
29/05/2021,934,3,3,50,53
29/05/2021,804,3,228,1373,1601
29/05/2021,402,3,291,1899,2190
29/05/2021,535,3,230,1221,1451
29/05/2021,479,3,116,591,707
29/05/2021,901,3,46,360,406
29/05/2021,83,3,796,4412,5208
29/05/2021,408,3,370,3620,3990
29/05/2021,198,3,232,1265,1497
29/05/2021,589,3,164,872,1036
29/05/2021,361,3,189,884,1073
29/05/2021,864,3,119,694,813
29/05/2021,888,3,5,79,84
29/05/2021,413,3,295,3008,3303
29/05/2021,571,3,159,716,875
29/05/2021,332,3,124,804,928
29/05/2021,607,3,485,4311,4796
29/05/2021,42,3,144,816,960
29/05/2021,17,3,121,717,838
29/05/2021,287,3,332,2416,2748
29/05/2021,776,3,190,1694,1884
29/05/2021,648,3,262,1763,2025
29/05/2021,153,3,233,1275,1508
29/05/2021,147,3,190,1631,1821
29/05/2021,356,3,490,3752,4242
29/05/2021,114,3,318,1804,2122
29/05/2021,217,3,180,1343,1523
29/05/2021,797,3,275,1654,1929
29/05/2021,846,3,6,113,119
29/05/2021,566,3,138,836,974
29/05/2021,712,3,113,685,798
29/05/2021,824,3,471,2550,3021
29/05/2021,333,3,180,2421,2601
29/05/2021,280,3,46,120,166
29/05/2021,79,3,157,737,894
29/05/2021,311,3,479,3012,3491
29/05/2021,500,3,124,862,986
29/05/2021,907,3,388,2142,2530
29/05/2021,43,3,154,1272,1426
29/05/2021,465,3,116,679,795
29/05/2021,783,3,570,4659,5229
29/05/2021,360,3,154,1197,1351
29/05/2021,293,3,205,1598,1803
29/05/2021,637,3,418,3435,3853
29/05/2021,498,3,200,1449,1649
29/05/2021,525,3,213,1586,1799
29/05/2021,806,3,276,1957,2233
29/05/2021,368,3,336,2654,2990
29/05/2021,67,3,149,1477,1626
29/05/2021,657,3,281,1578,1859
29/05/2021,4,3,209,1500,1709
29/05/2021,915,3,3,50,53
29/05/2021,437,3,211,1564,1775
29/05/2021,211,3,198,1470,1668
29/05/2021,226,3,179,1104,1283
29/05/2021,152,3,214,1957,2171
29/05/2021,560,3,489,3200,3689
29/05/2021,57,3,129,1129,1258
29/05/2021,669,3,201,1141,1342
29/05/2021,95,3,552,4084,4636
29/05/2021,473,3,73,377,450
29/05/2021,37,3,165,1043,1208
29/05/2021,443,3,136,859,995
29/05/2021,59,3,180,1438,1618
29/05/2021,195,3,152,884,1036
29/05/2021,161,3,544,2258,2802
29/05/2021,309,3,24,50,74
29/05/2021,244,3,269,1879,2148
29/05/2021,802,3,344,2757,3101
29/05/2021,381,3,14,161,175
29/05/2021,748,3,104,574,678
29/05/2021,685,3,115,505,620
29/05/2021,703,3,224,1272,1496
29/05/2021,440,3,384,2050,2434
29/05/2021,216,3,141,802,943
29/05/2021,634,3,43,230,273
29/05/2021,583,3,118,702,820
29/05/2021,369,3,439,3197,3636
29/05/2021,511,3,252,1869,2121
29/05/2021,86,3,76,595,671
29/05/2021,263,3,233,1890,2123
29/05/2021,841,3,27,209,236
29/05/2021,487,3,218,1542,1760
29/05/2021,233,3,231,1255,1486
29/05/2021,624,3,64,391,455
29/05/2021,731,3,86,460,546
29/05/2021,178,3,239,1477,1716
29/05/2021,237,3,240,1479,1719
29/05/2021,788,3,420,2950,3370
29/05/2021,279,3,332,2291,2623
29/05/2021,786,3,363,2949,3312
29/05/2021,318,3,370,2531,2901
29/05/2021,54,3,191,1765,1956
29/05/2021,628,3,147,921,1068
29/05/2021,489,3,18,99,117
29/05/2021,458,3,138,811,949
29/05/2021,478,3,156,292,448
29/05/2021,565,3,474,3145,3619
29/05/2021,528,3,104,441,545
29/05/2021,929,3,1,0,1
29/05/2021,735,3,246,2106,2352
29/05/2021,306,3,0,1,1
29/05/2021,155,3,410,3397,3807
29/05/2021,845,3,203,1214,1417
29/05/2021,214,3,196,1519,1715
29/05/2021,827,3,393,2548,2941
29/05/2021,725,3,70,339,409
29/05/2021,363,3,202,934,1136
29/05/2021,346,3,116,809,925
29/05/2021,160,3,15,92,107
29/05/2021,664,3,498,2961,3459
29/05/2021,21,3,311,2395,2706
29/05/2021,94,3,38,291,329
29/05/2021,208,3,95,725,820
29/05/2021,483,3,336,2558,2894
29/05/2021,31,3,186,1640,1826
29/05/2021,880,3,3,49,52
29/05/2021,618,3,249,1626,1875
29/05/2021,225,3,433,2688,3121
29/05/2021,38,3,113,920,1033
29/05/2021,316,3,186,1339,1525
29/05/2021,668,3,84,773,857
29/05/2021,530,3,131,793,924
29/05/2021,107,3,566,3557,4123
29/05/2021,679,3,144,1070,1214
29/05/2021,357,3,558,4014,4572
29/05/2021,290,3,264,2011,2275
29/05/2021,174,3,165,848,1013
29/05/2021,476,3,119,800,919
29/05/2021,5,3,78,419,497
29/05/2021,916,3,4,46,50
29/05/2021,821,3,291,1838,2129
29/05/2021,407,3,247,2384,2631
29/05/2021,559,3,515,3359,3874
29/05/2021,265,3,193,1558,1751
29/05/2021,878,3,10,67,77
29/05/2021,391,3,389,3099,3488
29/05/2021,371,3,237,1794,2031
29/05/2021,514,3,114,782,896
29/05/2021,823,3,89,470,559
29/05/2021,111,3,356,1833,2189
29/05/2021,701,3,200,1381,1581
29/05/2021,660,3,119,657,776
29/05/2021,1,3,78,410,488
29/05/2021,173,3,118,819,937
29/05/2021,394,3,148,867,1015
29/05/2021,12,3,103,770,873
29/05/2021,816,3,419,3412,3831
29/05/2021,167,3,290,2255,2545
29/05/2021,529,3,137,704,841
29/05/2021,390,3,262,1884,2146
29/05/2021,881,3,1,26,27
29/05/2021,496,3,164,1229,1393
29/05/2021,433,3,682,3537,4219
29/05/2021,467,3,132,1104,1236
29/05/2021,862,3,264,1772,2036
29/05/2021,527,3,98,430,528
29/05/2021,739,3,200,1897,2097
29/05/2021,209,3,57,345,402
29/05/2021,142,3,137,930,1067
29/05/2021,694,3,171,1090,1261
29/05/2021,461,3,464,2786,3250
29/05/2021,421,3,392,2439,2831
29/05/2021,651,3,219,1408,1627
29/05/2021,578,3,135,815,950
29/05/2021,661,3,680,4064,4744
29/05/2021,260,3,946,6036,6982
29/05/2021,680,3,188,1437,1625
29/05/2021,517,3,138,849,987
29/05/2021,469,3,220,1728,1948
29/05/2021,24,3,56,246,302
29/05/2021,580,3,161,1154,1315
29/05/2021,425,3,257,2134,2391
30/05/2021,469,3,235,1668,1903
30/05/2021,694,3,148,1139,1287
30/05/2021,580,3,168,872,1040
30/05/2021,260,3,1133,5575,6708
30/05/2021,421,3,399,2684,3083
30/05/2021,661,3,759,4088,4847
30/05/2021,578,3,71,448,519
30/05/2021,651,3,197,1164,1361
30/05/2021,24,3,57,181,238
30/05/2021,517,3,78,438,516
30/05/2021,425,3,244,1918,2162
30/05/2021,680,3,126,785,911
30/05/2021,461,3,478,2499,2977
30/05/2021,86,3,82,718,800
30/05/2021,487,3,170,1272,1442
30/05/2021,511,3,129,985,1114
30/05/2021,583,3,112,504,616
30/05/2021,841,3,15,125,140
30/05/2021,440,3,347,1626,1973
30/05/2021,369,3,448,2892,3340
30/05/2021,381,3,11,114,125
30/05/2021,748,3,87,436,523
30/05/2021,624,3,51,343,394
30/05/2021,233,3,192,980,1172
30/05/2021,634,3,39,163,202
30/05/2021,685,3,120,546,666
30/05/2021,216,3,119,593,712
30/05/2021,731,3,63,343,406
30/05/2021,703,3,254,1430,1684
30/05/2021,263,3,164,1062,1226
30/05/2021,637,3,439,2884,3323
30/05/2021,217,3,164,871,1035
30/05/2021,465,3,88,515,603
30/05/2021,79,3,111,551,662
30/05/2021,783,3,636,4365,5001
30/05/2021,311,3,515,2840,3355
30/05/2021,500,3,83,453,536
30/05/2021,43,3,155,1191,1346
30/05/2021,333,3,197,2048,2245
30/05/2021,293,3,155,917,1072
30/05/2021,280,3,35,106,141
30/05/2021,907,3,407,2010,2417
30/05/2021,712,3,131,704,835
30/05/2021,846,3,6,82,88
30/05/2021,566,3,108,578,686
30/05/2021,356,3,567,3728,4295
30/05/2021,114,3,248,1279,1527
30/05/2021,797,3,285,1510,1795
30/05/2021,360,3,117,913,1030
30/05/2021,824,3,342,1783,2125
30/05/2021,332,3,104,567,671
30/05/2021,153,3,242,1063,1305
30/05/2021,361,3,170,567,737
30/05/2021,864,3,83,425,508
30/05/2021,776,3,150,1382,1532
30/05/2021,42,3,174,953,1127
30/05/2021,571,3,168,833,1001
30/05/2021,413,3,323,2737,3060
30/05/2021,17,3,111,584,695
30/05/2021,888,3,5,46,51
30/05/2021,287,3,278,1531,1809
30/05/2021,147,3,184,1531,1715
30/05/2021,198,3,214,925,1139
30/05/2021,589,3,138,751,889
30/05/2021,648,3,242,1812,2054
30/05/2021,607,3,494,3830,4324
30/05/2021,123,3,126,939,1065
30/05/2021,7,3,63,259,322
30/05/2021,166,3,43,461,504
30/05/2021,941,3,36,296,332
30/05/2021,105,3,341,1570,1911
30/05/2021,646,3,123,568,691
30/05/2021,798,3,370,2032,2402
30/05/2021,774,3,151,848,999
30/05/2021,157,3,168,793,961
30/05/2021,298,3,260,1476,1736
30/05/2021,125,3,142,560,702
30/05/2021,497,3,235,1654,1889
30/05/2021,196,3,271,1415,1686
30/05/2021,585,3,366,2126,2492
30/05/2021,905,3,15,71,86
30/05/2021,562,3,108,598,706
30/05/2021,828,3,192,841,1033
30/05/2021,653,3,88,606,694
30/05/2021,455,3,221,1542,1763
30/05/2021,179,3,225,1209,1434
30/05/2021,741,3,183,1614,1797
30/05/2021,445,3,217,1616,1833
30/05/2021,156,3,398,2183,2581
30/05/2021,641,3,202,1131,1333
30/05/2021,343,3,80,540,620
30/05/2021,414,3,194,1337,1531
30/05/2021,621,3,152,1077,1229
30/05/2021,358,3,654,4334,4988
30/05/2021,494,3,186,1016,1202
30/05/2021,201,3,194,1597,1791
30/05/2021,620,3,0,6,6
30/05/2021,184,3,57,300,357
30/05/2021,259,3,565,2734,3299
30/05/2021,526,3,73,347,420
30/05/2021,420,3,432,2927,3359
30/05/2021,131,3,267,1516,1783
30/05/2021,593,3,633,3597,4230
30/05/2021,255,3,21,56,77
30/05/2021,365,3,199,931,1130
30/05/2021,939,3,0,11,11
30/05/2021,342,3,111,683,794
30/05/2021,817,3,222,1402,1624
30/05/2021,778,3,151,587,738
30/05/2021,689,3,117,489,606
30/05/2021,243,3,254,1446,1700
30/05/2021,151,3,52,386,438
30/05/2021,271,3,99,632,731
30/05/2021,190,3,214,1223,1437
30/05/2021,726,3,86,483,569
30/05/2021,649,3,69,356,425
30/05/2021,720,3,111,774,885
30/05/2021,548,3,166,578,744
30/05/2021,169,3,153,1100,1253
30/05/2021,315,3,60,240,300
30/05/2021,297,3,168,1188,1356
30/05/2021,747,3,69,466,535
30/05/2021,871,3,301,1546,1847
30/05/2021,633,3,114,591,705
30/05/2021,75,3,236,1509,1745
30/05/2021,77,3,186,1315,1501
30/05/2021,215,3,86,565,651
30/05/2021,323,3,35,249,284
30/05/2021,564,3,270,1622,1892
30/05/2021,619,3,207,1242,1449
30/05/2021,219,3,103,592,695
30/05/2021,349,3,140,781,921
30/05/2021,544,3,279,1651,1930
30/05/2021,556,3,520,3271,3791
30/05/2021,384,3,147,785,932
30/05/2021,887,3,1,30,31
30/05/2021,193,3,250,1242,1492
30/05/2021,848,3,288,1491,1779
30/05/2021,617,3,115,694,809
30/05/2021,594,3,450,2485,2935
30/05/2021,865,3,79,487,566
30/05/2021,228,3,97,415,512
30/05/2021,262,3,77,441,518
30/05/2021,475,3,368,2463,2831
30/05/2021,106,3,298,1948,2246
30/05/2021,755,3,340,2641,2981
30/05/2021,519,3,91,411,502
30/05/2021,451,3,357,2054,2411
30/05/2021,932,3,2,20,22
30/05/2021,183,3,102,892,994
30/05/2021,917,3,5,45,50
30/05/2021,896,3,651,4355,5006
30/05/2021,849,3,155,1291,1446
30/05/2021,819,3,256,1571,1827
30/05/2021,50,3,88,587,675
30/05/2021,470,3,150,912,1062
30/05/2021,573,3,162,797,959
30/05/2021,847,3,6,63,69
30/05/2021,553,3,80,487,567
30/05/2021,23,3,59,208,267
30/05/2021,801,3,205,1362,1567
30/05/2021,379,3,260,1472,1732
30/05/2021,700,3,136,1021,1157
30/05/2021,171,3,32,374,406
30/05/2021,370,3,332,2212,2544
30/05/2021,71,3,390,3441,3831
30/05/2021,100,3,746,4382,5128
30/05/2021,122,3,178,748,926
30/05/2021,278,3,278,1823,2101
30/05/2021,852,3,317,1837,2154
30/05/2021,615,3,155,818,973
30/05/2021,753,3,240,1957,2197
30/05/2021,745,3,108,469,577
30/05/2021,89,3,327,2793,3120
30/05/2021,710,3,116,526,642
30/05/2021,706,3,619,3199,3818
30/05/2021,582,3,706,3295,4001
30/05/2021,543,3,665,4493,5158
30/05/2021,930,3,1,25,26
30/05/2021,199,3,100,630,730
30/05/2021,412,3,276,2721,2997
30/05/2021,510,3,282,2033,2315
30/05/2021,126,3,193,1124,1317
30/05/2021,341,3,527,3615,4142
30/05/2021,134,3,262,1443,1705
30/05/2021,45,3,105,827,932
30/05/2021,102,3,267,1391,1658
30/05/2021,39,3,171,1337,1508
30/05/2021,743,3,68,372,440
30/05/2021,635,3,294,1906,2200
30/05/2021,692,3,120,568,688
30/05/2021,457,3,70,307,377
30/05/2021,877,3,3,63,66
30/05/2021,453,3,146,961,1107
30/05/2021,463,3,333,1805,2138
30/05/2021,840,3,133,824,957
30/05/2021,663,3,619,3618,4237
30/05/2021,140,3,295,2226,2521
30/05/2021,655,3,538,2566,3104
30/05/2021,30,3,245,1200,1445
30/05/2021,604,3,489,2581,3070
30/05/2021,61,3,146,1239,1385
30/05/2021,842,3,14,76,90
30/05/2021,850,3,544,2248,2792
30/05/2021,144,3,166,1345,1511
30/05/2021,124,3,100,603,703
30/05/2021,185,3,116,829,945
30/05/2021,289,3,136,806,942
30/05/2021,807,3,129,624,753
30/05/2021,338,3,209,1478,1687
30/05/2021,210,3,116,649,765
30/05/2021,902,3,163,812,975
30/05/2021,493,3,174,871,1045
30/05/2021,212,3,282,1894,2176
30/05/2021,330,3,181,1202,1383
30/05/2021,411,3,254,1930,2184
30/05/2021,304,3,256,1140,1396
30/05/2021,117,3,353,2299,2652
30/05/2021,78,3,689,4614,5303
30/05/2021,602,3,469,2546,3015
30/05/2021,671,3,111,640,751
30/05/2021,775,3,124,1132,1256
30/05/2021,928,3,47,335,382
30/05/2021,722,3,45,347,392
30/05/2021,793,3,164,1012,1176
30/05/2021,41,3,158,1252,1410
30/05/2021,449,3,164,1073,1237
30/05/2021,350,3,94,557,651
30/05/2021,462,3,88,780,868
30/05/2021,162,3,385,1313,1698
30/05/2021,186,3,94,598,692
30/05/2021,399,3,311,1426,1737
30/05/2021,825,3,635,3492,4127
30/05/2021,654,3,155,1025,1180
30/05/2021,512,3,65,419,484
30/05/2021,56,3,143,1011,1154
30/05/2021,253,3,59,440,499
30/05/2021,192,3,189,918,1107
30/05/2021,597,3,406,3261,3667
30/05/2021,15,3,154,631,785
30/05/2021,251,3,97,569,666
30/05/2021,269,3,121,707,828
30/05/2021,393,3,91,497,588
30/05/2021,247,3,307,1859,2166
30/05/2021,436,3,97,865,962
30/05/2021,683,3,170,918,1088
30/05/2021,474,3,107,591,698
30/05/2021,879,3,2,34,36
30/05/2021,18,3,196,1526,1722
30/05/2021,236,3,269,1932,2201
30/05/2021,751,3,8,12,20
30/05/2021,47,3,156,728,884
30/05/2021,826,3,213,1680,1893
30/05/2021,759,3,333,2988,3321
30/05/2021,221,3,116,806,922
30/05/2021,488,3,99,301,400
30/05/2021,765,3,219,1151,1370
30/05/2021,154,3,207,945,1152
30/05/2021,242,3,294,1769,2063
30/05/2021,704,3,58,273,331
30/05/2021,128,3,124,773,897
30/05/2021,417,3,319,2484,2803
30/05/2021,684,3,249,1648,1897
30/05/2021,836,3,199,1257,1456
30/05/2021,321,3,113,666,779
30/05/2021,600,3,666,3452,4118
30/05/2021,909,3,5,4,9
30/05/2021,252,3,70,370,440
30/05/2021,936,3,222,1353,1575
30/05/2021,138,3,250,1295,1545
30/05/2021,163,3,187,972,1159
30/05/2021,266,3,93,496,589
30/05/2021,875,3,82,470,552
30/05/2021,427,3,652,3353,4005
30/05/2021,354,3,2,6,8
30/05/2021,51,3,570,3828,4398
30/05/2021,213,3,164,906,1070
30/05/2021,603,3,455,2472,2927
30/05/2021,438,3,78,446,524
30/05/2021,715,3,356,2009,2365
30/05/2021,579,3,103,1061,1164
30/05/2021,58,3,446,3471,3917
30/05/2021,472,3,535,2490,3025
30/05/2021,403,3,374,2123,2497
30/05/2021,509,3,237,1544,1781
30/05/2021,322,3,167,1246,1413
30/05/2021,218,3,169,940,1109
30/05/2021,308,3,227,1208,1435
30/05/2021,764,3,202,2175,2377
30/05/2021,711,3,129,710,839
30/05/2021,780,3,466,2880,3346
30/05/2021,614,3,101,920,1021
30/05/2021,866,3,601,4148,4749
30/05/2021,70,3,250,2006,2256
30/05/2021,424,3,258,2604,2862
30/05/2021,829,3,218,1341,1559
30/05/2021,11,3,145,855,1000
30/05/2021,409,3,167,1217,1384
30/05/2021,705,3,41,263,304
30/05/2021,717,3,142,1308,1450
30/05/2021,170,3,204,1452,1656
30/05/2021,638,3,256,1482,1738
30/05/2021,616,3,197,1006,1203
30/05/2021,68,3,159,1299,1458
30/05/2021,884,3,6,89,95
30/05/2021,662,3,492,2262,2754
30/05/2021,115,3,101,819,920
30/05/2021,135,3,291,1637,1928
30/05/2021,344,3,122,684,806
30/05/2021,9,3,146,830,976
30/05/2021,129,3,261,1234,1495
30/05/2021,756,3,281,2457,2738
30/05/2021,542,3,227,1070,1297
30/05/2021,933,3,0,5,5
30/05/2021,428,3,84,704,788
30/05/2021,857,3,263,1310,1573
30/05/2021,220,3,93,562,655
30/05/2021,432,3,216,1705,1921
30/05/2021,699,3,78,507,585
30/05/2021,294,3,411,2905,3316
30/05/2021,385,3,86,304,390
30/05/2021,886,3,3,26,29
30/05/2021,143,3,187,1229,1416
30/05/2021,750,3,141,1246,1387
30/05/2021,180,3,308,1975,2283
30/05/2021,285,3,169,1052,1221
30/05/2021,626,3,103,870,973
30/05/2021,76,3,200,1270,1470
30/05/2021,84,3,376,1872,2248
30/05/2021,206,3,2,14,16
30/05/2021,805,3,193,1136,1329
30/05/2021,34,3,93,604,697
30/05/2021,882,3,1,13,14
30/05/2021,401,3,122,905,1027
30/05/2021,296,3,108,827,935
30/05/2021,66,3,154,1238,1392
30/05/2021,182,3,249,1450,1699
30/05/2021,267,3,123,754,877
30/05/2021,450,3,97,720,817
30/05/2021,666,3,214,1353,1567
30/05/2021,446,3,188,1328,1516
30/05/2021,281,3,384,2412,2796
30/05/2021,790,3,280,1844,2124
30/05/2021,416,3,292,3224,3516
30/05/2021,784,3,348,1865,2213
30/05/2021,920,3,2,33,35
30/05/2021,491,3,228,1600,1828
30/05/2021,522,3,174,1141,1315
30/05/2021,707,3,320,1463,1783
30/05/2021,239,3,204,1161,1365
30/05/2021,552,3,243,1527,1770
30/05/2021,331,3,95,575,670
30/05/2021,771,3,231,1842,2073
30/05/2021,81,3,276,2721,2997
30/05/2021,645,3,124,587,711
30/05/2021,116,3,112,398,510
30/05/2021,351,3,902,4373,5275
30/05/2021,291,3,163,910,1073
30/05/2021,606,3,318,1814,2132
30/05/2021,388,3,361,2953,3314
30/05/2021,773,3,95,501,596
30/05/2021,270,3,100,521,621
30/05/2021,674,3,159,876,1035
30/05/2021,665,3,101,610,711
30/05/2021,554,3,64,429,493
30/05/2021,85,3,542,2735,3277
30/05/2021,627,3,83,576,659
30/05/2021,35,3,215,1810,2025
30/05/2021,372,3,425,2544,2969
30/05/2021,919,3,165,892,1057
30/05/2021,295,3,146,745,891
30/05/2021,376,3,61,205,266
30/05/2021,307,3,309,1499,1808
30/05/2021,639,3,151,1027,1178
30/05/2021,197,3,265,1360,1625
30/05/2021,659,3,70,349,419
30/05/2021,495,3,154,905,1059
30/05/2021,82,3,384,1995,2379
30/05/2021,288,3,77,569,646
30/05/2021,910,3,7,92,99
30/05/2021,454,3,413,2534,2947
30/05/2021,359,3,186,826,1012
30/05/2021,892,3,13,28,41
30/05/2021,261,3,1206,6106,7312
30/05/2021,843,3,85,549,634
30/05/2021,328,3,157,1024,1181
30/05/2021,854,3,300,1705,2005
30/05/2021,120,3,195,934,1129
30/05/2021,885,3,6,89,95
30/05/2021,232,3,115,673,788
30/05/2021,108,3,186,1004,1190
30/05/2021,588,3,119,560,679
30/05/2021,366,3,173,866,1039
30/05/2021,33,3,224,1256,1480
30/05/2021,480,3,106,443,549
30/05/2021,767,3,392,2941,3333
30/05/2021,274,3,0,18,18
30/05/2021,429,3,225,1700,1925
30/05/2021,250,3,159,451,610
30/05/2021,623,3,259,1242,1501
30/05/2021,392,3,113,674,787
30/05/2021,177,3,131,637,768
30/05/2021,860,3,288,1526,1814
30/05/2021,832,3,246,1475,1721
30/05/2021,838,3,550,3106,3656
30/05/2021,110,3,167,732,899
30/05/2021,484,3,99,390,489
30/05/2021,728,3,297,2309,2606
30/05/2021,352,3,343,1781,2124
30/05/2021,574,3,198,936,1134
30/05/2021,404,3,557,3059,3616
30/05/2021,362,3,178,579,757
30/05/2021,506,3,298,2011,2309
30/05/2021,647,3,79,374,453
30/05/2021,136,3,261,1446,1707
30/05/2021,431,3,89,449,538
30/05/2021,584,3,540,2730,3270
30/05/2021,598,3,791,4508,5299
30/05/2021,686,3,125,841,966
30/05/2021,382,3,0,9,9
30/05/2021,714,3,288,1358,1646
30/05/2021,439,3,74,403,477
30/05/2021,214,3,168,941,1109
30/05/2021,845,3,168,1033,1201
30/05/2021,725,3,85,411,496
30/05/2021,160,3,24,64,88
30/05/2021,483,3,304,2371,2675
30/05/2021,664,3,504,2570,3074
30/05/2021,346,3,107,732,839
30/05/2021,208,3,87,604,691
30/05/2021,618,3,210,1250,1460
30/05/2021,31,3,157,1268,1425
30/05/2021,21,3,295,2162,2457
30/05/2021,225,3,383,2152,2535
30/05/2021,94,3,60,467,527
30/05/2021,880,3,2,14,16
30/05/2021,827,3,433,2838,3271
30/05/2021,363,3,180,596,776
30/05/2021,279,3,325,1954,2279
30/05/2021,565,3,473,3051,3524
30/05/2021,155,3,294,1877,2171
30/05/2021,237,3,205,1275,1480
30/05/2021,628,3,133,636,769
30/05/2021,178,3,214,1186,1400
30/05/2021,788,3,350,1864,2214
30/05/2021,458,3,141,892,1033
30/05/2021,735,3,231,1811,2042
30/05/2021,318,3,366,2250,2616
30/05/2021,489,3,14,81,95
30/05/2021,478,3,172,523,695
30/05/2021,786,3,401,2345,2746
30/05/2021,54,3,151,1060,1211
30/05/2021,528,3,91,336,427
30/05/2021,306,3,0,2,2
30/05/2021,211,3,169,916,1085
30/05/2021,368,3,346,2302,2648
30/05/2021,437,3,206,1363,1569
30/05/2021,915,3,2,15,17
30/05/2021,525,3,311,2262,2573
30/05/2021,806,3,294,2023,2317
30/05/2021,657,3,248,1346,1594
30/05/2021,4,3,218,1495,1713
30/05/2021,57,3,135,1071,1206
30/05/2021,152,3,184,1550,1734
30/05/2021,669,3,175,976,1151
30/05/2021,560,3,508,3189,3697
30/05/2021,67,3,117,965,1082
30/05/2021,226,3,148,776,924
30/05/2021,498,3,141,933,1074
30/05/2021,112,3,200,1910,2110
30/05/2021,83,3,724,3941,4665
30/05/2021,934,3,2,15,17
30/05/2021,104,3,455,2431,2886
30/05/2021,264,3,130,886,1016
30/05/2021,688,3,116,513,629
30/05/2021,899,3,484,2974,3458
30/05/2021,248,3,223,1203,1426
30/05/2021,408,3,238,1728,1966
30/05/2021,535,3,198,932,1130
30/05/2021,804,3,206,1251,1457
30/05/2021,402,3,331,1899,2230
30/05/2021,479,3,131,592,723
30/05/2021,901,3,51,388,439
30/05/2021,272,3,232,1707,1939
30/05/2021,256,3,282,1390,1672
30/05/2021,441,3,340,1762,2102
30/05/2021,921,3,1,3,4
30/05/2021,757,3,325,1832,2157
30/05/2021,791,3,84,634,718
30/05/2021,410,3,212,1513,1725
30/05/2021,158,3,46,293,339
30/05/2021,818,3,142,509,651
30/05/2021,339,3,183,1196,1379
30/05/2021,486,3,170,1107,1277
30/05/2021,531,3,328,1936,2264
30/05/2021,643,3,189,896,1085
30/05/2021,53,3,198,1113,1311
30/05/2021,203,3,209,1444,1653
30/05/2021,820,3,105,694,799
30/05/2021,2,3,58,266,324
30/05/2021,96,3,197,1541,1738
30/05/2021,490,3,178,1351,1529
30/05/2021,830,3,642,4208,4850
30/05/2021,732,3,86,706,792
30/05/2021,386,3,509,3683,4192
30/05/2021,327,3,384,2298,2682
30/05/2021,698,3,160,1223,1383
30/05/2021,459,3,106,587,693
30/05/2021,891,3,121,462,583
30/05/2021,550,3,299,1759,2058
30/05/2021,856,3,416,2218,2634
30/05/2021,329,3,277,1473,1750
30/05/2021,911,3,203,1644,1847
30/05/2021,724,3,619,4205,4824
30/05/2021,913,3,495,3812,4307
30/05/2021,301,3,197,1218,1415
30/05/2021,313,3,86,549,635
30/05/2021,844,3,53,457,510
30/05/2021,299,3,94,322,416
30/05/2021,319,3,54,252,306
30/05/2021,508,3,219,1291,1510
30/05/2021,808,3,522,2870,3392
30/05/2021,98,3,592,3390,3982
30/05/2021,814,3,87,356,443
30/05/2021,181,3,206,1170,1376
30/05/2021,337,3,203,1915,2118
30/05/2021,55,3,57,384,441
30/05/2021,716,3,114,1149,1263
30/05/2021,505,3,119,877,996
30/05/2021,103,3,124,342,466
30/05/2021,257,3,969,4972,5941
30/05/2021,176,3,267,1435,1702
30/05/2021,314,3,63,442,505
30/05/2021,837,3,485,2566,3051
30/05/2021,434,3,28,307,335
30/05/2021,121,3,602,4070,4672
30/05/2021,835,3,203,897,1100
30/05/2021,831,3,191,1308,1499
30/05/2021,855,3,168,1085,1253
30/05/2021,277,3,226,1511,1737
30/05/2021,389,3,426,3362,3788
30/05/2021,709,3,549,2840,3389
30/05/2021,32,3,198,1332,1530
30/05/2021,418,3,162,1233,1395
30/05/2021,383,3,495,3573,4068
30/05/2021,863,3,118,738,856
30/05/2021,681,3,162,800,962
30/05/2021,675,3,107,567,674
30/05/2021,235,3,185,1337,1522
30/05/2021,752,3,362,2243,2605
30/05/2021,918,3,0,4,4
30/05/2021,60,3,31,249,280
30/05/2021,194,3,5,33,38
30/05/2021,632,3,118,634,752
30/05/2021,658,3,49,272,321
30/05/2021,900,3,21,86,107
30/05/2021,534,3,155,1066,1221
30/05/2021,924,3,0,15,15
30/05/2021,187,3,230,1475,1705
30/05/2021,28,3,142,845,987
30/05/2021,785,3,505,2851,3356
30/05/2021,696,3,233,1560,1793
30/05/2021,286,3,52,205,257
30/05/2021,276,3,326,2145,2471
30/05/2021,189,3,81,654,735
30/05/2021,423,3,255,2720,2975
30/05/2021,380,3,147,934,1081
30/05/2021,570,3,194,1022,1216
30/05/2021,400,3,63,340,403
30/05/2021,777,3,237,1105,1342
30/05/2021,238,3,291,1654,1945
30/05/2021,895,3,76,368,444
30/05/2021,897,3,373,2416,2789
30/05/2021,305,3,201,1071,1272
30/05/2021,586,3,206,1171,1377
30/05/2021,903,3,10,69,79
30/05/2021,175,3,238,1219,1457
30/05/2021,795,3,144,774,918
30/05/2021,406,3,204,839,1043
30/05/2021,69,3,144,989,1133
30/05/2021,93,3,241,1775,2016
30/05/2021,613,3,57,357,414
30/05/2021,477,3,71,434,505
30/05/2021,858,3,347,2341,2688
30/05/2021,558,3,81,488,569
30/05/2021,537,3,274,1316,1590
30/05/2021,702,3,225,1247,1472
30/05/2021,889,3,0,5,5
30/05/2021,378,3,93,496,589
30/05/2021,398,3,78,297,375
30/05/2021,504,3,161,796,957
30/05/2021,883,3,8,90,98
30/05/2021,492,3,104,577,681
30/05/2021,101,3,256,1717,1973
30/05/2021,334,3,526,2774,3300
30/05/2021,99,3,622,3690,4312
30/05/2021,466,3,148,973,1121
30/05/2021,88,3,86,343,429
30/05/2021,723,3,255,1363,1618
30/05/2021,738,3,203,1123,1326
30/05/2021,64,3,125,759,884
30/05/2021,520,3,71,279,350
30/05/2021,460,3,75,522,597
30/05/2021,19,3,316,2262,2578
30/05/2021,172,3,159,1206,1365
30/05/2021,815,3,578,2711,3289
30/05/2021,485,3,202,1335,1537
30/05/2021,803,3,267,1469,1736
30/05/2021,890,3,143,1397,1540
30/05/2021,868,3,968,4871,5839
30/05/2021,80,3,292,2685,2977
30/05/2021,697,3,174,1293,1467
30/05/2021,656,3,64,573,637
30/05/2021,355,3,174,1419,1593
30/05/2021,894,3,362,2682,3044
30/05/2021,340,3,199,1384,1583
30/05/2021,636,3,620,3714,4334
30/05/2021,733,3,118,908,1026
30/05/2021,859,3,25,130,155
30/05/2021,501,3,299,2075,2374
30/05/2021,499,3,219,1554,1773
30/05/2021,610,3,544,4505,5049
30/05/2021,870,3,40,204,244
30/05/2021,97,3,465,2157,2622
30/05/2021,188,3,216,1327,1543
30/05/2021,601,3,188,1328,1516
30/05/2021,789,3,173,646,819
30/05/2021,396,3,65,299,364
30/05/2021,130,3,316,1730,2046
30/05/2021,335,3,161,1061,1222
30/05/2021,207,3,103,773,876
30/05/2021,282,3,229,1534,1763
30/05/2021,515,3,112,772,884
30/05/2021,254,3,85,533,618
30/05/2021,65,3,134,1104,1238
30/05/2021,869,3,173,558,731
30/05/2021,419,3,375,1605,1980
30/05/2021,20,3,91,434,525
30/05/2021,347,3,240,685,925
30/05/2021,779,3,240,1221,1461
30/05/2021,676,3,76,369,445
30/05/2021,592,3,355,1942,2297
30/05/2021,629,3,180,1166,1346
30/05/2021,224,3,105,548,653
30/05/2021,781,3,457,3035,3492
30/05/2021,867,3,84,450,534
30/05/2021,148,3,63,322,385
30/05/2021,240,3,281,1590,1871
30/05/2021,513,3,141,1227,1368
30/05/2021,63,3,94,505,599
30/05/2021,812,3,116,797,913
30/05/2021,942,3,6,40,46
30/05/2021,345,3,139,621,760
30/05/2021,317,3,364,2404,2768
30/05/2021,576,3,59,442,501
30/05/2021,26,3,239,1248,1487
30/05/2021,810,3,93,599,692
30/05/2021,146,3,199,1083,1282
30/05/2021,640,3,188,971,1159
30/05/2021,605,3,561,3044,3605
30/05/2021,503,3,277,1887,2164
30/05/2021,377,3,310,1641,1951
30/05/2021,395,3,100,548,648
30/05/2021,273,3,113,498,611
30/05/2021,405,3,85,571,656
30/05/2021,468,3,94,563,657
30/05/2021,336,3,497,3476,3973
30/05/2021,13,3,433,2446,2879
30/05/2021,283,3,224,1523,1747
30/05/2021,36,3,146,1009,1155
30/05/2021,599,3,725,4239,4964
30/05/2021,227,3,115,594,709
30/05/2021,310,3,733,4483,5216
30/05/2021,742,3,195,1326,1521
30/05/2021,326,3,61,330,391
30/05/2021,861,3,199,1067,1266
30/05/2021,452,3,84,564,648
30/05/2021,691,3,152,672,824
30/05/2021,275,3,234,1418,1652
30/05/2021,612,3,410,2732,3142
30/05/2021,481,3,226,1400,1626
30/05/2021,426,3,94,451,545
30/05/2021,222,3,112,763,875
30/05/2021,127,3,117,864,981
30/05/2021,772,3,211,1010,1221
30/05/2021,906,3,7,33,40
30/05/2021,52,3,212,941,1153
30/05/2021,290,3,214,1228,1442
30/05/2021,821,3,284,1845,2129
30/05/2021,5,3,57,255,312
30/05/2021,476,3,97,631,728
30/05/2021,668,3,93,647,740
30/05/2021,916,3,2,41,43
30/05/2021,407,3,347,3159,3506
30/05/2021,559,3,520,3222,3742
30/05/2021,174,3,159,726,885
30/05/2021,107,3,610,3426,4036
30/05/2021,530,3,130,710,840
30/05/2021,357,3,680,4444,5124
30/05/2021,38,3,132,1050,1182
30/05/2021,316,3,148,1028,1176
30/05/2021,679,3,123,639,762
30/05/2021,195,3,152,686,838
30/05/2021,309,3,43,228,271
30/05/2021,443,3,122,839,961
30/05/2021,244,3,221,1313,1534
30/05/2021,95,3,579,3780,4359
30/05/2021,161,3,484,1952,2436
30/05/2021,802,3,213,1178,1391
30/05/2021,473,3,55,311,366
30/05/2021,59,3,170,1084,1254
30/05/2021,37,3,209,1358,1567
30/05/2021,898,3,129,667,796
30/05/2021,557,3,138,747,885
30/05/2021,348,3,68,523,591
30/05/2021,670,3,708,4622,5330
30/05/2021,851,3,204,1048,1252
30/05/2021,540,3,259,1471,1730
30/05/2021,249,3,261,1485,1746
30/05/2021,768,3,286,2099,2385
30/05/2021,312,3,209,879,1088
30/05/2021,397,3,108,550,658
30/05/2021,853,3,112,666,778
30/05/2021,48,3,91,594,685
30/05/2021,833,3,109,701,810
30/05/2021,300,3,194,1365,1559
30/05/2021,575,3,53,205,258
30/05/2021,650,3,120,706,826
30/05/2021,137,3,331,1936,2267
30/05/2021,563,3,164,793,957
30/05/2021,113,3,136,577,713
30/05/2021,538,3,171,1158,1329
30/05/2021,758,3,91,407,498
30/05/2021,551,3,294,1974,2268
30/05/2021,373,3,86,516,602
30/05/2021,569,3,172,814,986
30/05/2021,839,3,138,814,952
30/05/2021,430,3,103,567,670
30/05/2021,872,3,108,401,509
30/05/2021,737,3,206,1970,2176
30/05/2021,87,3,358,2877,3235
30/05/2021,374,3,93,480,573
30/05/2021,533,3,260,1665,1925
30/05/2021,435,3,86,683,769
30/05/2021,246,3,273,1546,1819
30/05/2021,572,3,196,810,1006
30/05/2021,749,3,103,615,718
30/05/2021,625,3,167,1058,1225
30/05/2021,631,3,89,485,574
30/05/2021,205,3,208,1428,1636
30/05/2021,91,3,135,688,823
30/05/2021,422,3,293,1678,1971
30/05/2021,782,3,551,3799,4350
30/05/2021,464,3,448,2286,2734
30/05/2021,642,3,180,918,1098
30/05/2021,72,3,518,4377,4895
30/05/2021,292,3,209,1376,1585
30/05/2021,3,3,59,265,324
30/05/2021,202,3,488,3330,3818
30/05/2021,204,3,224,1594,1818
30/05/2021,622,3,427,2834,3261
30/05/2021,813,3,124,548,672
30/05/2021,139,3,288,1546,1834
30/05/2021,760,3,314,2871,3185
30/05/2021,518,3,22,94,116
30/05/2021,754,3,166,1412,1578
30/05/2021,92,3,203,1693,1896
30/05/2021,873,3,246,1118,1364
30/05/2021,539,3,294,1595,1889
30/05/2021,734,3,64,316,380
30/05/2021,6,3,57,272,329
30/05/2021,49,3,86,572,658
30/05/2021,234,3,222,1505,1727
30/05/2021,118,3,260,1509,1769
30/05/2021,284,3,156,1124,1280
30/05/2021,230,3,186,901,1087
30/05/2021,521,3,77,561,638
30/05/2021,364,3,179,584,763
30/05/2021,799,3,51,169,220
30/05/2021,787,3,445,2509,2954
30/05/2021,938,3,1,2,3
30/05/2021,325,3,171,1457,1628
30/05/2021,925,3,1,7,8
30/05/2021,923,3,7,35,42
30/05/2021,258,3,1096,5449,6545
30/05/2021,926,3,429,3175,3604
30/05/2021,302,3,145,810,955
30/05/2021,367,3,338,2217,2555
30/05/2021,536,3,362,1906,2268
30/05/2021,693,3,174,1286,1460
30/05/2021,727,3,81,414,495
30/05/2021,914,3,2,10,12
30/05/2021,387,3,172,766,938
30/05/2021,908,3,105,872,977
30/05/2021,701,3,211,1327,1538
30/05/2021,111,3,337,1370,1707
30/05/2021,391,3,329,2160,2489
30/05/2021,265,3,118,821,939
30/05/2021,878,3,5,13,18
30/05/2021,371,3,256,1683,1939
30/05/2021,823,3,108,551,659
30/05/2021,1,3,60,255,315
30/05/2021,660,3,99,518,617
30/05/2021,514,3,59,346,405
30/05/2021,577,3,126,1107,1233
30/05/2021,876,3,14,15,29
30/05/2021,44,3,251,1228,1479
30/05/2021,595,3,154,857,1011
30/05/2021,719,3,92,543,635
30/05/2021,532,3,1030,5428,6458
30/05/2021,874,3,90,532,622
30/05/2021,547,3,673,4504,5177
30/05/2021,567,3,217,1065,1282
30/05/2021,770,3,365,2945,3310
30/05/2021,931,3,0,1,1
30/05/2021,587,3,241,1604,1845
30/05/2021,149,3,198,924,1122
30/05/2021,794,3,348,1780,2128
30/05/2021,746,3,78,320,398
30/05/2021,27,3,424,2720,3144
30/05/2021,168,3,80,356,436
30/05/2021,229,3,247,1197,1444
30/05/2021,713,3,209,2228,2437
30/05/2021,721,3,890,4420,5310
30/05/2021,561,3,44,278,322
30/05/2021,673,3,131,718,849
30/05/2021,456,3,87,446,533
30/05/2021,736,3,79,710,789
30/05/2021,811,3,57,367,424
30/05/2021,90,3,159,1444,1603
30/05/2021,159,3,428,3842,4270
30/05/2021,164,3,144,998,1142
30/05/2021,524,3,217,1324,1541
30/05/2021,937,3,8,123,131
30/05/2021,730,3,211,1957,2168
30/05/2021,682,3,114,665,779
30/05/2021,761,3,292,3217,3509
30/05/2021,22,3,208,1205,1413
30/05/2021,471,3,94,606,700
30/05/2021,8,3,176,1126,1302
30/05/2021,546,3,257,1405,1662
30/05/2021,268,3,653,3722,4375
30/05/2021,303,3,209,1398,1607
30/05/2021,800,3,164,792,956
30/05/2021,447,3,78,409,487
30/05/2021,739,3,181,1633,1814
30/05/2021,209,3,59,280,339
30/05/2021,467,3,91,760,851
30/05/2021,142,3,119,657,776
30/05/2021,173,3,79,514,593
30/05/2021,390,3,344,2506,2850
30/05/2021,496,3,87,556,643
30/05/2021,12,3,52,367,419
30/05/2021,394,3,110,650,760
30/05/2021,862,3,246,1649,1895
30/05/2021,433,3,509,2320,2829
30/05/2021,167,3,265,1942,2207
30/05/2021,881,3,1,18,19
30/05/2021,527,3,79,210,289
30/05/2021,816,3,433,2919,3352
30/05/2021,529,3,102,463,565
30/05/2021,581,3,213,1044,1257
30/05/2021,677,3,209,2300,2509
30/05/2021,46,3,127,654,781
30/05/2021,231,3,250,1718,1968
30/05/2021,809,3,86,413,499
30/05/2021,25,3,91,407,498
30/05/2021,904,3,489,2470,2959
30/05/2021,608,3,626,5266,5892
30/05/2021,200,3,91,600,691
30/05/2021,442,3,90,633,723
30/05/2021,448,3,592,2762,3354
30/05/2021,687,3,220,1361,1581
30/05/2021,245,3,97,432,529
30/05/2021,507,3,301,2065,2366
30/05/2021,133,3,88,568,656
30/05/2021,145,3,242,1177,1419
30/05/2021,353,3,101,819,920
30/05/2021,444,3,158,1035,1193
30/05/2021,555,3,464,2943,3407
30/05/2021,591,3,163,805,968
30/05/2021,119,3,290,1508,1798
30/05/2021,792,3,242,1389,1631
30/05/2021,922,3,1,3,4
30/05/2021,652,3,122,803,925
