hotel_key,stay_date,lead_time,off_rooms,sellable_capacity,total_rooms_sold,rooms_remaining,flex_rate,saver_rate,semi_flex_rate
488,30/05/2021,3,4,62,64,-2,NA,NA,NA
111,29/05/2021,3,0,60,60,0,NA,NA,NA
634,29/05/2021,3,0,20,20,0,NA,NA,NA
917,27/05/2021,3,1,105,17,88,35,0,0
554,25/05/2021,3,0,42,20,22,57,0,0
46,29/05/2021,3,1,59,53,6,104,0,0
462,29/05/2021,3,10,179,48,131,90,0,0
79,28/05/2021,3,1,45,29,16,100,0,0
584,28/05/2021,3,0,97,97,0,NA,NA,NA
817,30/05/2021,3,0,83,59,24,57,0,0
361,30/05/2021,3,52,13,11,2,89,0,0
102,28/05/2021,3,0,60,60,0,NA,NA,NA
633,30/05/2021,3,1,49,43,6,103,0,0
220,29/05/2021,3,5,98,94,4,159,0,0
290,29/05/2021,3,2,105,102,3,77,0,0
158,29/05/2021,3,0,24,20,4,130,0,0
289,25/05/2021,3,2,66,45,21,74,0,0
383,28/05/2021,3,3,82,82,0,NA,NA,NA
257,28/05/2021,3,1,43,44,-1,NA,NA,NA
678,29/05/2021,3,0,44,0,44,NA,NA,NA
867,28/05/2021,3,1,59,59,0,NA,NA,NA
58,25/05/2021,3,0,67,41,26,55,0,0
326,30/05/2021,3,3,78,51,27,52,0,0
33,28/05/2021,3,4,76,58,18,71,0,0
449,22/05/2021,3,7,88,40,48,100,0,0
82,25/05/2021,3,0,96,93,3,168,0,0
117,30/05/2021,3,1,93,94,-1,NA,NA,NA
423,29/05/2021,3,1,49,49,0,NA,NA,NA
562,30/05/2021,3,1,67,68,-1,NA,NA,NA
520,28/05/2021,3,0,58,57,1,92,0,0
29,30/05/2021,3,0,54,0,54,NA,NA,NA
858,28/05/2021,3,0,81,81,0,NA,NA,NA
104,28/05/2021,3,2,60,60,0,NA,NA,NA
827,29/05/2021,3,1,69,69,0,NA,NA,NA
44,23/05/2021,3,4,104,72,32,90,0,0
635,29/05/2021,3,0,88,88,0,NA,NA,NA
461,27/05/2021,3,2,120,18,102,90,0,0
605,29/05/2021,3,3,157,159,-2,NA,NA,NA
819,30/05/2021,3,1,79,79,0,NA,NA,NA
388,27/05/2021,3,1,59,38,21,52,0,0
329,28/05/2021,3,9,98,94,4,97,0,0
125,28/05/2021,3,2,34,33,1,100,0,0
933,27/05/2021,3,86,61,1,60,35,0,0
761,26/05/2021,3,2,81,37,44,49,0,0
309,29/05/2021,3,0,16,17,-1,NA,NA,NA
788,29/05/2021,3,2,89,89,0,NA,NA,NA
754,29/05/2021,3,0,62,56,6,83,0,0
163,28/05/2021,3,1,61,61,0,NA,NA,NA
527,29/05/2021,3,4,57,56,1,142,0,0
758,29/05/2021,3,0,73,73,0,NA,NA,NA
536,21/05/2021,3,2,79,47,32,58,0,0
572,29/05/2021,3,0,61,61,0,NA,NA,NA
615,30/05/2021,3,0,71,71,0,NA,NA,NA
397,26/05/2021,3,0,75,50,25,60,0,0
450,28/05/2021,3,3,181,149,32,60,0,0
548,26/05/2021,3,1,90,68,22,60,0,0
734,29/05/2021,3,1,60,60,0,NA,NA,NA
70,28/05/2021,3,1,38,28,10,97,0,0
547,30/05/2021,3,0,74,74,0,130,0,0
57,30/05/2021,3,2,138,107,31,62,0,0
826,29/05/2021,3,2,96,96,0,NA,NA,NA
111,30/05/2021,3,0,60,60,0,NA,NA,NA
233,29/05/2021,3,3,64,63,1,167,0,0
262,27/05/2021,3,1,50,44,6,79,0,0
270,25/05/2021,3,1,59,42,17,116,0,0
444,30/05/2021,3,4,115,95,20,57,0,0
654,29/05/2021,3,5,54,53,1,146,0,0
114,28/05/2021,3,0,75,52,23,110,0,0
404,29/05/2021,3,0,67,67,0,NA,NA,NA
190,30/05/2021,3,5,75,74,1,70,0,0
153,29/05/2021,3,2,62,63,-1,NA,NA,NA
102,29/05/2021,3,0,60,60,0,NA,NA,NA
887,29/05/2021,3,24,299,33,266,39,0,0
385,30/05/2021,3,3,60,60,0,NA,NA,NA
357,30/05/2021,3,1,82,78,4,75,0,0
441,29/05/2021,3,0,168,103,65,90,0,0
842,26/05/2021,3,2,89,36,53,99,0,0
658,26/05/2021,3,1,80,54,26,55,0,0
835,28/05/2021,3,5,99,99,0,NA,NA,NA
678,28/05/2021,3,0,44,0,44,NA,NA,NA
130,28/05/2021,3,1,80,80,0,NA,NA,NA
579,25/05/2021,3,0,44,22,22,80,0,0
127,30/05/2021,3,1,59,49,10,62,0,0
120,28/05/2021,3,2,152,134,18,67,0,0
671,22/05/2021,3,1,64,64,0,NA,NA,NA
454,23/05/2021,3,0,184,21,163,70,0,0
210,28/05/2021,3,2,100,100,0,NA,NA,NA
785,30/05/2021,3,1,109,109,0,NA,NA,NA
828,29/05/2021,3,0,75,75,0,NA,NA,NA
64,28/05/2021,3,3,244,31,213,55,0,0
549,30/05/2021,3,0,61,0,61,NA,NA,NA
69,28/05/2021,3,2,58,58,0,NA,NA,NA
83,28/05/2021,3,10,158,151,7,105,0,0
725,29/05/2021,3,0,17,17,0,NA,NA,NA
595,24/05/2021,3,2,48,24,24,57,0,0
655,30/05/2021,3,0,72,72,0,NA,NA,NA
461,26/05/2021,3,2,120,13,107,95,0,0
640,29/05/2021,3,6,120,121,-1,NA,NA,NA
573,29/05/2021,3,0,57,57,0,NA,NA,NA
552,27/05/2021,3,15,169,96,73,49,0,0
459,29/05/2021,3,3,89,87,2,80,0,0
157,29/05/2021,3,1,82,82,0,NA,NA,NA
9,28/05/2021,3,0,27,20,7,75,0,0
546,24/05/2021,3,11,141,46,95,49,0,0
161,29/05/2021,3,1,60,60,0,NA,NA,NA
788,30/05/2021,3,2,89,89,0,NA,NA,NA
754,28/05/2021,3,0,62,36,26,55,0,0
213,29/05/2021,3,3,145,145,0,NA,NA,NA
142,29/05/2021,3,1,61,55,6,140,0,0
137,29/05/2021,3,24,122,123,-1,NA,NA,NA
908,25/05/2021,3,1,135,42,93,49,0,0
246,29/05/2021,3,1,111,111,0,NA,NA,NA
710,29/05/2021,3,0,20,20,0,NA,NA,NA
851,29/05/2021,3,0,92,91,1,119,0,0
182,28/05/2021,3,2,78,59,19,67,0,0
747,26/05/2021,3,1,63,49,14,59,0,0
787,29/05/2021,3,3,105,105,0,NA,NA,NA
170,26/05/2021,3,0,105,84,21,74,0,0
561,30/05/2021,3,2,58,53,5,70,0,0
67,29/05/2021,3,1,51,48,3,74,0,0
765,29/05/2021,3,0,101,101,0,NA,NA,NA
391,30/05/2021,3,1,75,75,0,NA,NA,NA
685,28/05/2021,3,2,138,138,0,NA,NA,NA
262,28/05/2021,3,1,50,41,9,77,0,0
659,26/05/2021,3,4,39,18,21,74,0,0
591,30/05/2021,3,0,68,59,9,57,0,0
436,30/05/2021,3,10,196,104,92,57,0,0
637,28/05/2021,3,0,74,74,0,NA,NA,NA
484,29/05/2021,3,0,40,40,0,NA,NA,NA
593,30/05/2021,3,18,63,65,-2,NA,NA,NA
198,29/05/2021,3,22,113,115,-2,NA,NA,NA
582,29/05/2021,3,0,53,53,0,NA,NA,NA
77,27/05/2021,3,0,103,73,30,95,0,0
750,30/05/2021,3,3,109,109,0,NA,NA,NA
530,30/05/2021,3,1,59,58,1,115,0,0
732,30/05/2021,3,0,60,42,18,57,0,0
850,26/05/2021,3,4,79,68,11,82,0,0
534,28/05/2021,3,1,84,59,25,60,0,0
389,29/05/2021,3,2,124,124,0,NA,NA,NA
678,30/05/2021,3,0,44,0,44,NA,NA,NA
347,29/05/2021,3,2,60,60,0,NA,NA,NA
58,26/05/2021,3,0,67,54,13,67,0,0
612,29/05/2021,3,1,41,39,2,145,0,0
33,27/05/2021,3,3,77,41,36,57,0,0
671,23/05/2021,3,1,64,64,0,NA,NA,NA
454,25/05/2021,3,0,184,32,152,90,0,0
117,29/05/2021,3,1,93,93,0,NA,NA,NA
238,29/05/2021,3,0,66,66,0,NA,NA,NA
828,30/05/2021,3,0,75,75,0,NA,NA,NA
172,28/05/2021,3,2,83,66,17,74,0,0
656,30/05/2021,3,0,115,116,-1,NA,NA,NA
586,28/05/2021,3,4,79,79,0,NA,NA,NA
899,26/05/2021,3,2,103,45,58,143,0,0
225,29/05/2021,3,13,67,67,0,NA,NA,NA
595,27/05/2021,3,4,46,23,23,52,0,0
655,26/05/2021,3,0,72,38,34,80,0,0
469,26/05/2021,3,4,192,34,158,95,0,0
605,30/05/2021,3,9,151,153,-2,NA,NA,NA
896,30/05/2021,3,0,82,82,0,NA,NA,NA
81,26/05/2021,3,1,59,12,47,49,0,0
55,28/05/2021,3,1,32,24,8,60,0,0
798,29/05/2021,3,1,80,80,0,NA,NA,NA
9,26/05/2021,3,0,27,21,6,80,0,0
8,25/05/2021,3,1,39,28,11,63,0,0
802,29/05/2021,3,1,64,64,0,NA,NA,NA
628,30/05/2021,3,1,58,58,0,NA,NA,NA
518,27/05/2021,3,1,16,15,1,79,0,0
138,29/05/2021,3,0,98,98,0,NA,NA,NA
862,29/05/2021,3,1,109,108,1,137,0,0
430,29/05/2021,3,4,85,88,-3,NA,NA,NA
536,25/05/2021,3,1,80,31,49,89,0,0
87,28/05/2021,3,44,74,25,49,55,0,0
710,30/05/2021,3,0,20,20,0,NA,NA,NA
249,27/05/2021,3,2,125,93,32,74,0,0
296,28/05/2021,3,3,57,28,29,55,0,0
297,27/05/2021,3,1,75,42,33,55,0,0
284,29/05/2021,3,0,26,24,2,79,0,0
780,26/05/2021,3,0,60,40,20,77,0,0
159,30/05/2021,3,0,77,75,2,70,0,0
525,30/05/2021,3,1,74,59,15,62,0,0
236,26/05/2021,3,2,117,12,105,49,0,0
823,28/05/2021,3,1,60,60,0,NA,NA,NA
731,29/05/2021,3,5,94,94,0,NA,NA,NA
917,28/05/2021,3,1,105,14,91,35,0,0
665,26/05/2021,3,1,105,44,61,67,0,0
792,30/05/2021,3,0,102,101,1,118,0,0
186,29/05/2021,3,1,57,54,3,74,0,0
637,29/05/2021,3,0,74,74,0,NA,NA,NA
584,29/05/2021,3,0,97,97,0,NA,NA,NA
131,29/05/2021,3,4,45,46,-1,NA,NA,NA
413,29/05/2021,3,2,114,115,-1,NA,NA,NA
134,29/05/2021,3,1,47,47,0,NA,NA,NA
544,27/05/2021,3,0,53,23,30,49,0,0
76,30/05/2021,3,0,93,93,0,NA,NA,NA
476,30/05/2021,3,1,172,36,136,49,0,0
441,30/05/2021,3,0,168,81,87,60,0,0
61,25/05/2021,3,1,99,43,56,59,0,0
658,28/05/2021,3,1,80,80,0,NA,NA,NA
434,29/05/2021,3,2,58,58,0,NA,NA,NA
345,29/05/2021,3,0,101,101,0,NA,NA,NA
20,29/05/2021,3,1,81,81,0,NA,NA,NA
579,26/05/2021,3,0,44,22,22,79,0,0
772,29/05/2021,3,0,57,55,2,151,0,0
120,27/05/2021,3,2,152,140,12,62,0,0
722,22/05/2021,3,0,42,42,0,NA,NA,NA
454,26/05/2021,3,0,184,19,165,90,0,0
78,29/05/2021,3,0,44,44,0,NA,NA,NA
895,30/05/2021,3,0,69,69,0,NA,NA,NA
621,29/05/2021,3,0,60,48,12,87,0,0
460,28/05/2021,3,10,99,69,30,57,0,0
97,30/05/2021,3,5,102,102,0,NA,NA,NA
492,28/05/2021,3,4,33,22,11,67,0,0
408,28/05/2021,3,7,158,157,1,96,0,0
483,29/05/2021,3,5,94,90,4,115,0,0
577,28/05/2021,3,12,66,31,35,60,0,0
457,25/05/2021,3,1,62,32,30,55,0,0
661,28/05/2021,3,29,143,132,11,79,0,0
336,30/05/2021,3,0,74,74,0,NA,NA,NA
896,29/05/2021,3,0,82,83,-1,NA,NA,NA
552,26/05/2021,3,15,169,82,87,49,0,0
313,28/05/2021,3,1,30,16,14,55,0,0
646,29/05/2021,3,16,120,128,-8,NA,NA,NA
662,25/05/2021,3,1,106,72,34,79,0,0
471,25/05/2021,3,6,114,85,29,64,0,0
309,28/05/2021,3,0,16,16,0,NA,NA,NA
786,30/05/2021,3,1,61,61,0,NA,NA,NA
760,28/05/2021,3,1,35,34,1,84,0,0
417,29/05/2021,3,0,103,103,0,NA,NA,NA
467,30/05/2021,3,2,110,30,80,60,0,0
551,29/05/2021,3,0,115,115,0,NA,NA,NA
367,25/05/2021,3,0,74,24,50,107,0,0
533,28/05/2021,3,1,90,29,61,55,0,0
171,29/05/2021,3,2,47,47,0,NA,NA,NA
249,28/05/2021,3,2,125,104,21,82,0,0
522,28/05/2021,3,3,59,56,3,74,0,0
747,27/05/2021,3,1,63,35,28,64,0,0
284,30/05/2021,3,0,26,20,6,57,0,0
711,28/05/2021,3,0,89,76,13,74,0,0
567,30/05/2021,3,0,61,58,3,65,0,0
152,30/05/2021,3,1,90,78,12,57,0,0
154,28/05/2021,3,7,97,97,0,NA,NA,NA
823,29/05/2021,3,1,60,60,0,NA,NA,NA
634,27/05/2021,3,0,20,20,0,NA,NA,NA
451,29/05/2021,3,2,81,80,1,203,0,0
270,27/05/2021,3,1,59,54,5,96,0,0
231,30/05/2021,3,0,41,31,10,53,0,0
393,29/05/2021,3,1,59,58,1,79,0,0
114,30/05/2021,3,0,75,75,0,NA,NA,NA
686,29/05/2021,3,0,46,46,0,NA,NA,NA
365,30/05/2021,3,1,67,68,-1,NA,NA,NA
153,30/05/2021,3,2,62,63,-1,NA,NA,NA
706,28/05/2021,3,1,73,73,0,NA,NA,NA
75,28/05/2021,3,0,81,66,15,79,0,0
84,29/05/2021,3,0,20,20,0,NA,NA,NA
668,30/05/2021,3,4,299,42,257,49,0,0
820,30/05/2021,3,0,127,125,2,75,0,0
30,25/05/2021,3,1,70,64,6,142,0,0
675,26/05/2021,3,1,55,28,27,67,0,0
121,29/05/2021,3,0,110,110,0,NA,NA,NA
240,29/05/2021,3,1,70,70,0,NA,NA,NA
789,29/05/2021,3,1,71,72,-1,NA,NA,NA
603,25/05/2021,3,0,84,34,50,60,0,0
481,28/05/2021,3,0,56,35,21,74,0,0
232,27/05/2021,3,1,64,51,13,95,0,0
671,25/05/2021,3,1,64,60,4,112,0,0
495,23/05/2021,3,1,84,21,63,49,0,0
210,29/05/2021,3,1,101,101,0,NA,NA,NA
189,30/05/2021,3,0,165,102,63,52,0,0
358,29/05/2021,3,1,92,92,0,NA,NA,NA
19,28/05/2021,3,1,93,54,39,79,0,0
697,30/05/2021,3,1,108,108,0,NA,NA,NA
883,28/05/2021,3,6,98,16,82,45,0,0
804,26/05/2021,3,4,141,38,103,49,0,0
827,28/05/2021,3,1,69,69,0,NA,NA,NA
44,30/05/2021,3,2,106,103,3,153,0,0
463,28/05/2021,3,9,154,77,77,120,0,0
517,30/05/2021,3,13,45,41,4,52,0,0
273,29/05/2021,3,0,103,103,0,NA,NA,NA
50,29/05/2021,3,2,119,119,0,NA,NA,NA
773,27/05/2021,3,1,73,68,5,82,0,0
459,28/05/2021,3,4,88,88,0,NA,NA,NA
125,29/05/2021,3,2,34,34,0,NA,NA,NA
662,28/05/2021,3,1,106,83,23,93,0,0
8,26/05/2021,3,1,39,19,20,62,0,0
443,29/05/2021,3,4,86,89,-3,NA,NA,NA
528,29/05/2021,3,0,119,119,0,NA,NA,NA
72,29/05/2021,3,2,58,44,14,74,0,0
417,30/05/2021,3,0,103,103,0,NA,NA,NA
12,28/05/2021,3,1,42,30,12,60,0,0
650,29/05/2021,3,4,124,124,0,NA,NA,NA
302,26/05/2021,3,0,61,43,18,57,0,0
91,29/05/2021,3,2,78,78,0,NA,NA,NA
753,29/05/2021,3,4,123,123,0,NA,NA,NA
348,29/05/2021,3,8,132,131,1,88,0,0
296,29/05/2021,3,3,57,44,13,84,0,0
726,27/05/2021,3,0,39,33,6,85,0,0
521,30/05/2021,3,1,54,50,4,72,0,0
829,28/05/2021,3,0,150,88,62,49,0,0
746,29/05/2021,3,3,57,53,4,82,0,0
368,30/05/2021,3,1,84,74,10,69,0,0
154,30/05/2021,3,3,101,101,0,NA,NA,NA
391,29/05/2021,3,1,75,75,0,NA,NA,NA
634,28/05/2021,3,0,20,20,0,NA,NA,NA
183,29/05/2021,3,0,80,68,12,99,0,0
627,26/05/2021,3,0,41,15,26,64,0,0
507,30/05/2021,3,4,196,138,58,49,0,0
253,30/05/2021,3,1,57,50,7,63,0,0
637,30/05/2021,3,0,74,74,0,NA,NA,NA
647,28/05/2021,3,6,87,92,-5,NA,NA,NA
243,29/05/2021,3,1,126,126,0,NA,NA,NA
413,30/05/2021,3,1,115,118,-3,NA,NA,NA
706,29/05/2021,3,1,73,73,0,NA,NA,NA
384,30/05/2021,3,0,101,100,1,75,0,0
84,30/05/2021,3,0,20,20,0,NA,NA,NA
174,29/05/2021,3,4,24,23,1,74,0,0
96,30/05/2021,3,13,56,51,5,106,0,0
144,23/05/2021,3,1,98,29,69,49,0,0
752,26/05/2021,3,1,43,22,21,74,0,0
389,28/05/2021,3,2,124,79,45,55,0,0
146,30/05/2021,3,1,40,40,0,NA,NA,NA
781,28/05/2021,3,2,81,81,0,NA,NA,NA
509,27/05/2021,3,1,111,71,40,49,0,0
310,30/05/2021,3,1,71,66,5,65,0,0
366,28/05/2021,3,4,76,60,16,85,0,0
449,26/05/2021,3,1,94,21,73,90,0,0
359,23/05/2021,3,2,102,100,2,70,0,0
117,28/05/2021,3,5,89,89,0,NA,NA,NA
187,29/05/2021,3,1,40,40,0,NA,NA,NA
414,29/05/2021,3,19,167,171,-4,NA,NA,NA
101,28/05/2021,3,1,59,57,2,67,0,0
870,30/05/2021,3,3,43,40,3,67,0,0
477,28/05/2021,3,5,115,23,92,55,0,0
248,26/05/2021,3,0,82,51,31,74,0,0
214,29/05/2021,3,3,83,83,0,NA,NA,NA
577,23/05/2021,3,0,78,31,47,49,0,0
692,28/05/2021,3,1,86,86,0,NA,NA,NA
680,30/05/2021,3,3,77,71,6,70,0,0
405,26/05/2021,3,1,89,89,0,NA,NA,NA
470,29/05/2021,3,3,77,77,0,NA,NA,NA
331,26/05/2021,3,55,39,35,4,170,0,0
55,29/05/2021,3,1,32,32,0,NA,NA,NA
166,29/05/2021,3,1,65,65,0,NA,NA,NA
135,25/05/2021,3,4,62,56,6,84,0,0
682,25/05/2021,3,2,78,38,40,72,0,0
309,27/05/2021,3,0,16,16,0,NA,NA,NA
155,30/05/2021,3,0,93,93,0,NA,NA,NA
760,29/05/2021,3,1,35,34,1,79,0,0
836,30/05/2021,3,0,101,101,0,NA,NA,NA
467,28/05/2021,3,1,111,30,81,90,0,0
538,29/05/2021,3,1,43,43,0,NA,NA,NA
302,25/05/2021,3,0,61,48,13,62,0,0
749,29/05/2021,3,24,130,144,-14,NA,NA,NA
700,30/05/2021,3,5,127,127,0,NA,NA,NA
853,29/05/2021,3,2,100,99,1,84,0,0
66,28/05/2021,3,1,151,67,84,55,0,0
871,25/05/2021,3,2,76,68,8,65,0,0
118,30/05/2021,3,2,57,58,-1,NA,NA,NA
829,26/05/2021,3,1,149,15,134,49,0,0
811,30/05/2021,3,3,87,82,5,63,0,0
4,29/05/2021,3,1,63,62,1,155,0,0
765,30/05/2021,3,0,101,101,0,NA,NA,NA
514,25/05/2021,3,4,230,49,181,49,0,0
263,29/05/2021,3,0,66,66,0,NA,NA,NA
617,29/05/2021,3,0,44,40,4,74,0,0
554,26/05/2021,3,0,42,27,15,52,0,0
200,30/05/2021,3,3,116,102,14,62,0,0
393,30/05/2021,3,1,59,49,10,62,0,0
333,29/05/2021,3,1,56,56,0,NA,NA,NA
431,29/05/2021,3,3,127,127,0,NA,NA,NA
778,29/05/2021,3,2,79,79,0,NA,NA,NA
42,29/05/2021,3,0,99,99,0,NA,NA,NA
126,29/05/2021,3,2,118,118,0,NA,NA,NA
215,27/05/2021,3,1,45,30,15,59,0,0
294,30/05/2021,3,2,115,116,-1,NA,NA,NA
668,29/05/2021,3,4,299,69,230,49,0,0
531,30/05/2021,3,1,58,56,2,70,0,0
124,23/05/2021,3,0,54,31,23,49,0,0
675,28/05/2021,3,1,55,53,2,112,0,0
32,29/05/2021,3,1,104,104,0,NA,NA,NA
148,28/05/2021,3,0,25,25,0,NA,NA,NA
65,29/05/2021,3,0,78,78,0,NA,NA,NA
438,25/05/2021,3,5,91,48,43,64,0,0
227,30/05/2021,3,1,43,37,6,62,0,0
392,29/05/2021,3,6,170,157,13,77,0,0
449,23/05/2021,3,7,88,19,69,70,0,0
328,25/05/2021,3,2,96,63,33,80,0,0
330,30/05/2021,3,2,117,117,0,NA,NA,NA
380,29/05/2021,3,1,159,159,0,NA,NA,NA
414,30/05/2021,3,19,167,184,-17,NA,NA,NA
334,28/05/2021,3,1,57,40,17,83,0,0
636,30/05/2021,3,0,120,120,0,NA,NA,NA
537,26/05/2021,3,3,99,75,24,106,0,0
248,28/05/2021,3,0,82,63,19,77,0,0
214,27/05/2021,3,2,84,62,22,57,0,0
719,24/05/2021,3,0,41,22,19,80,0,0
692,29/05/2021,3,2,85,86,-1,NA,NA,NA
694,30/05/2021,3,3,106,80,26,57,0,0
468,29/05/2021,3,5,91,91,0,NA,NA,NA
23,29/05/2021,3,1,63,63,0,NA,NA,NA
291,25/05/2021,3,0,61,48,13,62,0,0
181,29/05/2021,3,0,34,34,0,NA,NA,NA
125,27/05/2021,3,2,34,27,7,79,0,0
135,26/05/2021,3,3,63,61,2,115,0,0
22,25/05/2021,3,0,64,62,2,123,0,0
37,29/05/2021,3,1,80,80,0,NA,NA,NA
478,30/05/2021,3,0,20,20,0,NA,NA,NA
139,27/05/2021,3,2,57,36,21,62,0,0
600,29/05/2021,3,0,50,50,0,NA,NA,NA
496,28/05/2021,3,1,59,53,6,74,0,0
373,29/05/2021,3,2,101,101,0,NA,NA,NA
727,23/05/2021,3,0,75,73,2,80,0,0
374,28/05/2021,3,1,55,47,8,67,0,0
100,29/05/2021,3,76,148,149,-1,NA,NA,NA
348,30/05/2021,3,8,132,129,3,65,0,0
790,28/05/2021,3,1,98,80,18,102,0,0
315,27/05/2021,3,0,62,61,1,89,0,0
49,29/05/2021,3,4,144,144,0,NA,NA,NA
829,27/05/2021,3,1,149,22,127,49,0,0
736,30/05/2021,3,3,102,79,23,52,0,0
368,29/05/2021,3,1,84,68,16,107,0,0
18,30/05/2021,3,2,90,90,0,NA,NA,NA
265,30/05/2021,3,1,56,45,11,63,0,0
511,29/05/2021,3,0,76,76,0,NA,NA,NA
932,27/05/2021,3,21,86,6,80,45,0,0
376,25/05/2021,3,1,63,63,0,NA,NA,NA
581,30/05/2021,3,50,175,174,1,76,0,0
683,30/05/2021,3,1,65,51,14,57,0,0
907,29/05/2021,3,3,77,77,0,NA,NA,NA
439,29/05/2021,3,2,89,89,0,NA,NA,NA
151,30/05/2021,3,6,70,70,0,NA,NA,NA
607,29/05/2021,3,1,74,74,0,NA,NA,NA
412,29/05/2021,3,11,90,90,0,NA,NA,NA
619,27/05/2021,3,1,100,45,55,55,0,0
76,29/05/2021,3,1,92,92,0,NA,NA,NA
5,30/05/2021,3,6,83,73,10,57,0,0
96,29/05/2021,3,13,56,57,-1,NA,NA,NA
144,25/05/2021,3,1,98,47,51,52,0,0
681,28/05/2021,3,5,66,55,11,74,0,0
257,29/05/2021,3,1,43,43,0,NA,NA,NA
26,29/05/2021,3,2,64,57,7,74,0,0
396,28/05/2021,3,1,29,29,0,NA,NA,NA
472,25/05/2021,3,2,232,42,190,90,0,0
227,28/05/2021,3,2,42,26,16,60,0,0
854,28/05/2021,3,5,105,44,61,120,0,0
722,26/05/2021,3,0,42,30,12,72,0,0
328,26/05/2021,3,2,96,56,40,72,0,0
210,30/05/2021,3,2,100,100,0,NA,NA,NA
777,29/05/2021,3,3,117,117,0,NA,NA,NA
641,29/05/2021,3,0,160,162,-2,NA,NA,NA
738,28/05/2021,3,1,123,121,2,77,0,0
499,30/05/2021,3,0,31,25,6,62,0,0
492,26/05/2021,3,3,34,18,16,62,0,0
899,28/05/2021,3,2,103,100,3,117,0,0
363,29/05/2021,3,3,96,95,1,142,0,0
532,25/05/2021,3,0,84,83,1,127,0,0
663,29/05/2021,3,13,135,158,-23,NA,NA,NA
517,26/05/2021,3,0,58,40,18,57,0,0
36,29/05/2021,3,1,62,62,0,NA,NA,NA
801,30/05/2021,3,7,160,130,30,57,0,0
388,26/05/2021,3,1,59,41,18,67,0,0
319,29/05/2021,3,6,108,108,0,NA,NA,NA
7,29/05/2021,3,3,100,33,67,55,0,0
933,26/05/2021,3,87,60,2,58,35,0,0
447,25/05/2021,3,0,143,131,12,85,0,0
473,29/05/2021,3,2,48,48,0,NA,NA,NA
478,28/05/2021,3,0,20,20,0,NA,NA,NA
139,28/05/2021,3,2,57,28,29,67,0,0
600,30/05/2021,3,0,50,50,0,NA,NA,NA
496,29/05/2021,3,1,59,57,2,170,0,0
839,29/05/2021,3,3,152,152,0,NA,NA,NA
727,25/05/2021,3,0,75,48,27,104,0,0
374,29/05/2021,3,1,55,55,0,NA,NA,NA
615,29/05/2021,3,0,71,71,0,NA,NA,NA
768,26/05/2021,3,1,86,43,43,60,0,0
401,29/05/2021,3,0,79,70,9,123,0,0
649,27/05/2021,3,2,62,56,6,98,0,0
873,29/05/2021,3,4,97,97,0,NA,NA,NA
424,26/05/2021,3,1,27,23,4,95,0,0
811,29/05/2021,3,2,88,86,2,74,0,0
560,30/05/2021,3,0,80,79,1,84,0,0
826,30/05/2021,3,2,96,96,0,NA,NA,NA
701,25/05/2021,3,2,60,46,14,85,0,0
624,29/05/2021,3,0,79,79,0,NA,NA,NA
475,28/05/2021,3,1,98,81,17,80,0,0
307,26/05/2021,3,1,78,63,15,63,0,0
809,30/05/2021,3,1,100,86,14,57,0,0
192,29/05/2021,3,0,86,77,9,74,0,0
907,30/05/2021,3,3,77,77,0,NA,NA,NA
506,29/05/2021,3,1,194,194,0,NA,NA,NA
243,30/05/2021,3,1,126,126,0,NA,NA,NA
147,30/05/2021,3,1,79,57,22,52,0,0
341,26/05/2021,3,41,73,70,3,152,0,0
619,28/05/2021,3,1,100,69,31,55,0,0
294,29/05/2021,3,1,116,116,0,NA,NA,NA
290,30/05/2021,3,2,105,63,42,52,0,0
256,30/05/2021,3,1,108,109,-1,NA,NA,NA
30,23/05/2021,3,1,70,49,21,92,0,0
752,28/05/2021,3,0,44,44,0,NA,NA,NA
434,28/05/2021,3,3,57,51,6,79,0,0
146,29/05/2021,3,1,40,40,0,NA,NA,NA
592,28/05/2021,3,1,83,83,0,NA,NA,NA
403,26/05/2021,3,4,94,66,28,79,0,0
326,28/05/2021,3,3,78,54,24,60,0,0
854,27/05/2021,3,7,103,32,71,100,0,0
41,22/05/2021,3,2,82,82,0,NA,NA,NA
359,26/05/2021,3,2,102,74,28,82,0,0
78,28/05/2021,3,0,44,44,0,NA,NA,NA
785,29/05/2021,3,1,109,109,0,NA,NA,NA
741,29/05/2021,3,1,69,69,0,NA,NA,NA
890,29/05/2021,3,0,150,148,2,169,0,0
610,30/05/2021,3,2,65,63,2,103,0,0
492,27/05/2021,3,3,34,23,11,57,0,0
104,27/05/2021,3,2,60,60,0,NA,NA,NA
664,29/05/2021,3,9,146,145,1,131,0,0
577,25/05/2021,3,0,78,48,30,52,0,0
140,30/05/2021,3,15,155,157,-2,NA,NA,NA
421,28/05/2021,3,0,19,19,0,NA,NA,NA
405,30/05/2021,3,1,89,89,0,NA,NA,NA
573,30/05/2021,3,0,57,52,5,65,0,0
351,27/05/2021,3,2,64,54,10,85,0,0
337,29/05/2021,3,0,60,60,0,NA,NA,NA
105,29/05/2021,3,5,70,68,2,123,0,0
542,25/05/2021,3,2,73,68,5,139,0,0
8,24/05/2021,3,1,39,25,14,63,0,0
59,27/05/2021,3,6,69,22,47,49,0,0
478,29/05/2021,3,0,20,20,0,NA,NA,NA
204,29/05/2021,3,0,64,64,0,NA,NA,NA
163,30/05/2021,3,1,61,60,1,130,0,0
142,30/05/2021,3,1,61,60,1,124,0,0
872,30/05/2021,3,1,64,64,0,NA,NA,NA
727,26/05/2021,3,0,75,41,34,103,0,0
737,29/05/2021,3,2,40,40,0,NA,NA,NA
700,29/05/2021,3,6,126,126,0,NA,NA,NA
312,26/05/2021,3,1,96,59,37,74,0,0
281,28/05/2021,3,1,82,35,47,55,0,0
720,27/05/2021,3,0,39,34,5,77,0,0
873,30/05/2021,3,3,98,98,0,NA,NA,NA
424,27/05/2021,3,1,27,26,1,87,0,0
587,30/05/2021,3,2,79,76,3,80,0,0
806,30/05/2021,3,2,134,133,1,63,0,0
759,29/05/2021,3,2,85,85,0,NA,NA,NA
701,30/05/2021,3,2,60,57,3,103,0,0
703,29/05/2021,3,0,91,90,1,84,0,0
106,28/05/2021,3,1,30,30,0,NA,NA,NA
659,27/05/2021,3,3,40,22,18,60,0,0
46,30/05/2021,3,1,59,39,20,58,0,0
192,30/05/2021,3,0,86,73,13,57,0,0
824,28/05/2021,3,0,339,76,263,85,0,0
574,29/05/2021,3,12,75,76,-1,NA,NA,NA
778,30/05/2021,3,1,80,80,0,NA,NA,NA
571,29/05/2021,3,2,159,159,0,NA,NA,NA
39,28/05/2021,3,1,60,41,19,60,0,0
633,28/05/2021,3,1,49,38,11,67,0,0
385,29/05/2021,3,2,61,61,0,NA,NA,NA
5,29/05/2021,3,6,83,58,25,60,0,0
327,30/05/2021,3,19,49,50,-1,NA,NA,NA
124,25/05/2021,3,0,54,54,0,NA,NA,NA
418,26/05/2021,3,0,116,42,74,49,0,0
837,28/05/2021,3,4,322,51,271,90,0,0
345,30/05/2021,3,0,101,101,0,NA,NA,NA
130,29/05/2021,3,1,80,80,0,NA,NA,NA
472,26/05/2021,3,2,232,56,176,90,0,0
127,28/05/2021,3,1,59,45,14,67,0,0
429,29/05/2021,3,3,122,53,69,55,0,0
775,22/05/2021,3,4,105,83,22,60,0,0
328,28/05/2021,3,2,96,86,10,70,0,0
304,29/05/2021,3,0,60,60,0,NA,NA,NA
897,29/05/2021,3,2,108,108,0,NA,NA,NA
156,30/05/2021,3,0,148,148,0,NA,NA,NA
485,27/05/2021,3,0,65,26,39,49,0,0
80,30/05/2021,3,2,123,89,34,52,0,0
406,26/05/2021,3,1,38,29,9,85,0,0
264,28/05/2021,3,1,59,48,11,67,0,0
21,27/05/2021,3,1,59,30,29,57,0,0
532,26/05/2021,3,0,84,73,11,95,0,0
692,30/05/2021,3,3,84,86,-2,NA,NA,NA
421,30/05/2021,3,0,19,19,0,NA,NA,NA
336,26/05/2021,3,1,73,51,22,177,0,0
819,29/05/2021,3,1,79,79,0,NA,NA,NA
81,28/05/2021,3,1,59,17,42,55,0,0
808,29/05/2021,3,2,166,166,0,NA,NA,NA
585,27/05/2021,3,2,58,57,1,112,0,0
756,26/05/2021,3,0,106,106,0,NA,NA,NA
447,27/05/2021,3,0,143,112,31,69,0,0
161,28/05/2021,3,1,60,55,5,94,0,0
237,28/05/2021,3,6,115,99,16,57,0,0
139,29/05/2021,3,3,56,57,-1,NA,NA,NA
266,30/05/2021,3,0,61,60,1,75,0,0
173,29/05/2021,3,2,69,66,3,74,0,0
137,28/05/2021,3,25,121,71,50,55,0,0
693,21/05/2021,3,2,123,62,61,55,0,0
631,29/05/2021,3,1,70,35,35,55,0,0
852,29/05/2021,3,0,80,80,0,NA,NA,NA
898,26/05/2021,3,1,99,80,19,75,0,0
707,28/05/2021,3,0,40,39,1,144,0,0
871,27/05/2021,3,2,76,57,19,62,0,0
234,29/05/2021,3,1,61,61,0,NA,NA,NA
705,29/05/2021,3,0,91,90,1,89,0,0
90,29/05/2021,3,0,78,76,2,77,0,0
915,29/05/2021,3,4,185,15,170,35,0,0
242,29/05/2021,3,1,137,137,0,NA,NA,NA
111,26/05/2021,3,0,60,49,11,85,0,0
86,29/05/2021,3,1,47,47,0,NA,NA,NA
755,29/05/2021,3,0,87,87,0,NA,NA,NA
197,27/05/2021,3,0,118,42,76,49,0,0
353,29/05/2021,3,1,51,50,1,127,0,0
474,30/05/2021,3,0,112,110,2,63,0,0
356,30/05/2021,3,0,136,132,4,121,0,0
647,29/05/2021,3,6,87,91,-4,NA,NA,NA
184,29/05/2021,3,0,51,51,0,NA,NA,NA
648,29/05/2021,3,1,63,63,0,NA,NA,NA
510,26/05/2021,3,2,141,29,112,49,0,0
219,26/05/2021,3,5,72,33,39,49,0,0
699,29/05/2021,3,1,61,61,0,NA,NA,NA
38,30/05/2021,3,1,49,46,3,103,0,0
386,29/05/2021,3,2,83,83,0,NA,NA,NA
61,23/05/2021,3,3,97,36,61,49,0,0
60,26/05/2021,3,0,57,46,11,59,0,0
835,27/05/2021,3,6,98,73,25,82,0,0
513,29/05/2021,3,3,74,74,0,NA,NA,NA
592,29/05/2021,3,1,83,83,0,NA,NA,NA
764,26/05/2021,3,3,66,37,29,55,0,0
310,28/05/2021,3,1,71,50,21,60,0,0
274,28/05/2021,3,2,208,30,178,39,0,0
41,24/05/2021,3,2,82,58,24,60,0,0
359,28/05/2021,3,3,101,58,43,55,0,0
304,30/05/2021,3,0,60,60,0,NA,NA,NA
897,30/05/2021,3,2,108,108,0,NA,NA,NA
179,29/05/2021,3,1,91,67,24,67,0,0
868,27/05/2021,3,0,83,76,7,57,0,0
188,30/05/2021,3,6,115,84,31,52,0,0
889,26/05/2021,3,1,123,14,109,45,0,0
479,28/05/2021,3,2,53,47,6,77,0,0
31,28/05/2021,3,1,62,37,25,55,0,0
719,30/05/2021,3,0,41,40,1,74,0,0
457,30/05/2021,3,11,52,52,0,NA,NA,NA
580,30/05/2021,3,0,98,98,0,NA,NA,NA
36,28/05/2021,3,1,62,41,21,60,0,0
23,30/05/2021,3,1,63,54,9,57,0,0
606,28/05/2021,3,2,44,40,4,95,0,0
891,29/05/2021,3,2,80,80,0,NA,NA,NA
196,28/05/2021,3,0,138,54,84,55,0,0
9,25/05/2021,3,0,27,27,0,NA,NA,NA
303,28/05/2021,3,2,63,52,11,67,0,0
59,29/05/2021,3,6,69,53,16,74,0,0
528,28/05/2021,3,0,119,107,12,74,0,0
422,29/05/2021,3,1,78,78,0,NA,NA,NA
875,28/05/2021,3,2,90,74,16,67,0,0
739,30/05/2021,3,2,73,60,13,57,0,0
563,29/05/2021,3,2,68,67,1,84,0,0
693,22/05/2021,3,2,123,95,28,67,0,0
533,29/05/2021,3,1,90,83,7,79,0,0
122,30/05/2021,3,3,118,118,0,NA,NA,NA
833,27/05/2021,3,1,82,62,20,63,0,0
239,28/05/2021,3,0,40,33,7,74,0,0
720,28/05/2021,3,0,39,27,12,81,0,0
258,29/05/2021,3,1,142,142,0,NA,NA,NA
11,30/05/2021,3,1,83,62,21,57,0,0
90,30/05/2021,3,0,78,61,17,62,0,0
915,30/05/2021,3,3,186,7,179,35,0,0
488,29/05/2021,3,3,63,63,0,NA,NA,NA
371,25/05/2021,3,0,36,17,19,146,0,0
487,29/05/2021,3,0,39,39,0,NA,NA,NA
519,29/05/2021,3,0,64,64,0,NA,NA,NA
554,27/05/2021,3,0,42,26,16,49,0,0
591,29/05/2021,3,0,68,63,5,88,0,0
474,29/05/2021,3,0,112,110,2,74,0,0
783,30/05/2021,3,0,80,79,1,119,0,0
352,29/05/2021,3,0,64,64,0,NA,NA,NA
817,29/05/2021,3,0,83,83,0,NA,NA,NA
198,30/05/2021,3,50,85,85,0,NA,NA,NA
45,28/05/2021,3,66,90,20,70,49,0,0
556,26/05/2021,3,2,115,96,19,65,0,0
750,29/05/2021,3,3,109,109,0,NA,NA,NA
476,29/05/2021,3,0,173,34,139,55,0,0
643,30/05/2021,3,2,101,101,0,NA,NA,NA
604,26/05/2021,3,4,78,42,36,60,0,0
60,28/05/2021,3,0,57,44,13,60,0,0
314,28/05/2021,3,1,68,56,12,67,0,0
513,28/05/2021,3,2,75,54,21,60,0,0
347,28/05/2021,3,13,49,47,2,94,0,0
715,25/05/2021,3,0,88,88,0,NA,NA,NA
742,28/05/2021,3,1,73,61,12,67,0,0
274,29/05/2021,3,2,208,32,176,39,0,0
793,22/05/2021,3,2,129,75,54,55,0,0
261,28/05/2021,3,2,100,100,0,NA,NA,NA
902,30/05/2021,3,0,126,75,51,49,0,0
570,29/05/2021,3,0,149,149,0,NA,NA,NA
201,29/05/2021,3,5,133,126,7,74,0,0
520,29/05/2021,3,0,58,57,1,115,0,0
501,30/05/2021,3,23,210,179,31,52,0,0
889,27/05/2021,3,1,123,12,111,45,0,0
83,27/05/2021,3,13,155,118,37,80,0,0
31,27/05/2021,3,2,61,22,39,49,0,0
44,26/05/2021,3,4,104,47,57,112,0,0
140,29/05/2021,3,8,162,162,0,NA,NA,NA
260,29/05/2021,3,1,119,119,0,NA,NA,NA
13,30/05/2021,3,3,78,77,1,84,0,0
50,30/05/2021,3,2,119,116,3,63,0,0
552,25/05/2021,3,11,173,85,88,49,0,0
856,29/05/2021,3,0,120,120,0,NA,NA,NA
497,29/05/2021,3,4,189,189,0,NA,NA,NA
756,28/05/2021,3,0,106,106,0,NA,NA,NA
268,24/05/2021,3,1,77,64,13,72,0,0
802,28/05/2021,3,1,64,63,1,122,0,0
628,28/05/2021,3,1,58,58,0,NA,NA,NA
622,29/05/2021,3,3,41,41,0,NA,NA,NA
684,30/05/2021,3,4,94,70,24,57,0,0
390,28/05/2021,3,2,134,121,13,74,0,0
113,28/05/2021,3,1,31,25,6,74,0,0
536,24/05/2021,3,1,80,29,51,75,0,0
91,27/05/2021,3,2,78,62,16,57,0,0
710,28/05/2021,3,0,20,15,5,74,0,0
833,28/05/2021,3,1,82,56,26,74,0,0
522,29/05/2021,3,3,59,59,0,NA,NA,NA
297,26/05/2021,3,1,75,51,24,55,0,0
234,30/05/2021,3,1,61,61,0,NA,NA,NA
711,30/05/2021,3,1,88,84,4,62,0,0
149,30/05/2021,3,0,88,87,1,62,0,0
669,30/05/2021,3,1,86,82,4,63,0,0
704,29/05/2021,3,1,31,31,0,NA,NA,NA
371,26/05/2021,3,0,36,13,23,124,0,0
216,28/05/2021,3,1,57,17,40,55,0,0
106,29/05/2021,3,1,30,30,0,NA,NA,NA
35,25/05/2021,3,0,110,34,76,49,0,0
652,30/05/2021,3,0,69,35,34,49,0,0
56,30/05/2021,3,2,63,53,10,62,0,0
465,29/05/2021,3,29,238,255,-17,NA,NA,NA
598,29/05/2021,3,0,146,146,0,NA,NA,NA
259,29/05/2021,3,0,60,60,0,NA,NA,NA
589,29/05/2021,3,4,139,114,25,74,0,0
412,26/05/2021,3,15,86,37,49,49,0,0
215,30/05/2021,3,2,44,41,3,57,0,0
857,29/05/2021,3,3,207,207,0,NA,NA,NA
407,30/05/2021,3,0,41,39,2,62,0,0
203,29/05/2021,3,1,39,39,0,NA,NA,NA
144,27/05/2021,3,2,97,41,56,49,0,0
918,26/05/2021,3,0,201,23,178,39,0,0
103,29/05/2021,3,0,161,163,-2,NA,NA,NA
240,28/05/2021,3,1,70,66,4,79,0,0
419,28/05/2021,3,6,104,69,35,90,0,0
509,25/05/2021,3,1,111,58,53,49,0,0
227,29/05/2021,3,1,43,36,7,67,0,0
392,27/05/2021,3,0,176,98,78,49,0,0
775,23/05/2021,3,4,105,37,68,49,0,0
454,28/05/2021,3,0,184,56,128,90,0,0
493,30/05/2021,3,1,34,34,0,NA,NA,NA
696,29/05/2021,3,0,89,89,0,NA,NA,NA
343,29/05/2021,3,3,59,42,17,119,0,0
868,29/05/2021,3,0,83,82,1,127,0,0
355,30/05/2021,3,1,98,74,24,57,0,0
858,26/05/2021,3,0,81,72,9,90,0,0
535,26/05/2021,3,1,82,33,49,49,0,0
725,27/05/2021,3,0,17,13,4,77,0,0
577,27/05/2021,3,12,66,42,24,52,0,0
463,25/05/2021,3,7,156,63,93,110,0,0
260,30/05/2021,3,1,119,119,0,NA,NA,NA
468,30/05/2021,3,4,92,88,4,65,0,0
470,30/05/2021,3,3,77,75,2,77,0,0
81,27/05/2021,3,1,59,27,32,49,0,0
329,29/05/2021,3,9,98,98,0,NA,NA,NA
196,27/05/2021,3,0,138,25,113,49,0,0
542,26/05/2021,3,2,73,73,0,NA,NA,NA
22,24/05/2021,3,0,64,62,2,89,0,0
37,27/05/2021,3,1,80,49,31,49,0,0
178,29/05/2021,3,0,38,38,0,NA,NA,NA
642,29/05/2021,3,2,93,93,0,NA,NA,NA
321,30/05/2021,3,1,39,30,9,63,0,0
862,28/05/2021,3,2,108,104,4,88,0,0
538,30/05/2021,3,0,44,39,5,70,0,0
693,24/05/2021,3,3,122,31,91,49,0,0
631,27/05/2021,3,2,69,52,17,59,0,0
171,28/05/2021,3,2,47,43,4,100,0,0
397,30/05/2021,3,1,74,63,11,62,0,0
784,29/05/2021,3,1,48,48,0,NA,NA,NA
297,29/05/2021,3,1,75,42,33,55,0,0
258,30/05/2021,3,1,142,142,0,NA,NA,NA
780,28/05/2021,3,0,60,60,0,NA,NA,NA
159,29/05/2021,3,0,77,74,3,83,0,0
67,30/05/2021,3,1,51,32,19,57,0,0
879,26/05/2021,3,4,160,19,141,39,0,0
878,25/05/2021,3,0,218,11,207,44,0,0
86,27/05/2021,3,2,46,31,15,52,0,0
594,29/05/2021,3,2,105,106,-1,NA,NA,NA
307,25/05/2021,3,1,78,62,16,65,0,0
652,29/05/2021,3,0,69,57,12,74,0,0
350,30/05/2021,3,2,58,57,1,70,0,0
43,29/05/2021,3,2,71,71,0,NA,NA,NA
686,28/05/2021,3,0,46,36,10,67,0,0
689,30/05/2021,3,0,130,130,0,NA,NA,NA
17,29/05/2021,3,1,93,92,1,74,0,0
543,26/05/2021,3,1,64,37,27,141,0,0
349,26/05/2021,3,6,84,71,13,80,0,0
886,30/05/2021,3,2,150,70,80,49,0,0
679,29/05/2021,3,0,89,88,1,105,0,0
757,30/05/2021,3,0,117,117,0,NA,NA,NA
124,24/05/2021,3,0,54,40,14,67,0,0
383,26/05/2021,3,4,81,66,15,85,0,0
505,29/05/2021,3,0,84,84,0,NA,NA,NA
148,29/05/2021,3,0,25,23,2,74,0,0
207,29/05/2021,3,2,61,60,1,115,0,0
58,27/05/2021,3,1,66,49,17,60,0,0
742,29/05/2021,3,1,73,72,1,84,0,0
588,27/05/2021,3,0,59,54,5,74,0,0
775,24/05/2021,3,4,105,62,43,49,0,0
843,24/05/2021,3,2,64,37,27,52,0,0
493,29/05/2021,3,1,34,35,-1,NA,NA,NA
238,30/05/2021,3,0,66,65,1,62,0,0
445,29/05/2021,3,3,166,130,36,57,0,0
485,28/05/2021,3,0,65,36,29,55,0,0
340,30/05/2021,3,16,118,48,70,49,0,0
558,26/05/2021,3,0,44,13,31,55,0,0
272,27/05/2021,3,4,123,80,43,49,0,0
225,28/05/2021,3,13,67,67,0,NA,NA,NA
874,27/05/2021,3,10,79,23,56,49,0,0
635,26/05/2021,3,0,88,45,43,49,0,0
661,29/05/2021,3,28,144,147,-3,NA,NA,NA
640,30/05/2021,3,6,120,104,16,62,0,0
849,30/05/2021,3,0,84,59,25,49,0,0
351,25/05/2021,3,0,66,56,10,85,0,0
724,29/05/2021,3,1,85,85,0,NA,NA,NA
7,27/05/2021,3,4,99,31,68,55,0,0
135,28/05/2021,3,3,63,63,0,NA,NA,NA
471,26/05/2021,3,7,113,92,21,64,0,0
244,27/05/2021,3,2,198,118,80,49,0,0
565,29/05/2021,3,0,62,62,0,NA,NA,NA
782,28/05/2021,3,0,20,20,0,NA,NA,NA
51,29/05/2021,3,2,78,78,0,NA,NA,NA
739,28/05/2021,3,2,73,47,26,55,0,0
563,28/05/2021,3,2,68,68,0,NA,NA,NA
536,22/05/2021,3,1,80,44,36,70,0,0
91,28/05/2021,3,2,78,72,6,74,0,0
852,30/05/2021,3,1,79,79,0,NA,NA,NA
348,27/05/2021,3,8,132,123,9,65,0,0
239,29/05/2021,3,0,40,40,0,NA,NA,NA
649,26/05/2021,3,2,62,61,1,110,0,0
118,29/05/2021,3,2,57,57,0,NA,NA,NA
866,28/05/2021,3,0,100,100,0,NA,NA,NA
164,29/05/2021,3,0,62,61,1,149,0,0
498,30/05/2021,3,0,87,60,27,52,0,0
879,27/05/2021,3,4,160,17,143,39,0,0
878,26/05/2021,3,0,218,14,204,44,0,0
233,27/05/2021,3,3,64,52,12,57,0,0
848,29/05/2021,3,7,131,131,0,NA,NA,NA
627,25/05/2021,3,0,41,16,25,64,0,0
677,30/05/2021,3,0,40,30,10,65,0,0
462,30/05/2021,3,10,179,34,145,60,0,0
712,29/05/2021,3,6,79,79,0,NA,NA,NA
714,28/05/2021,3,0,59,49,10,85,0,0
259,30/05/2021,3,0,60,60,0,NA,NA,NA
864,29/05/2021,3,1,84,77,7,79,0,0
102,26/05/2021,3,0,60,43,17,72,0,0
619,26/05/2021,3,1,100,50,50,59,0,0
180,29/05/2021,3,1,40,30,10,57,0,0
821,29/05/2021,3,0,79,79,0,NA,NA,NA
53,30/05/2021,3,0,70,70,0,NA,NA,NA
604,25/05/2021,3,0,82,41,41,55,0,0
632,27/05/2021,3,1,81,37,44,55,0,0
709,29/05/2021,3,0,83,83,0,NA,NA,NA
317,30/05/2021,3,0,80,79,1,128,0,0
629,29/05/2021,3,3,59,58,1,79,0,0
308,27/05/2021,3,2,46,38,8,62,0,0
222,28/05/2021,3,0,77,66,11,81,0,0
392,28/05/2021,3,0,176,91,85,55,0,0
41,23/05/2021,3,2,82,42,40,49,0,0
843,23/05/2021,3,3,63,33,30,49,0,0
330,29/05/2021,3,2,117,117,0,NA,NA,NA
777,30/05/2021,3,3,117,118,-1,NA,NA,NA
494,29/05/2021,3,4,135,113,22,77,0,0
803,28/05/2021,3,0,69,68,1,85,0,0
733,30/05/2021,3,2,98,43,55,49,0,0
613,28/05/2021,3,0,56,35,21,67,0,0
248,27/05/2021,3,0,82,55,27,74,0,0
21,29/05/2021,3,1,59,59,0,NA,NA,NA
532,22/05/2021,3,0,84,65,19,157,0,0
140,28/05/2021,3,46,124,125,-1,NA,NA,NA
260,28/05/2021,3,1,119,119,0,NA,NA,NA
640,28/05/2021,3,5,121,79,42,55,0,0
379,30/05/2021,3,6,281,241,40,94,0,0
291,27/05/2021,3,0,61,56,5,62,0,0
913,29/05/2021,3,2,103,105,-2,NA,NA,NA
646,27/05/2021,3,18,118,88,30,63,0,0
756,25/05/2021,3,0,106,100,6,126,0,0
22,26/05/2021,3,0,64,58,6,89,0,0
473,28/05/2021,3,2,48,32,16,60,0,0
318,30/05/2021,3,0,59,59,0,NA,NA,NA
202,29/05/2021,3,0,76,76,0,NA,NA,NA
128,29/05/2021,3,1,20,20,0,NA,NA,NA
394,30/05/2021,3,0,68,52,16,52,0,0
839,30/05/2021,3,3,152,152,0,NA,NA,NA
693,26/05/2021,3,2,123,28,95,49,0,0
749,28/05/2021,3,24,130,102,28,52,0,0
615,28/05/2021,3,0,71,58,13,97,0,0
768,27/05/2021,3,11,76,48,28,60,0,0
416,29/05/2021,3,0,34,34,0,NA,NA,NA
871,26/05/2021,3,2,76,69,7,65,0,0
230,29/05/2021,3,1,79,79,0,NA,NA,NA
70,30/05/2021,3,1,38,38,0,NA,NA,NA
794,30/05/2021,3,0,137,52,85,60,0,0
498,29/05/2021,3,6,81,80,1,77,0,0
242,28/05/2021,3,4,134,101,33,77,0,0
878,30/05/2021,3,0,218,10,208,44,0,0
369,27/05/2021,3,4,86,58,28,73,0,0
519,28/05/2021,3,0,64,64,0,NA,NA,NA
197,26/05/2021,3,0,118,45,73,49,0,0
25,29/05/2021,3,1,51,51,0,NA,NA,NA
253,29/05/2021,3,1,57,50,7,112,0,0
712,30/05/2021,3,6,79,79,0,NA,NA,NA
484,28/05/2021,3,0,40,39,1,84,0,0
420,29/05/2021,3,0,69,69,0,NA,NA,NA
864,30/05/2021,3,1,84,75,9,62,0,0
134,28/05/2021,3,1,47,47,0,NA,NA,NA
564,27/05/2021,3,1,73,60,13,52,0,0
143,30/05/2021,3,4,116,119,-3,NA,NA,NA
107,29/05/2021,3,1,88,88,0,NA,NA,NA
158,30/05/2021,3,0,24,24,0,NA,NA,NA
185,23/05/2021,3,1,167,57,110,49,0,0
863,27/05/2021,3,13,82,55,27,52,0,0
505,28/05/2021,3,0,84,45,39,55,0,0
317,28/05/2021,3,0,80,77,3,93,0,0
224,28/05/2021,3,1,56,30,26,55,0,0
322,27/05/2021,3,3,97,42,55,49,0,0
481,30/05/2021,3,0,56,50,6,65,0,0
177,27/05/2021,3,0,48,19,29,59,0,0
449,24/05/2021,3,2,93,24,69,85,0,0
495,28/05/2021,3,1,84,49,35,55,0,0
411,29/05/2021,3,0,185,185,0,NA,NA,NA
189,29/05/2021,3,0,165,165,0,NA,NA,NA
562,29/05/2021,3,1,67,66,1,79,0,0
460,27/05/2021,3,11,98,69,29,52,0,0
601,30/05/2021,3,2,66,66,0,NA,NA,NA
883,27/05/2021,3,6,98,26,72,45,0,0
112,28/05/2021,3,0,84,69,15,67,0,0
31,29/05/2021,3,1,62,62,0,NA,NA,NA
719,23/05/2021,3,0,41,18,23,61,0,0
457,29/05/2021,3,2,61,62,-1,NA,NA,NA
580,28/05/2021,3,0,98,98,0,NA,NA,NA
336,27/05/2021,3,1,73,57,16,158,0,0
801,29/05/2021,3,7,160,159,1,62,0,0
552,28/05/2021,3,12,172,169,3,79,0,0
911,29/05/2021,3,0,158,158,0,NA,NA,NA
123,28/05/2021,3,5,90,43,47,55,0,0
662,27/05/2021,3,1,106,104,2,71,0,0
761,24/05/2021,3,2,81,45,36,49,0,0
195,27/05/2021,3,1,50,37,13,49,0,0
786,29/05/2021,3,1,61,61,0,NA,NA,NA
782,29/05/2021,3,0,20,20,0,NA,NA,NA
684,29/05/2021,3,4,94,94,0,NA,NA,NA
394,28/05/2021,3,0,68,32,36,55,0,0
113,29/05/2021,3,2,30,30,0,NA,NA,NA
536,26/05/2021,3,1,80,27,53,84,0,0
435,29/05/2021,3,48,72,59,13,57,0,0
700,28/05/2021,3,6,126,113,13,77,0,0
540,26/05/2021,3,2,80,40,40,49,0,0
450,29/05/2021,3,3,181,181,0,NA,NA,NA
649,28/05/2021,3,2,62,61,1,113,0,0
539,29/05/2021,3,3,94,94,0,NA,NA,NA
424,30/05/2021,3,1,27,27,0,NA,NA,NA
524,30/05/2021,3,1,109,89,20,57,0,0
211,30/05/2021,3,2,58,52,6,62,0,0
488,28/05/2021,3,2,64,62,2,85,0,0
265,26/05/2021,3,1,56,32,24,52,0,0
685,27/05/2021,3,2,138,135,3,77,0,0
519,27/05/2021,3,0,64,59,5,85,0,0
639,26/05/2021,3,0,59,32,27,57,0,0
119,29/05/2021,3,2,66,66,0,NA,NA,NA
512,30/05/2021,3,1,61,57,4,62,0,0
333,28/05/2021,3,1,56,56,0,NA,NA,NA
136,29/05/2021,3,0,128,128,0,NA,NA,NA
420,30/05/2021,3,0,69,69,0,NA,NA,NA
287,29/05/2021,3,1,122,83,39,55,0,0
199,29/05/2021,3,3,79,79,0,NA,NA,NA
349,28/05/2021,3,6,84,53,31,55,0,0
805,29/05/2021,3,3,110,110,0,NA,NA,NA
407,29/05/2021,3,1,40,40,0,NA,NA,NA
531,29/05/2021,3,1,58,58,0,NA,NA,NA
61,27/05/2021,3,1,99,52,47,49,0,0
235,26/05/2021,3,4,153,32,121,49,0,0
121,28/05/2021,3,0,110,107,3,130,0,0
810,29/05/2021,3,6,383,91,292,90,0,0
869,28/05/2021,3,1,59,52,7,141,0,0
509,24/05/2021,3,1,111,74,37,52,0,0
772,28/05/2021,3,0,57,49,8,71,0,0
250,27/05/2021,3,0,115,83,32,80,0,0
602,24/05/2021,3,0,64,42,22,57,0,0
495,24/05/2021,3,1,84,29,55,49,0,0
807,30/05/2021,3,28,72,72,0,NA,NA,NA
305,29/05/2021,3,6,53,53,0,NA,NA,NA
653,29/05/2021,3,3,112,72,40,55,0,0
815,27/05/2021,3,12,117,86,31,84,0,0
859,30/05/2021,3,1,84,84,0,NA,NA,NA
702,26/05/2021,3,1,49,37,12,85,0,0
535,28/05/2021,3,0,83,65,18,74,0,0
208,29/05/2021,3,0,60,60,0,NA,NA,NA
595,22/05/2021,3,2,48,29,19,57,0,0
140,27/05/2021,3,77,93,93,0,NA,NA,NA
680,28/05/2021,3,3,77,77,0,NA,NA,NA
605,28/05/2021,3,42,118,119,-1,NA,NA,NA
849,29/05/2021,3,1,83,78,5,79,0,0
331,25/05/2021,3,55,39,27,12,124,0,0
814,29/05/2021,3,1,67,65,2,96,0,0
774,28/05/2021,3,5,100,39,61,55,0,0
68,26/05/2021,3,1,115,31,84,49,0,0
682,27/05/2021,3,2,78,50,28,49,0,0
473,27/05/2021,3,2,48,43,5,82,0,0
565,30/05/2021,3,0,62,62,0,NA,NA,NA
518,28/05/2021,3,0,17,17,0,NA,NA,NA
875,29/05/2021,3,2,90,90,0,NA,NA,NA
209,28/05/2021,3,1,113,112,1,90,0,0
758,30/05/2021,3,0,73,72,1,91,0,0
536,23/05/2021,3,3,78,22,56,49,0,0
572,28/05/2021,3,0,61,38,23,60,0,0
370,30/05/2021,3,0,40,39,1,69,0,0
853,27/05/2021,3,2,100,62,38,55,0,0
707,29/05/2021,3,1,39,39,0,NA,NA,NA
871,28/05/2021,3,2,76,56,20,74,0,0
49,30/05/2021,3,4,144,154,-10,NA,NA,NA
780,30/05/2021,3,0,60,60,0,NA,NA,NA
587,29/05/2021,3,2,79,78,1,119,0,0
152,29/05/2021,3,1,90,87,3,119,0,0
759,28/05/2021,3,2,85,48,37,55,0,0
1,29/05/2021,3,2,98,26,72,55,0,0
731,27/05/2021,3,4,95,68,27,52,0,0
451,27/05/2021,3,2,81,44,37,140,0,0
674,26/05/2021,3,1,97,43,54,49,0,0
555,29/05/2021,3,0,117,117,0,NA,NA,NA
15,29/05/2021,3,0,31,31,0,NA,NA,NA
79,29/05/2021,3,1,45,45,0,NA,NA,NA
362,29/05/2021,3,3,117,95,22,129,0,0
365,29/05/2021,3,0,68,68,0,NA,NA,NA
332,30/05/2021,3,0,40,23,17,49,0,0
582,26/05/2021,3,1,52,36,16,143,0,0
384,26/05/2021,3,0,101,77,24,64,0,0
143,29/05/2021,3,1,119,119,0,NA,NA,NA
530,29/05/2021,3,1,59,59,0,NA,NA,NA
818,29/05/2021,3,1,80,80,0,NA,NA,NA
850,25/05/2021,3,1,82,71,11,82,0,0
418,27/05/2021,3,0,116,50,66,49,0,0
103,28/05/2021,3,0,161,162,-1,NA,NA,NA
513,30/05/2021,3,3,74,65,9,65,0,0
779,28/05/2021,3,0,104,99,5,79,0,0
403,24/05/2021,3,3,95,56,39,74,0,0
426,30/05/2021,3,7,156,154,2,65,0,0
860,27/05/2021,3,0,92,69,23,49,0,0
449,25/05/2021,3,1,94,24,70,90,0,0
495,27/05/2021,3,1,84,36,48,49,0,0
212,28/05/2021,3,1,77,70,7,82,0,0
895,29/05/2021,3,0,69,69,0,NA,NA,NA
179,30/05/2021,3,1,91,37,54,49,0,0
723,28/05/2021,3,2,79,61,18,81,0,0
697,29/05/2021,3,1,108,107,1,102,0,0
504,28/05/2021,3,0,83,47,36,55,0,0
104,26/05/2021,3,2,60,50,10,85,0,0
346,29/05/2021,3,6,114,114,0,NA,NA,NA
595,25/05/2021,3,2,48,10,38,62,0,0
457,26/05/2021,3,1,62,42,20,67,0,0
578,29/05/2021,3,0,58,58,0,NA,NA,NA
503,29/05/2021,3,7,177,178,-1,NA,NA,NA
379,29/05/2021,3,8,279,277,2,136,0,0
771,27/05/2021,3,2,28,22,6,77,0,0
808,28/05/2021,3,2,166,166,0,NA,NA,NA
798,27/05/2021,3,1,80,58,22,95,0,0
115,25/05/2021,3,1,114,26,88,49,0,0
761,27/05/2021,3,2,81,35,46,49,0,0
802,27/05/2021,3,1,64,61,3,80,0,0
788,28/05/2021,3,2,89,89,0,NA,NA,NA
518,29/05/2021,3,0,17,17,0,NA,NA,NA
128,30/05/2021,3,1,20,20,0,NA,NA,NA
529,28/05/2021,3,3,38,36,2,83,0,0
569,28/05/2021,3,0,120,91,29,60,0,0
693,23/05/2021,3,3,122,25,97,49,0,0
205,28/05/2021,3,0,126,90,36,91,0,0
122,29/05/2021,3,3,118,119,-1,NA,NA,NA
853,28/05/2021,3,2,100,67,33,55,0,0
66,29/05/2021,3,0,152,152,0,NA,NA,NA
649,29/05/2021,3,2,62,60,2,170,0,0
787,30/05/2021,3,2,106,106,0,NA,NA,NA
70,29/05/2021,3,1,38,38,0,NA,NA,NA
794,29/05/2021,3,0,137,69,68,95,0,0
437,30/05/2021,3,3,162,120,42,52,0,0
759,30/05/2021,3,3,84,83,1,63,0,0
878,29/05/2021,3,0,218,13,205,44,0,0
233,28/05/2021,3,3,64,37,27,55,0,0
451,28/05/2021,3,2,81,64,17,180,0,0
35,27/05/2021,3,1,109,44,65,49,0,0
677,29/05/2021,3,0,40,40,0,NA,NA,NA
162,29/05/2021,3,1,121,121,0,NA,NA,NA
79,30/05/2021,3,1,45,45,0,NA,NA,NA
352,28/05/2021,3,0,64,53,11,74,0,0
593,29/05/2021,3,17,64,64,0,NA,NA,NA
648,30/05/2021,3,0,64,59,5,62,0,0
39,26/05/2021,3,1,60,36,24,64,0,0
384,27/05/2021,3,0,101,81,20,67,0,0
285,29/05/2021,3,0,80,80,0,NA,NA,NA
174,30/05/2021,3,4,24,24,0,NA,NA,NA
410,29/05/2021,3,0,56,56,0,NA,NA,NA
124,27/05/2021,3,0,54,38,16,60,0,0
632,26/05/2021,3,1,81,38,43,59,0,0
277,29/05/2021,3,6,66,67,-1,NA,NA,NA
810,28/05/2021,3,6,383,56,327,80,0,0
419,29/05/2021,3,19,91,93,-2,NA,NA,NA
218,27/05/2021,3,3,75,58,17,57,0,0
452,30/05/2021,3,2,58,54,4,74,0,0
177,28/05/2021,3,0,48,26,22,60,0,0
775,25/05/2021,3,4,105,48,57,49,0,0
843,28/05/2021,3,1,65,43,22,52,0,0
807,28/05/2021,3,1,99,77,22,67,0,0
400,29/05/2021,3,3,27,21,6,67,0,0
445,30/05/2021,3,1,168,106,62,49,0,0
815,28/05/2021,3,11,118,117,1,96,0,0
697,28/05/2021,3,2,107,81,26,74,0,0
586,26/05/2021,3,3,80,50,30,64,0,0
264,26/05/2021,3,1,59,37,22,60,0,0
845,29/05/2021,3,4,116,114,2,87,0,0
876,27/05/2021,3,7,175,54,121,45,0,0
663,25/05/2021,3,2,146,12,134,115,0,0
421,26/05/2021,3,0,19,19,0,NA,NA,NA
273,28/05/2021,3,0,103,103,0,NA,NA,NA
847,29/05/2021,3,6,191,62,129,35,0,0
645,27/05/2021,3,4,37,36,1,79,0,0
319,28/05/2021,3,6,108,108,0,NA,NA,NA
497,28/05/2021,3,4,189,178,11,74,0,0
344,28/05/2021,3,1,64,47,17,106,0,0
546,28/05/2021,3,11,141,129,12,67,0,0
244,29/05/2021,3,3,197,196,1,77,0,0
155,28/05/2021,3,0,93,75,18,85,0,0
422,27/05/2021,3,1,78,38,40,49,0,0
266,29/05/2021,3,0,61,61,0,NA,NA,NA
433,28/05/2021,3,2,316,174,142,100,0,0
569,30/05/2021,3,0,120,109,11,62,0,0
693,25/05/2021,3,2,123,21,102,49,0,0
749,27/05/2021,3,24,130,57,73,49,0,0
171,30/05/2021,3,2,47,45,2,83,0,0
898,28/05/2021,3,2,98,61,37,129,0,0
446,29/05/2021,3,8,125,125,0,NA,NA,NA
548,25/05/2021,3,1,90,85,5,77,0,0
521,29/05/2021,3,1,54,52,2,104,0,0
424,29/05/2021,3,1,27,27,0,NA,NA,NA
229,29/05/2021,3,4,52,55,-3,NA,NA,NA
560,29/05/2021,3,0,80,80,0,NA,NA,NA
704,27/05/2021,3,1,31,28,3,63,0,0
701,29/05/2021,3,2,60,60,0,NA,NA,NA
369,28/05/2021,3,3,87,42,45,58,0,0
917,29/05/2021,3,1,105,19,86,35,0,0
376,27/05/2021,3,1,63,55,8,67,0,0
792,29/05/2021,3,0,102,102,0,NA,NA,NA
512,29/05/2021,3,1,61,61,0,NA,NA,NA
217,29/05/2021,3,0,41,41,0,NA,NA,NA
714,29/05/2021,3,0,59,54,5,110,0,0
131,30/05/2021,3,2,47,47,0,NA,NA,NA
776,30/05/2021,3,0,104,51,53,49,0,0
39,29/05/2021,3,1,60,59,1,84,0,0
215,28/05/2021,3,0,46,16,30,55,0,0
626,29/05/2021,3,4,98,98,0,NA,NA,NA
38,29/05/2021,3,2,48,48,0,NA,NA,NA
820,29/05/2021,3,0,127,127,0,NA,NA,NA
289,26/05/2021,3,2,66,38,28,67,0,0
60,27/05/2021,3,0,57,40,17,72,0,0
257,27/05/2021,3,1,43,43,0,NA,NA,NA
576,29/05/2021,3,1,57,57,0,NA,NA,NA
254,29/05/2021,3,1,77,77,0,NA,NA,NA
603,27/05/2021,3,0,84,42,42,60,0,0
691,29/05/2021,3,1,31,20,11,123,0,0
480,27/05/2021,3,0,28,16,12,52,0,0
775,26/05/2021,3,4,105,47,58,49,0,0
843,26/05/2021,3,1,65,40,25,74,0,0
807,29/05/2021,3,2,98,97,1,90,0,0
28,29/05/2021,3,2,126,125,1,147,0,0
641,30/05/2021,3,0,160,137,23,57,0,0
460,29/05/2021,3,9,100,90,10,85,0,0
859,29/05/2021,3,1,84,84,0,NA,NA,NA
883,26/05/2021,3,6,98,21,77,45,0,0
688,27/05/2021,3,3,116,101,15,62,0,0
363,27/05/2021,3,5,94,93,1,59,0,0
44,28/05/2021,3,5,103,99,4,141,0,0
663,28/05/2021,3,13,135,106,29,74,0,0
421,27/05/2021,3,0,19,19,0,NA,NA,NA
377,29/05/2021,3,0,149,149,0,NA,NA,NA
847,30/05/2021,3,3,194,54,140,35,0,0
606,25/05/2021,3,1,45,20,25,52,0,0
891,28/05/2021,3,12,70,70,0,NA,NA,NA
798,28/05/2021,3,1,80,78,2,97,0,0
344,25/05/2021,3,1,64,45,19,63,0,0
682,28/05/2021,3,2,78,75,3,74,0,0
95,27/05/2021,3,0,88,65,23,57,0,0
178,28/05/2021,3,0,38,20,18,55,0,0
760,27/05/2021,3,1,35,31,4,62,0,0
836,29/05/2021,3,0,101,101,0,NA,NA,NA
394,29/05/2021,3,0,68,66,2,74,0,0
650,30/05/2021,3,2,126,111,15,65,0,0
302,24/05/2021,3,0,61,45,16,49,0,0
246,27/05/2021,3,2,110,42,68,49,0,0
852,28/05/2021,3,0,80,72,8,82,0,0
853,30/05/2021,3,2,100,87,13,62,0,0
666,29/05/2021,3,2,64,64,0,NA,NA,NA
169,26/05/2021,3,1,19,13,6,64,0,0
734,30/05/2021,3,1,60,51,9,62,0,0
829,29/05/2021,3,0,150,150,0,NA,NA,NA
746,30/05/2021,3,3,57,58,-1,NA,NA,NA
525,29/05/2021,3,1,74,74,0,NA,NA,NA
704,30/05/2021,3,1,31,29,2,70,0,0
701,28/05/2021,3,2,60,59,1,70,0,0
731,28/05/2021,3,5,94,58,36,52,0,0
228,27/05/2021,3,2,40,14,26,49,0,0
919,27/05/2021,3,11,112,85,27,60,0,0
507,29/05/2021,3,4,196,196,0,NA,NA,NA
683,29/05/2021,3,1,65,65,0,NA,NA,NA
311,29/05/2021,3,0,97,97,0,NA,NA,NA
136,28/05/2021,3,0,128,128,0,NA,NA,NA
271,29/05/2021,3,0,70,70,0,NA,NA,NA
287,30/05/2021,3,1,122,54,68,49,0,0
126,26/05/2021,3,1,119,90,29,62,0,0
219,29/05/2021,3,9,68,54,14,60,0,0
220,30/05/2021,3,6,97,97,0,NA,NA,NA
679,30/05/2021,3,0,89,89,0,NA,NA,NA
410,30/05/2021,3,0,56,56,0,NA,NA,NA
604,23/05/2021,3,0,82,47,35,56,0,0
235,27/05/2021,3,4,153,51,102,49,0,0
314,29/05/2021,3,1,68,68,0,NA,NA,NA
812,30/05/2021,3,16,121,121,0,NA,NA,NA
867,29/05/2021,3,1,59,59,0,NA,NA,NA
715,26/05/2021,3,0,88,73,15,85,0,0
275,28/05/2021,3,0,117,111,6,79,0,0
250,29/05/2021,3,0,115,78,37,72,0,0
793,26/05/2021,3,2,129,28,101,69,0,0
82,28/05/2021,3,1,95,85,10,70,0,0
338,28/05/2021,3,4,396,122,274,49,0,0
28,30/05/2021,3,2,126,103,23,62,0,0
156,29/05/2021,3,0,148,132,16,111,0,0
466,29/05/2021,3,5,135,120,15,57,0,0
29,29/05/2021,3,0,54,0,54,NA,NA,NA
702,28/05/2021,3,1,49,45,4,77,0,0
272,26/05/2021,3,1,126,52,74,49,0,0
208,28/05/2021,3,0,60,47,13,67,0,0
595,23/05/2021,3,2,48,11,37,49,0,0
463,30/05/2021,3,8,155,121,34,85,0,0
469,29/05/2021,3,2,194,129,65,105,0,0
336,28/05/2021,3,1,73,73,0,NA,NA,NA
896,21/05/2021,3,0,82,82,0,NA,NA,NA
773,25/05/2021,3,1,73,61,12,80,0,0
98,29/05/2021,3,3,92,92,0,NA,NA,NA
585,29/05/2021,3,2,58,57,1,161,0,0
428,26/05/2021,3,2,90,55,35,55,0,0
447,28/05/2021,3,0,143,98,45,62,0,0
95,28/05/2021,3,0,88,87,1,89,0,0
178,30/05/2021,3,0,38,33,5,62,0,0
92,29/05/2021,3,1,121,111,10,67,0,0
138,30/05/2021,3,0,98,98,0,NA,NA,NA
209,30/05/2021,3,1,113,111,2,79,0,0
137,30/05/2021,3,25,121,119,2,70,0,0
727,22/05/2021,3,0,75,74,1,117,0,0
737,27/05/2021,3,2,40,17,23,49,0,0
370,29/05/2021,3,0,40,28,12,118,0,0
300,26/05/2021,3,0,210,98,112,55,0,0
182,29/05/2021,3,2,78,78,0,NA,NA,NA
548,27/05/2021,3,1,90,70,20,62,0,0
230,30/05/2021,3,1,79,57,22,52,0,0
780,29/05/2021,3,0,60,60,0,NA,NA,NA
229,30/05/2021,3,2,54,55,-1,NA,NA,NA
4,30/05/2021,3,1,63,63,0,NA,NA,NA
47,26/05/2021,3,0,57,46,11,80,0,0
660,29/05/2021,3,6,180,76,104,49,0,0
748,28/05/2021,3,8,136,72,64,55,0,0
183,27/05/2021,3,0,80,32,48,64,0,0
674,27/05/2021,3,1,97,73,24,52,0,0
608,29/05/2021,3,12,128,128,0,NA,NA,NA
162,30/05/2021,3,1,121,121,0,NA,NA,NA
566,30/05/2021,3,0,75,75,0,NA,NA,NA
110,28/05/2021,3,1,86,77,9,67,0,0
689,29/05/2021,3,0,130,130,0,NA,NA,NA
42,30/05/2021,3,0,99,85,14,57,0,0
134,26/05/2021,3,1,47,37,10,79,0,0
219,30/05/2021,3,8,69,35,34,49,0,0
857,30/05/2021,3,3,207,207,0,NA,NA,NA
821,30/05/2021,3,1,78,78,0,NA,NA,NA
830,29/05/2021,3,0,66,66,0,NA,NA,NA
144,24/05/2021,3,1,98,36,62,49,0,0
675,27/05/2021,3,1,55,25,30,55,0,0
709,27/05/2021,3,0,83,73,10,77,0,0
576,28/05/2021,3,1,57,35,22,55,0,0
65,28/05/2021,3,0,78,54,24,60,0,0
322,25/05/2021,3,3,97,28,69,49,0,0
452,28/05/2021,3,2,58,56,2,79,0,0
767,27/05/2021,3,1,66,44,22,67,0,0
41,25/05/2021,3,2,82,57,25,80,0,0
495,25/05/2021,3,1,84,32,52,49,0,0
212,30/05/2021,3,1,77,52,25,72,0,0
305,30/05/2021,3,5,54,53,1,70,0,0
455,30/05/2021,3,3,248,73,175,70,0,0
466,27/05/2021,3,2,138,59,79,49,0,0
29,26/05/2021,3,0,54,0,54,NA,NA,NA
477,26/05/2021,3,5,115,34,81,49,0,0
83,26/05/2021,3,9,159,101,58,95,0,0
845,28/05/2021,3,3,117,45,72,55,0,0
595,26/05/2021,3,2,48,19,29,49,0,0
840,25/05/2021,3,3,309,101,208,49,0,0
24,29/05/2021,3,0,84,86,-2,NA,NA,NA
283,29/05/2021,3,1,75,75,0,NA,NA,NA
819,21/05/2021,3,0,80,80,0,NA,NA,NA
606,26/05/2021,3,1,45,34,11,63,0,0
313,29/05/2021,3,0,31,31,0,NA,NA,NA
105,28/05/2021,3,6,69,68,1,81,0,0
428,28/05/2021,3,2,90,64,26,57,0,0
447,24/05/2021,3,1,142,135,7,85,0,0
37,28/05/2021,3,1,80,49,31,55,0,0
54,28/05/2021,3,1,60,51,9,74,0,0
204,28/05/2021,3,0,64,35,29,79,0,0
51,28/05/2021,3,2,78,78,0,NA,NA,NA
467,29/05/2021,3,2,110,40,70,100,0,0
569,29/05/2021,3,0,120,119,1,89,0,0
908,23/05/2021,3,0,136,41,95,49,0,0
533,27/05/2021,3,1,90,17,73,49,0,0
278,28/05/2021,3,0,105,28,77,49,0,0
397,27/05/2021,3,0,75,53,22,60,0,0
784,28/05/2021,3,2,47,47,0,NA,NA,NA
169,27/05/2021,3,1,19,17,2,115,0,0
6,29/05/2021,3,22,168,93,75,55,0,0
409,29/05/2021,3,6,101,104,-3,NA,NA,NA
456,29/05/2021,3,11,79,83,-4,NA,NA,NA
226,29/05/2021,3,0,47,47,0,NA,NA,NA
18,28/05/2021,3,2,90,70,20,74,0,0
265,27/05/2021,3,1,56,33,23,49,0,0
685,29/05/2021,3,5,135,134,1,103,0,0
617,27/05/2021,3,0,44,32,12,60,0,0
919,25/05/2021,3,19,104,89,15,74,0,0
809,29/05/2021,3,2,99,99,0,NA,NA,NA
399,30/05/2021,3,1,60,61,-1,NA,NA,NA
311,30/05/2021,3,0,97,97,0,NA,NA,NA
506,28/05/2021,3,1,194,137,57,60,0,0
190,29/05/2021,3,5,75,73,2,119,0,0
776,29/05/2021,3,0,104,100,4,74,0,0
706,26/05/2021,3,1,73,48,25,64,0,0
349,27/05/2021,3,6,84,78,6,77,0,0
34,29/05/2021,3,2,86,63,23,52,0,0
316,29/05/2021,3,2,37,37,0,NA,NA,NA
830,30/05/2021,3,0,66,66,0,NA,NA,NA
842,25/05/2021,3,2,89,41,48,101,0,0
418,28/05/2021,3,0,116,63,53,55,0,0
32,27/05/2021,3,1,104,74,30,79,0,0
63,30/05/2021,3,1,63,37,26,49,0,0
789,28/05/2021,3,0,72,61,11,87,0,0
218,26/05/2021,3,3,75,46,29,49,0,0
861,28/05/2021,3,0,61,47,14,161,0,0
767,28/05/2021,3,1,66,65,1,79,0,0
671,26/05/2021,3,1,64,52,12,124,0,0
495,26/05/2021,3,1,84,34,50,49,0,0
493,28/05/2021,3,1,34,20,14,55,0,0
187,30/05/2021,3,2,39,38,1,115,0,0
494,30/05/2021,3,2,137,101,36,57,0,0
890,27/05/2021,3,5,145,42,103,79,0,0
29,28/05/2021,3,0,54,0,54,NA,NA,NA
795,26/05/2021,3,6,99,62,37,64,0,0
112,26/05/2021,3,0,84,71,13,62,0,0
483,27/05/2021,3,6,93,54,39,49,0,0
874,26/05/2021,3,2,87,18,69,49,0,0
840,26/05/2021,3,3,309,102,207,49,0,0
517,28/05/2021,3,1,57,35,22,55,0,0
336,29/05/2021,3,1,73,73,0,NA,NA,NA
819,22/05/2021,3,0,80,80,0,NA,NA,NA
771,26/05/2021,3,2,28,21,7,77,0,0
508,29/05/2021,3,1,79,79,0,NA,NA,NA
298,29/05/2021,3,2,227,140,87,60,0,0
616,26/05/2021,3,2,73,58,15,90,0,0
471,24/05/2021,3,7,113,91,22,67,0,0
95,29/05/2021,3,0,88,69,19,104,0,0
279,29/05/2021,3,1,56,52,4,88,0,0
202,27/05/2021,3,0,76,57,19,98,0,0
51,30/05/2021,3,2,78,78,0,NA,NA,NA
529,29/05/2021,3,3,38,37,1,119,0,0
575,28/05/2021,3,1,49,35,14,60,0,0
908,26/05/2021,3,0,136,64,72,49,0,0
87,29/05/2021,3,43,75,52,23,79,0,0
745,28/05/2021,3,1,104,65,39,55,0,0
670,27/05/2021,3,0,108,83,25,128,0,0
416,28/05/2021,3,0,34,21,13,55,0,0
747,28/05/2021,3,1,63,42,21,60,0,0
539,30/05/2021,3,3,94,83,11,62,0,0
424,28/05/2021,3,1,27,27,0,NA,NA,NA
673,29/05/2021,3,4,119,119,0,NA,NA,NA
657,29/05/2021,3,0,48,48,0,NA,NA,NA
236,27/05/2021,3,3,116,10,106,49,0,0
111,25/05/2021,3,0,60,59,1,90,0,0
487,28/05/2021,3,0,39,19,20,67,0,0
617,28/05/2021,3,0,44,19,25,55,0,0
919,26/05/2021,3,19,104,87,17,67,0,0
687,29/05/2021,3,2,85,85,0,NA,NA,NA
825,30/05/2021,3,2,144,144,0,NA,NA,NA
797,30/05/2021,3,0,67,67,0,NA,NA,NA
431,28/05/2021,3,3,127,109,18,80,0,0
342,30/05/2021,3,0,114,57,57,49,0,0
589,30/05/2021,3,4,139,107,32,57,0,0
543,27/05/2021,3,1,64,55,9,113,0,0
219,27/05/2021,3,5,72,39,33,49,0,0
206,29/05/2021,3,16,197,54,143,59,0,0
357,29/05/2021,3,1,82,82,0,NA,NA,NA
667,29/05/2021,3,0,10,0,10,NA,NA,NA
850,23/05/2021,3,1,82,58,24,64,0,0
632,28/05/2021,3,1,81,34,47,55,0,0
837,27/05/2021,3,4,322,43,279,85,0,0
26,28/05/2021,3,2,64,19,45,55,0,0
20,28/05/2021,3,1,81,75,6,69,0,0
509,26/05/2021,3,1,111,76,35,52,0,0
52,28/05/2021,3,19,123,119,4,87,0,0
860,28/05/2021,3,1,91,79,12,67,0,0
722,23/05/2021,3,0,42,32,10,52,0,0
82,27/05/2021,3,1,95,82,13,85,0,0
304,28/05/2021,3,0,60,55,5,118,0,0
400,30/05/2021,3,3,27,26,1,62,0,0
653,30/05/2021,3,3,112,52,60,49,0,0
466,28/05/2021,3,3,137,58,79,49,0,0
29,27/05/2021,3,0,54,0,54,NA,NA,NA
406,27/05/2021,3,1,38,37,1,89,0,0
408,26/05/2021,3,5,160,42,118,55,0,0
618,27/05/2021,3,12,139,69,70,49,0,0
719,22/05/2021,3,0,41,21,20,115,0,0
453,28/05/2021,3,2,136,84,52,49,0,0
517,29/05/2021,3,1,57,53,4,74,0,0
405,29/05/2021,3,1,89,89,0,NA,NA,NA
470,20/05/2021,3,4,76,78,-2,NA,NA,NA
606,27/05/2021,3,3,43,39,4,65,0,0
698,28/05/2021,3,3,113,97,16,74,0,0
157,28/05/2021,3,1,82,71,11,105,0,0
542,27/05/2021,3,2,73,55,18,57,0,0
303,24/05/2021,3,2,63,42,21,59,0,0
59,28/05/2021,3,6,69,30,39,55,0,0
735,29/05/2021,3,1,28,26,2,89,0,0
642,28/05/2021,3,2,93,81,12,67,0,0
875,30/05/2021,3,2,90,91,-1,NA,NA,NA
12,30/05/2021,3,1,42,28,14,49,0,0
758,28/05/2021,3,0,73,59,14,90,0,0
367,21/05/2021,3,0,74,41,33,58,0,0
737,28/05/2021,3,2,40,28,12,55,0,0
71,28/05/2021,3,1,61,40,21,55,0,0
670,26/05/2021,3,0,108,71,37,151,0,0
267,28/05/2021,3,1,82,45,37,55,0,0
548,28/05/2021,3,1,90,80,10,74,0,0
6,30/05/2021,3,22,168,62,106,49,0,0
711,29/05/2021,3,1,88,88,0,NA,NA,NA
456,30/05/2021,3,8,82,82,0,NA,NA,NA
226,30/05/2021,3,0,47,47,0,NA,NA,NA
18,29/05/2021,3,2,90,90,0,NA,NA,NA
111,27/05/2021,3,0,60,49,11,85,0,0
440,29/05/2021,3,0,265,126,139,100,0,0
106,27/05/2021,3,1,30,26,4,82,0,0
372,27/05/2021,3,19,73,65,8,95,0,0
119,30/05/2021,3,2,66,66,0,NA,NA,NA
15,30/05/2021,3,0,31,32,-1,NA,NA,NA
293,30/05/2021,3,4,56,47,9,62,0,0
832,28/05/2021,3,3,97,44,53,55,0,0
526,29/05/2021,3,0,38,36,2,119,0,0
17,30/05/2021,3,1,93,86,7,62,0,0
543,29/05/2021,3,1,64,63,1,199,0,0
219,28/05/2021,3,5,72,36,36,55,0,0
432,29/05/2021,3,0,165,86,79,100,0,0
559,29/05/2021,3,44,141,141,0,NA,NA,NA
667,30/05/2021,3,0,10,0,10,NA,NA,NA
144,26/05/2021,3,1,98,41,57,52,0,0
681,26/05/2021,3,7,64,62,2,89,0,0
176,29/05/2021,3,3,97,92,5,79,0,0
63,29/05/2021,3,6,58,48,10,67,0,0
207,28/05/2021,3,2,61,53,8,74,0,0
603,24/05/2021,3,0,84,33,51,60,0,0
426,28/05/2021,3,8,155,125,30,75,0,0
366,27/05/2021,3,4,76,68,8,102,0,0
722,25/05/2021,3,0,42,41,1,123,0,0
328,23/05/2021,3,4,94,50,44,66,0,0
338,29/05/2021,3,4,396,188,208,49,0,0
276,30/05/2021,3,1,203,89,114,49,0,0
455,29/05/2021,3,3,248,65,183,100,0,0
64,27/05/2021,3,3,244,35,209,49,0,0
549,26/05/2021,3,0,61,0,61,NA,NA,NA
702,27/05/2021,3,1,49,33,16,60,0,0
479,26/05/2021,3,2,53,27,26,55,0,0
664,27/05/2021,3,13,142,126,16,65,0,0
719,28/05/2021,3,0,41,31,10,81,0,0
457,28/05/2021,3,2,61,33,28,49,0,0
694,28/05/2021,3,2,107,79,28,52,0,0
273,30/05/2021,3,0,103,103,0,NA,NA,NA
470,19/05/2021,3,2,78,78,0,NA,NA,NA
388,25/05/2021,3,1,59,38,21,84,0,0
508,28/05/2021,3,2,78,67,11,67,0,0
7,28/05/2021,3,3,100,23,77,55,0,0
933,25/05/2021,3,87,60,17,43,35,0,0
447,26/05/2021,3,0,143,120,23,85,0,0
195,29/05/2021,3,1,50,48,2,74,0,0
54,29/05/2021,3,1,60,56,4,145,0,0
782,27/05/2021,3,0,20,15,5,80,0,0
321,28/05/2021,3,1,39,30,9,67,0,0
173,30/05/2021,3,1,70,52,18,52,0,0
430,28/05/2021,3,2,87,71,16,64,0,0
367,24/05/2021,3,0,74,23,51,68,0,0
631,28/05/2021,3,1,70,25,45,55,0,0
71,30/05/2021,3,0,62,49,13,57,0,0
557,26/05/2021,3,0,104,73,31,55,0,0
281,29/05/2021,3,1,82,80,2,84,0,0
297,25/05/2021,3,1,75,47,28,55,0,0
325,30/05/2021,3,0,45,43,2,81,0,0
409,27/05/2021,3,8,99,72,27,52,0,0
524,29/05/2021,3,2,108,108,0,NA,NA,NA
657,30/05/2021,3,0,48,48,0,NA,NA,NA
154,29/05/2021,3,3,101,101,0,NA,NA,NA
660,28/05/2021,3,6,180,35,145,49,0,0
263,28/05/2021,3,0,66,52,14,67,0,0
755,28/05/2021,3,0,87,76,11,138,0,0
674,25/05/2021,3,1,97,44,53,49,0,0
145,29/05/2021,3,5,53,53,0,NA,NA,NA
247,30/05/2021,3,2,91,91,0,NA,NA,NA
356,29/05/2021,3,1,135,133,2,129,0,0
574,28/05/2021,3,11,76,53,23,55,0,0
342,29/05/2021,3,0,114,67,47,67,0,0
147,29/05/2021,3,1,79,78,1,79,0,0
199,26/05/2021,3,3,79,71,8,74,0,0
349,29/05/2021,3,5,85,83,2,79,0,0
285,30/05/2021,3,0,80,77,3,62,0,0
107,30/05/2021,3,1,88,88,0,NA,NA,NA
327,29/05/2021,3,19,49,49,0,NA,NA,NA
30,27/05/2021,3,1,70,52,18,189,0,0
383,27/05/2021,3,3,82,80,2,89,0,0
835,29/05/2021,3,5,99,98,1,149,0,0
812,28/05/2021,3,2,135,76,59,49,0,0
254,28/05/2021,3,1,77,62,15,49,0,0
603,26/05/2021,3,0,84,34,50,67,0,0
326,29/05/2021,3,3,78,75,3,84,0,0
429,27/05/2021,3,2,123,45,78,49,0,0
41,26/05/2021,3,2,82,56,26,72,0,0
328,24/05/2021,3,4,94,70,24,80,0,0
212,29/05/2021,3,1,77,75,2,82,0,0
276,29/05/2021,3,1,203,89,114,49,0,0
358,30/05/2021,3,1,92,90,2,70,0,0
64,29/05/2021,3,3,244,60,184,55,0,0
549,29/05/2021,3,0,61,0,61,NA,NA,NA
406,28/05/2021,3,1,38,27,11,105,0,0
272,28/05/2021,3,4,123,78,45,58,0,0
827,27/05/2021,3,1,69,60,9,84,0,0
577,26/05/2021,3,0,78,49,29,52,0,0
635,28/05/2021,3,0,88,64,24,60,0,0
651,30/05/2021,3,3,75,59,16,57,0,0
405,27/05/2021,3,1,89,53,36,52,0,0
573,22/05/2021,3,0,57,57,0,NA,NA,NA
116,27/05/2021,3,0,61,58,3,85,0,0
844,29/05/2021,3,0,61,25,36,90,0,0
166,28/05/2021,3,1,65,64,1,101,0,0
129,25/05/2021,3,13,187,119,68,49,0,0
682,26/05/2021,3,2,78,36,42,64,0,0
195,28/05/2021,3,1,50,33,17,55,0,0
237,29/05/2021,3,6,115,115,0,NA,NA,NA
202,28/05/2021,3,0,76,65,11,116,0,0
600,28/05/2021,3,0,50,45,5,96,0,0
173,28/05/2021,3,3,68,30,38,55,0,0
872,28/05/2021,3,1,64,48,16,93,0,0
908,24/05/2021,3,0,136,48,88,49,0,0
435,27/05/2021,3,53,67,37,30,55,0,0
753,30/05/2021,3,4,123,120,3,161,0,0
557,30/05/2021,3,0,104,60,44,52,0,0
666,28/05/2021,3,2,64,55,9,67,0,0
297,28/05/2021,3,1,75,42,33,55,0,0
364,29/05/2021,3,1,129,100,29,129,0,0
705,27/05/2021,3,3,88,70,18,52,0,0
673,30/05/2021,3,5,118,118,0,NA,NA,NA
806,29/05/2021,3,2,134,134,0,NA,NA,NA
221,29/05/2021,3,1,61,61,0,NA,NA,NA
514,30/05/2021,3,8,226,198,28,62,0,0
511,28/05/2021,3,0,76,61,15,67,0,0
228,28/05/2021,3,2,40,12,28,55,0,0
295,27/05/2021,3,2,103,30,73,49,0,0
200,29/05/2021,3,3,116,116,0,NA,NA,NA
247,29/05/2021,3,1,92,92,0,NA,NA,NA
217,28/05/2021,3,0,41,30,11,60,0,0
838,29/05/2021,3,4,61,60,1,157,0,0
184,30/05/2021,3,0,51,50,1,62,0,0
332,29/05/2021,3,0,40,39,1,67,0,0
126,27/05/2021,3,2,118,85,33,62,0,0
215,26/05/2021,3,1,45,38,7,80,0,0
626,30/05/2021,3,4,98,85,13,57,0,0
316,30/05/2021,3,2,37,37,0,NA,NA,NA
643,29/05/2021,3,2,101,101,0,NA,NA,NA
124,26/05/2021,3,0,54,48,6,84,0,0
534,27/05/2021,3,1,84,35,49,49,0,0
314,27/05/2021,3,2,67,37,30,49,0,0
810,30/05/2021,3,6,383,64,319,60,0,0
335,28/05/2021,3,4,82,43,39,49,0,0
403,25/05/2021,3,3,95,58,37,74,0,0
481,29/05/2021,3,0,56,54,2,123,0,0
232,28/05/2021,3,2,63,55,8,98,0,0
793,24/05/2021,3,3,128,28,100,50,0,0
359,27/05/2021,3,3,101,74,27,52,0,0
902,29/05/2021,3,2,124,119,5,74,0,0
423,30/05/2021,3,1,49,48,1,115,0,0
741,30/05/2021,3,1,69,53,16,52,0,0
88,28/05/2021,3,1,41,35,6,67,0,0
549,28/05/2021,3,0,61,0,61,NA,NA,NA
93,27/05/2021,3,2,139,50,89,49,0,0
408,27/05/2021,3,5,160,55,105,55,0,0
363,28/05/2021,3,3,96,87,9,113,0,0
874,23/05/2021,3,1,88,11,77,49,0,0
877,26/05/2021,3,0,158,73,85,35,0,0
425,26/05/2021,3,11,239,50,189,90,0,0
405,28/05/2021,3,1,89,79,10,74,0,0
896,18/05/2021,3,0,82,82,0,NA,NA,NA
291,26/05/2021,3,0,61,47,14,49,0,0
911,28/05/2021,3,0,158,73,85,55,0,0
105,27/05/2021,3,5,70,55,15,82,0,0
129,28/05/2021,3,11,189,188,1,82,0,0
8,27/05/2021,3,1,39,38,1,65,0,0
443,27/05/2021,3,3,87,60,27,64,0,0
318,29/05/2021,3,0,59,61,-2,NA,NA,NA
292,27/05/2021,3,0,239,60,179,49,0,0
266,28/05/2021,3,0,61,55,6,77,0,0
527,28/05/2021,3,5,56,47,9,77,0,0
575,29/05/2021,3,1,49,43,6,74,0,0
302,23/05/2021,3,0,61,35,26,49,0,0
625,28/05/2021,3,1,160,107,53,60,0,0
122,28/05/2021,3,3,118,87,31,90,0,0
851,30/05/2021,3,0,92,91,1,75,0,0
491,28/05/2021,3,5,174,147,27,60,0,0
726,28/05/2021,3,0,39,38,1,88,0,0
364,30/05/2021,3,1,129,100,29,94,0,0
614,26/05/2021,3,2,80,56,24,64,0,0
770,30/05/2021,3,2,33,33,0,NA,NA,NA
437,29/05/2021,3,3,162,162,0,NA,NA,NA
221,30/05/2021,3,1,61,61,0,NA,NA,NA
265,25/05/2021,3,1,56,23,33,52,0,0
263,27/05/2021,3,0,66,26,40,49,0,0
932,28/05/2021,3,26,81,10,71,45,0,0
627,30/05/2021,3,0,41,31,10,57,0,0
444,29/05/2021,3,4,115,115,0,NA,NA,NA
399,29/05/2021,3,1,60,60,0,NA,NA,NA
783,28/05/2021,3,1,79,79,0,NA,NA,NA
404,28/05/2021,3,0,67,50,17,122,0,0
271,30/05/2021,3,0,70,69,1,70,0,0
361,29/05/2021,3,52,13,12,1,129,0,0
199,27/05/2021,3,3,79,68,11,67,0,0
633,27/05/2021,3,1,49,41,8,62,0,0
206,30/05/2021,3,1,212,54,158,55,0,0
559,30/05/2021,3,73,112,112,0,NA,NA,NA
256,29/05/2021,3,1,108,107,1,90,0,0
604,28/05/2021,3,0,82,63,19,80,0,0
681,23/05/2021,3,4,67,69,-2,NA,NA,NA
831,27/05/2021,3,3,147,67,80,49,0,0
812,29/05/2021,3,5,132,131,1,65,0,0
676,29/05/2021,3,1,114,102,12,84,0,0
715,28/05/2021,3,1,87,60,27,103,0,0
481,23/05/2021,3,0,56,15,41,49,0,0
480,25/05/2021,3,0,28,18,10,72,0,0
671,30/05/2021,3,1,64,64,0,NA,NA,NA
261,22/05/2021,3,2,100,100,0,NA,NA,NA
330,28/05/2021,3,2,117,72,45,49,0,0
380,30/05/2021,3,1,159,145,14,63,0,0
201,30/05/2021,3,6,132,83,49,49,0,0
723,26/05/2021,3,3,78,67,11,189,0,0
549,27/05/2021,3,0,61,0,61,NA,NA,NA
889,30/05/2021,3,0,124,7,117,45,0,0
479,24/05/2021,3,2,53,38,15,57,0,0
483,28/05/2021,3,6,93,64,29,60,0,0
874,24/05/2021,3,1,88,11,77,49,0,0
140,26/05/2021,3,0,170,85,85,49,0,0
680,26/05/2021,3,3,77,29,48,49,0,0
395,28/05/2021,3,1,71,51,20,67,0,0
50,18/05/2021,3,2,119,59,60,49,0,0
552,29/05/2021,3,12,172,171,1,116,0,0
181,28/05/2021,3,0,34,31,3,67,0,0
125,30/05/2021,3,2,34,34,0,NA,NA,NA
616,30/05/2021,3,2,73,72,1,65,0,0
730,24/05/2021,3,1,74,28,46,49,0,0
244,28/05/2021,3,4,196,144,52,55,0,0
458,29/05/2021,3,2,179,201,-22,NA,NA,NA
754,27/05/2021,3,0,62,27,35,49,0,0
128,28/05/2021,3,1,20,19,1,87,0,0
496,23/05/2021,3,1,59,14,45,49,0,0
373,30/05/2021,3,1,102,97,5,63,0,0
908,29/05/2021,3,0,136,136,0,NA,NA,NA
205,27/05/2021,3,0,126,88,38,62,0,0
278,30/05/2021,3,0,105,41,64,49,0,0
48,28/05/2021,3,12,167,172,-5,NA,NA,NA
446,28/05/2021,3,7,126,72,54,49,0,0
297,21/05/2021,3,1,75,18,57,55,0,0
325,29/05/2021,3,0,45,39,6,118,0,0
717,29/05/2021,3,3,190,157,33,60,0,0
27,29/05/2021,3,0,78,78,0,NA,NA,NA
211,29/05/2021,3,2,58,58,0,NA,NA,NA
236,28/05/2021,3,3,116,63,53,55,0,0
823,27/05/2021,3,1,60,51,9,71,0,0
216,26/05/2021,3,1,57,49,8,65,0,0
228,26/05/2021,3,3,39,12,27,49,0,0
376,28/05/2021,3,1,63,61,2,77,0,0
145,30/05/2021,3,5,53,53,0,NA,NA,NA
462,26/05/2021,3,9,180,22,158,80,0,0
500,29/05/2021,3,6,73,73,0,NA,NA,NA
484,30/05/2021,3,0,40,40,0,NA,NA,NA
526,30/05/2021,3,0,38,32,6,70,0,0
287,28/05/2021,3,1,122,61,61,55,0,0
39,22/05/2021,3,1,60,51,9,67,0,0
564,28/05/2021,3,1,73,60,13,67,0,0
886,29/05/2021,3,1,151,115,36,53,0,0
679,28/05/2021,3,0,89,89,0,NA,NA,NA
203,30/05/2021,3,1,39,35,4,83,0,0
842,29/05/2021,3,2,89,61,28,136,0,0
383,23/05/2021,3,4,81,69,12,71,0,0
257,24/05/2021,3,1,43,43,0,NA,NA,NA
678,26/05/2021,3,0,44,0,44,NA,NA,NA
781,30/05/2021,3,2,81,81,0,NA,NA,NA
218,29/05/2021,3,3,75,72,3,134,0,0
691,23/05/2021,3,1,31,25,6,70,0,0
177,26/05/2021,3,0,48,16,32,59,0,0
671,28/05/2021,3,2,63,63,0,NA,NA,NA
328,22/05/2021,3,4,94,94,0,NA,NA,NA
493,23/05/2021,3,1,34,16,18,55,0,0
785,28/05/2021,3,17,93,93,0,NA,NA,NA
562,27/05/2021,3,1,67,56,11,62,0,0
803,25/05/2021,3,1,68,60,8,65,0,0
733,26/05/2021,3,0,100,29,71,49,0,0
795,29/05/2021,3,8,97,99,-2,NA,NA,NA
104,25/05/2021,3,1,61,54,7,85,0,0
725,26/05/2021,3,0,17,15,2,90,0,0
44,22/05/2021,3,4,104,104,0,NA,NA,NA
692,26/05/2021,3,0,87,46,41,52,0,0
24,27/05/2021,3,2,82,52,30,55,0,0
395,29/05/2021,3,1,71,60,11,89,0,0
23,19/05/2021,3,3,61,39,22,49,0,0
116,30/05/2021,3,0,61,61,0,NA,NA,NA
716,28/05/2021,3,0,104,67,37,52,0,0
157,30/05/2021,3,1,82,82,0,NA,NA,NA
344,30/05/2021,3,0,65,64,1,126,0,0
268,26/05/2021,3,3,75,54,21,72,0,0
309,25/05/2021,3,0,16,16,0,NA,NA,NA
735,28/05/2021,3,1,28,17,11,55,0,0
204,24/05/2021,3,0,64,14,50,49,0,0
163,29/05/2021,3,1,61,60,1,160,0,0
390,25/05/2021,3,2,134,66,68,49,0,0
872,25/05/2021,3,1,64,64,0,NA,NA,NA
536,29/05/2021,3,1,80,81,-1,NA,NA,NA
374,26/05/2021,3,1,55,49,6,85,0,0
171,26/05/2021,3,2,47,31,16,79,0,0
48,29/05/2021,3,12,167,174,-7,NA,NA,NA
267,30/05/2021,3,2,81,58,23,57,0,0
169,21/05/2021,3,1,19,16,3,79,0,0
284,28/05/2021,3,0,26,17,9,67,0,0
409,30/05/2021,3,5,102,65,37,52,0,0
587,28/05/2021,3,2,79,51,28,90,0,0
57,29/05/2021,3,1,139,139,0,NA,NA,NA
879,28/05/2021,3,4,160,34,126,39,0,0
391,25/05/2021,3,1,75,47,28,49,0,0
86,25/05/2021,3,1,47,32,15,74,0,0
932,25/05/2021,3,10,97,3,94,45,0,0
197,28/05/2021,3,0,118,53,65,55,0,0
133,29/05/2021,3,3,61,63,-2,NA,NA,NA
462,27/05/2021,3,10,179,13,166,75,0,0
783,29/05/2021,3,1,79,79,0,NA,NA,NA
404,30/05/2021,3,0,67,67,0,NA,NA,NA
365,26/05/2021,3,0,68,59,9,119,0,0
607,28/05/2021,3,1,74,73,1,77,0,0
341,22/05/2021,3,10,104,106,-2,NA,NA,NA
619,29/05/2021,3,1,100,91,9,74,0,0
432,26/05/2021,3,0,165,3,162,90,0,0
290,28/05/2021,3,2,105,93,12,67,0,0
158,28/05/2021,3,0,24,10,14,59,0,0
144,30/05/2021,3,1,98,96,2,75,0,0
658,23/05/2021,3,1,80,50,30,63,0,0
277,25/05/2021,3,4,68,50,18,111,0,0
678,27/05/2021,3,0,44,0,44,NA,NA,NA
20,30/05/2021,3,1,81,81,0,NA,NA,NA
403,29/05/2021,3,4,94,92,2,118,0,0
227,23/05/2021,3,2,42,21,21,49,0,0
588,26/05/2021,3,0,59,44,15,72,0,0
793,29/05/2021,3,4,127,127,0,NA,NA,NA
328,18/05/2021,3,2,96,49,47,59,0,0
493,22/05/2021,3,1,34,34,0,NA,NA,NA
305,26/05/2021,3,29,30,30,0,NA,NA,NA
455,28/05/2021,3,3,248,44,204,90,0,0
334,25/05/2021,3,1,57,33,24,74,0,0
859,27/05/2021,3,1,84,19,65,49,0,0
537,29/05/2021,3,3,99,99,0,NA,NA,NA
264,25/05/2021,3,1,59,36,23,55,0,0
21,25/05/2021,3,1,59,33,26,62,0,0
44,29/05/2021,3,3,105,105,0,NA,NA,NA
877,25/05/2021,3,0,158,69,89,35,0,0
425,27/05/2021,3,11,239,36,203,85,0,0
283,30/05/2021,3,1,75,54,21,57,0,0
847,18/05/2021,3,4,193,62,131,35,0,0
771,29/05/2021,3,2,28,28,0,NA,NA,NA
913,26/05/2021,3,0,105,23,82,116,0,0
166,30/05/2021,3,1,65,65,0,NA,NA,NA
542,29/05/2021,3,2,73,65,8,123,0,0
22,27/05/2021,3,0,64,60,4,85,0,0
309,26/05/2021,3,0,16,16,0,NA,NA,NA
478,27/05/2021,3,0,20,20,0,NA,NA,NA
518,24/05/2021,3,1,16,13,3,85,0,0
417,26/05/2021,3,0,103,63,40,52,0,0
142,23/05/2021,3,2,60,58,2,74,0,0
373,26/05/2021,3,1,102,102,0,NA,NA,NA
536,30/05/2021,3,1,80,81,-1,NA,NA,NA
435,26/05/2021,3,52,68,43,25,64,0,0
171,25/05/2021,3,2,47,41,6,86,0,0
48,30/05/2021,3,6,173,174,-1,NA,NA,NA
66,30/05/2021,3,2,150,92,58,49,0,0
649,22/05/2021,3,2,62,61,1,159,0,0
521,28/05/2021,3,1,54,50,4,74,0,0
717,30/05/2021,3,3,190,144,46,52,0,0
149,28/05/2021,3,0,88,71,17,67,0,0
669,29/05/2021,3,1,86,86,0,NA,NA,NA
879,29/05/2021,3,4,160,43,117,39,0,0
1,30/05/2021,3,2,98,52,46,49,0,0
233,25/05/2021,3,3,64,51,13,95,0,0
106,25/05/2021,3,1,30,20,10,82,0,0
295,28/05/2021,3,2,103,53,50,55,0,0
581,29/05/2021,3,48,177,188,-11,NA,NA,NA
269,28/05/2021,3,0,80,27,53,55,0,0
356,28/05/2021,3,1,135,93,42,55,0,0
584,30/05/2021,3,0,97,97,0,NA,NA,NA
259,26/05/2021,3,0,60,51,9,169,0,0
332,27/05/2021,3,0,40,18,22,55,0,0
199,25/05/2021,3,2,80,79,1,83,0,0
564,30/05/2021,3,1,73,68,5,70,0,0
750,28/05/2021,3,4,108,108,0,NA,NA,NA
38,28/05/2021,3,2,48,48,0,NA,NA,NA
327,28/05/2021,3,18,50,50,0,NA,NA,NA
124,30/05/2021,3,0,54,43,11,57,0,0
383,25/05/2021,3,4,81,62,19,82,0,0
277,26/05/2021,3,4,68,47,21,76,0,0
678,24/05/2021,3,0,44,0,44,NA,NA,NA
130,30/05/2021,3,1,80,80,0,NA,NA,NA
715,29/05/2021,3,1,87,86,1,140,0,0
861,23/05/2021,3,0,61,58,3,129,0,0
108,25/05/2021,3,0,78,48,30,62,0,0
602,29/05/2021,3,0,64,64,0,NA,NA,NA
843,18/05/2021,3,2,64,46,18,62,0,0
304,22/05/2021,3,2,58,55,3,94,0,0
305,27/05/2021,3,25,34,34,0,NA,NA,NA
653,27/05/2021,3,3,112,31,81,49,0,0
520,26/05/2021,3,1,57,29,28,79,0,0
188,26/05/2021,3,7,114,71,43,52,0,0
406,30/05/2021,3,1,38,38,0,NA,NA,NA
899,25/05/2021,3,1,104,57,47,141,0,0
31,26/05/2021,3,2,61,22,39,49,0,0
532,30/05/2021,3,0,84,84,0,NA,NA,NA
635,25/05/2021,3,0,88,50,38,49,0,0
425,28/05/2021,3,10,240,58,182,90,0,0
395,30/05/2021,3,1,71,45,26,52,0,0
573,19/05/2021,3,0,57,39,18,67,0,0
331,30/05/2021,3,12,82,82,0,NA,NA,NA
911,26/05/2021,3,0,158,8,150,49,0,0
585,30/05/2021,3,2,58,58,0,NA,NA,NA
616,29/05/2021,3,2,73,63,10,77,0,0
303,27/05/2021,3,2,63,41,22,72,0,0
195,25/05/2021,3,1,50,30,20,49,0,0
318,26/05/2021,3,0,59,48,11,109,0,0
464,25/05/2021,3,1,265,46,219,90,0,0
600,27/05/2021,3,0,50,37,13,89,0,0
173,25/05/2021,3,2,69,49,20,67,0,0
872,26/05/2021,3,1,64,64,0,NA,NA,NA
727,28/05/2021,3,0,75,75,0,NA,NA,NA
749,25/05/2021,3,19,135,38,97,49,0,0
710,25/05/2021,3,0,20,14,6,64,0,0
540,30/05/2021,3,2,80,80,0,NA,NA,NA
790,30/05/2021,3,0,99,97,2,95,0,0
720,21/05/2021,3,0,39,29,10,81,0,0
234,26/05/2021,3,2,60,37,23,57,0,0
866,29/05/2021,3,14,86,80,6,113,0,0
547,28/05/2021,3,0,74,72,2,146,0,0
525,26/05/2021,3,1,74,62,12,77,0,0
154,26/05/2021,3,2,102,58,44,49,0,0
878,28/05/2021,3,0,218,13,205,44,0,0
233,26/05/2021,3,3,64,53,11,142,0,0
262,25/05/2021,3,1,50,43,7,74,0,0
639,28/05/2021,3,0,59,40,19,74,0,0
231,29/05/2021,3,0,41,40,1,107,0,0
654,26/05/2021,3,6,53,11,42,95,0,0
566,28/05/2021,3,0,75,41,34,55,0,0
598,30/05/2021,3,0,146,146,0,NA,NA,NA
271,26/05/2021,3,0,70,65,5,79,0,0
198,28/05/2021,3,42,93,93,0,NA,NA,NA
126,25/05/2021,3,1,119,87,32,62,0,0
215,29/05/2021,3,1,45,37,8,74,0,0
84,28/05/2021,3,0,20,20,0,NA,NA,NA
530,28/05/2021,3,1,59,59,0,NA,NA,NA
818,28/05/2021,3,1,80,80,0,NA,NA,NA
842,30/05/2021,3,2,89,66,23,72,0,0
675,25/05/2021,3,1,55,44,11,123,0,0
434,26/05/2021,3,3,57,47,10,63,0,0
678,25/05/2021,3,0,44,0,44,NA,NA,NA
592,30/05/2021,3,1,83,83,0,NA,NA,NA
764,29/05/2021,3,2,67,66,1,74,0,0
227,24/05/2021,3,2,42,23,19,49,0,0
588,25/05/2021,3,0,59,54,5,80,0,0
722,29/05/2021,3,0,42,42,0,NA,NA,NA
261,21/05/2021,3,2,100,91,9,79,0,0
411,21/05/2021,3,0,185,185,0,NA,NA,NA
305,28/05/2021,3,15,44,49,-5,NA,NA,NA
562,26/05/2021,3,1,67,62,5,63,0,0
101,25/05/2021,3,1,59,37,22,67,0,0
601,26/05/2021,3,5,63,48,15,65,0,0
537,30/05/2021,3,3,99,99,0,NA,NA,NA
804,23/05/2021,3,3,142,42,100,49,0,0
725,25/05/2021,3,0,17,16,1,130,0,0
532,29/05/2021,3,0,84,84,0,NA,NA,NA
655,25/05/2021,3,0,72,47,25,82,0,0
425,29/05/2021,3,7,243,96,147,100,0,0
395,26/05/2021,3,2,70,54,16,63,0,0
819,18/05/2021,3,0,80,79,1,168,0,0
771,30/05/2021,3,2,28,28,0,NA,NA,NA
319,26/05/2021,3,6,108,104,4,115,0,0
123,30/05/2021,3,0,95,36,59,49,0,0
933,29/05/2021,3,89,58,1,57,35,0,0
8,28/05/2021,3,1,39,35,4,68,0,0
161,25/05/2021,3,1,60,41,19,88,0,0
788,26/05/2021,3,2,89,58,31,102,0,0
518,25/05/2021,3,1,16,11,5,74,0,0
163,27/05/2021,3,2,60,52,8,85,0,0
12,25/05/2021,3,1,42,29,13,63,0,0
872,27/05/2021,3,1,64,41,23,80,0,0
727,29/05/2021,3,0,75,75,0,NA,NA,NA
246,25/05/2021,3,1,111,29,82,49,0,0
370,25/05/2021,3,0,40,17,23,136,0,0
557,29/05/2021,3,0,104,104,0,NA,NA,NA
882,30/05/2021,3,0,130,42,88,39,0,0
548,21/05/2021,3,0,91,89,2,79,0,0
118,26/05/2021,3,2,57,10,47,49,0,0
409,26/05/2021,3,7,100,71,29,57,0,0
456,28/05/2021,3,9,81,67,14,67,0,0
368,28/05/2021,3,1,84,58,26,68,0,0
221,27/05/2021,3,0,62,25,37,55,0,0
1,26/05/2021,3,3,97,61,36,67,0,0
369,26/05/2021,3,3,87,51,36,107,0,0
262,26/05/2021,3,1,50,39,11,74,0,0
85,28/05/2021,3,7,113,113,0,NA,NA,NA
353,30/05/2021,3,2,50,48,2,70,0,0
15,26/05/2021,3,0,31,21,10,82,0,0
712,28/05/2021,3,6,79,54,25,55,0,0
647,30/05/2021,3,26,67,67,0,NA,NA,NA
184,28/05/2021,3,0,51,32,19,59,0,0
147,28/05/2021,3,1,79,42,37,55,0,0
134,25/05/2021,3,1,47,28,19,74,0,0
887,26/05/2021,3,19,304,25,279,39,0,0
84,27/05/2021,3,0,20,20,0,NA,NA,NA
5,26/05/2021,3,6,83,48,35,60,0,0
667,27/05/2021,3,0,10,0,10,NA,NA,NA
144,28/05/2021,3,2,97,66,31,67,0,0
60,25/05/2021,3,0,57,44,13,95,0,0
837,26/05/2021,3,4,322,56,266,90,0,0
148,24/05/2021,3,0,25,22,3,77,0,0
867,30/05/2021,3,1,59,59,0,NA,NA,NA
764,30/05/2021,3,2,67,48,19,52,0,0
127,23/05/2021,3,1,59,22,37,49,0,0
177,25/05/2021,3,0,48,13,35,59,0,0
602,30/05/2021,3,0,64,64,0,NA,NA,NA
359,21/05/2021,3,3,101,100,1,83,0,0
78,22/05/2021,3,0,44,34,10,144,0,0
28,26/05/2021,3,2,126,102,24,85,0,0
741,28/05/2021,3,1,69,49,20,60,0,0
64,25/05/2021,3,3,244,60,184,49,0,0
870,26/05/2021,3,3,43,27,16,67,0,0
492,29/05/2021,3,3,34,34,0,NA,NA,NA
535,23/05/2021,3,1,82,29,53,49,0,0
208,25/05/2021,3,0,60,34,26,64,0,0
595,29/05/2021,3,3,47,47,0,NA,NA,NA
655,29/05/2021,3,0,72,71,1,121,0,0
461,29/05/2021,3,2,120,66,54,105,0,0
599,26/05/2021,3,2,151,113,38,105,0,0
819,19/05/2021,3,0,80,79,1,147,0,0
291,30/05/2021,3,0,61,51,10,63,0,0
319,27/05/2021,3,6,108,108,0,NA,NA,NA
798,30/05/2021,3,1,80,80,0,NA,NA,NA
933,30/05/2021,3,92,55,1,54,35,0,0
730,28/05/2021,3,1,74,40,34,55,0,0
473,25/05/2021,3,1,49,33,16,77,0,0
786,26/05/2021,3,2,60,41,19,97,0,0
642,25/05/2021,3,2,93,60,33,57,0,0
321,26/05/2021,3,1,39,18,21,64,0,0
433,25/05/2021,3,1,317,78,239,100,0,0
569,25/05/2021,3,0,120,50,70,49,0,0
908,30/05/2021,3,0,136,136,0,NA,NA,NA
533,25/05/2021,3,1,90,16,74,49,0,0
615,27/05/2021,3,0,71,54,17,62,0,0
768,29/05/2021,3,1,86,86,0,NA,NA,NA
281,30/05/2021,3,1,82,62,20,57,0,0
726,24/05/2021,3,0,39,33,6,98,0,0
734,26/05/2021,3,1,60,60,0,NA,NA,NA
717,26/05/2021,3,2,191,108,83,67,0,0
561,28/05/2021,3,2,58,34,24,55,0,0
806,26/05/2021,3,2,134,113,21,67,0,0
242,27/05/2021,3,3,135,87,48,57,0,0
1,28/05/2021,3,3,97,20,77,55,0,0
86,26/05/2021,3,2,46,29,17,67,0,0
865,25/05/2021,3,1,84,32,52,49,0,0
376,29/05/2021,3,2,62,63,-1,NA,NA,NA
687,30/05/2021,3,2,85,70,15,57,0,0
474,28/05/2021,3,0,112,74,38,60,0,0
360,30/05/2021,3,1,43,28,15,62,0,0
110,30/05/2021,3,1,86,73,13,62,0,0
365,28/05/2021,3,0,68,58,10,90,0,0
147,27/05/2021,3,1,79,43,36,49,0,0
39,23/05/2021,3,1,60,19,41,49,0,0
887,27/05/2021,3,19,304,23,281,39,0,0
857,28/05/2021,3,41,169,169,0,NA,NA,NA
316,28/05/2021,3,2,37,30,7,74,0,0
667,28/05/2021,3,0,10,0,10,NA,NA,NA
30,28/05/2021,3,1,70,69,1,131,0,0
918,25/05/2021,3,0,201,24,177,39,0,0
176,25/05/2021,3,2,98,24,74,49,0,0
148,27/05/2021,3,0,25,24,1,71,0,0
396,30/05/2021,3,6,24,23,1,62,0,0
509,30/05/2021,3,1,111,91,20,57,0,0
452,23/05/2021,3,3,57,28,29,55,0,0
366,25/05/2021,3,2,78,67,11,122,0,0
722,27/05/2021,3,0,42,41,1,119,0,0
843,21/05/2021,3,2,64,53,11,57,0,0
117,21/05/2021,3,1,93,93,0,NA,NA,NA
400,26/05/2021,3,3,27,15,12,57,0,0
828,28/05/2021,3,0,75,76,-1,NA,NA,NA
64,26/05/2021,3,3,244,48,196,49,0,0
610,28/05/2021,3,2,65,64,1,87,0,0
492,30/05/2021,3,3,34,34,0,NA,NA,NA
408,25/05/2021,3,5,160,35,125,55,0,0
725,24/05/2021,3,0,17,17,0,NA,NA,NA
595,30/05/2021,3,3,47,47,0,NA,NA,NA
692,25/05/2021,3,0,87,44,43,52,0,0
461,30/05/2021,3,2,120,68,52,70,0,0
468,28/05/2021,3,5,91,76,15,57,0,0
849,21/05/2021,3,0,84,60,24,60,0,0
351,29/05/2021,3,0,66,64,2,151,0,0
329,27/05/2021,3,9,98,98,0,NA,NA,NA
646,30/05/2021,3,14,122,126,-4,NA,NA,NA
129,30/05/2021,3,10,190,195,-5,NA,NA,NA
730,26/05/2021,3,0,75,35,40,49,0,0
95,25/05/2021,3,2,86,38,48,67,0,0
237,27/05/2021,3,6,115,60,55,49,0,0
72,26/05/2021,3,2,58,51,7,77,0,0
51,26/05/2021,3,1,79,74,5,92,0,0
816,25/05/2021,3,1,81,78,3,121,0,0
569,26/05/2021,3,0,120,42,78,49,0,0
367,30/05/2021,3,0,74,39,35,64,0,0
737,25/05/2021,3,2,40,10,30,49,0,0
370,26/05/2021,3,0,40,15,25,131,0,0
249,30/05/2021,3,2,125,125,0,NA,NA,NA
666,30/05/2021,3,2,64,59,5,65,0,0
720,24/05/2021,3,0,39,30,9,74,0,0
284,27/05/2021,3,1,25,25,0,NA,NA,NA
614,27/05/2021,3,2,80,60,20,67,0,0
149,27/05/2021,3,0,88,67,21,68,0,0
669,26/05/2021,3,0,87,57,30,57,0,0
47,28/05/2021,3,0,57,38,19,70,0,0
391,27/05/2021,3,1,75,61,14,57,0,0
634,25/05/2021,3,0,20,20,0,NA,NA,NA
183,25/05/2021,3,0,80,54,26,64,0,0
674,29/05/2021,3,1,97,98,-1,NA,NA,NA
25,30/05/2021,3,1,51,49,2,65,0,0
186,26/05/2021,3,1,57,39,18,62,0,0
465,30/05/2021,3,40,227,226,1,65,0,0
136,30/05/2021,3,0,128,128,0,NA,NA,NA
131,26/05/2021,3,4,45,30,15,62,0,0
17,27/05/2021,3,1,93,74,19,67,0,0
510,25/05/2021,3,2,141,30,111,49,0,0
887,30/05/2021,3,24,299,27,272,39,0,0
285,28/05/2021,3,1,79,45,34,55,0,0
174,26/05/2021,3,2,26,14,12,60,0,0
327,27/05/2021,3,18,50,51,-1,NA,NA,NA
289,28/05/2021,3,1,67,43,24,67,0,0
752,23/05/2021,3,1,43,30,13,57,0,0
103,25/05/2021,3,1,160,112,48,111,0,0
148,25/05/2021,3,0,25,23,2,139,0,0
224,30/05/2021,3,1,56,35,21,49,0,0
579,28/05/2021,3,0,44,34,10,82,0,0
612,23/05/2021,3,1,41,30,11,57,0,0
232,26/05/2021,3,1,64,46,18,106,0,0
722,30/05/2021,3,0,42,36,6,103,0,0
495,18/05/2021,3,1,84,35,49,49,0,0
212,22/05/2021,3,2,76,76,0,NA,NA,NA
423,26/05/2021,3,11,39,23,16,123,0,0
156,27/05/2021,3,2,146,102,44,62,0,0
520,25/05/2021,3,0,58,41,17,102,0,0
188,29/05/2021,3,6,115,114,1,NA,NA,NA
702,29/05/2021,3,1,49,48,1,119,0,0
104,23/05/2021,3,1,61,46,15,63,0,0
21,24/05/2021,3,1,59,29,30,52,0,0
719,29/05/2021,3,0,41,41,0,NA,NA,NA
140,25/05/2021,3,0,170,85,85,49,0,0
580,26/05/2021,3,0,98,78,20,67,0,0
13,28/05/2021,3,3,78,59,19,86,0,0
896,22/05/2021,3,0,82,81,1,170,0,0
606,30/05/2021,3,2,44,42,2,88,0,0
716,27/05/2021,3,0,104,71,33,60,0,0
497,30/05/2021,3,4,189,182,7,62,0,0
68,29/05/2021,3,1,115,117,-2,NA,NA,NA
682,24/05/2021,3,2,78,42,36,49,0,0
59,26/05/2021,3,6,69,7,62,49,0,0
54,27/05/2021,3,2,59,47,12,67,0,0
92,26/05/2021,3,2,120,58,62,49,0,0
128,26/05/2021,3,1,20,12,8,64,0,0
394,23/05/2021,3,0,68,16,52,49,0,0
575,26/05/2021,3,1,49,41,8,59,0,0
302,30/05/2021,3,0,61,59,2,70,0,0
737,26/05/2021,3,2,40,9,31,49,0,0
710,26/05/2021,3,0,20,13,7,64,0,0
768,30/05/2021,3,2,85,85,0,NA,NA,NA
296,30/05/2021,3,3,57,37,20,49,0,0
871,24/05/2021,3,2,76,65,11,63,0,0
734,27/05/2021,3,1,60,49,11,80,0,0
614,29/05/2021,3,2,80,70,10,57,0,0
567,28/05/2021,3,0,61,61,0,NA,NA,NA
669,27/05/2021,3,0,87,62,25,52,0,0
47,29/05/2021,3,0,57,56,1,104,0,0
265,29/05/2021,3,1,56,55,1,79,0,0
634,26/05/2021,3,0,20,20,0,NA,NA,NA
617,25/05/2021,3,0,44,30,14,72,0,0
307,28/05/2021,3,1,78,78,0,NA,NA,NA
904,30/05/2021,3,2,272,117,155,70,0,0
56,27/05/2021,3,1,64,48,16,72,0,0
846,30/05/2021,3,2,187,47,140,45,0,0
728,30/05/2021,3,0,47,47,0,NA,NA,NA
131,28/05/2021,3,4,45,29,16,55,0,0
198,27/05/2021,3,1,134,116,18,80,0,0
412,25/05/2021,3,15,86,37,49,49,0,0
75,27/05/2021,3,0,81,58,23,78,0,0
699,28/05/2021,3,1,61,58,3,89,0,0
38,26/05/2021,3,1,49,31,18,62,0,0
96,27/05/2021,3,14,55,45,10,62,0,0
61,30/05/2021,3,1,99,78,21,57,0,0
658,24/05/2021,3,1,80,50,30,74,0,0
32,26/05/2021,3,1,104,84,20,124,0,0
345,25/05/2021,3,0,101,101,0,NA,NA,NA
347,30/05/2021,3,1,61,61,0,NA,NA,NA
322,30/05/2021,3,3,97,86,11,62,0,0
222,23/05/2021,3,0,77,39,38,54,0,0
232,25/05/2021,3,1,64,42,22,100,0,0
671,29/05/2021,3,1,64,63,1,149,0,0
288,21/05/2021,3,0,60,25,35,55,0,0
493,21/05/2021,3,1,34,33,1,79,0,0
696,26/05/2021,3,1,88,49,39,52,0,0
414,28/05/2021,3,19,167,159,8,101,0,0
485,25/05/2021,3,0,65,28,37,66,0,0
499,29/05/2021,3,0,31,31,0,NA,NA,NA
175,29/05/2021,3,12,108,87,21,84,0,0
899,24/05/2021,3,1,104,51,53,118,0,0
845,24/05/2021,3,0,120,75,45,52,0,0
874,22/05/2021,3,1,88,39,49,49,0,0
655,27/05/2021,3,0,72,58,14,77,0,0
24,26/05/2021,3,0,84,52,32,60,0,0
395,27/05/2021,3,2,70,57,13,57,0,0
470,21/05/2021,3,3,77,62,15,74,0,0
388,30/05/2021,3,1,59,55,4,62,0,0
98,27/05/2021,3,2,93,76,17,82,0,0
7,30/05/2021,3,5,98,25,73,49,0,0
344,29/05/2021,3,1,64,64,0,NA,NA,NA
303,25/05/2021,3,2,63,53,10,59,0,0
59,25/05/2021,3,5,70,7,63,49,0,0
279,27/05/2021,3,1,56,31,25,55,0,0
760,25/05/2021,3,3,33,5,28,49,0,0
128,27/05/2021,3,1,20,20,0,NA,NA,NA
529,25/05/2021,3,4,37,37,0,NA,NA,NA
650,26/05/2021,3,3,125,76,49,60,0,0
727,30/05/2021,3,0,75,74,1,124,0,0
533,26/05/2021,3,1,90,11,79,49,0,0
852,25/05/2021,3,0,80,57,23,74,0,0
249,29/05/2021,3,2,125,125,0,NA,NA,NA
522,30/05/2021,3,3,59,59,0,NA,NA,NA
649,24/05/2021,3,2,62,60,2,91,0,0
49,28/05/2021,3,4,144,144,0,NA,NA,NA
409,28/05/2021,3,6,101,67,34,55,0,0
770,28/05/2021,3,2,33,33,0,NA,NA,NA
806,27/05/2021,3,2,134,116,18,67,0,0
236,29/05/2021,3,3,116,114,2,79,0,0
823,25/05/2021,3,1,60,51,9,65,0,0
263,25/05/2021,3,0,66,23,43,49,0,0
755,26/05/2021,3,0,87,55,32,113,0,0
372,29/05/2021,3,18,74,74,0,NA,NA,NA
904,29/05/2021,3,2,272,89,183,105,0,0
393,27/05/2021,3,1,59,46,13,52,0,0
846,28/05/2021,3,1,188,92,96,45,0,0
352,30/05/2021,3,0,64,63,1,75,0,0
151,26/05/2021,3,6,70,55,15,85,0,0
589,27/05/2021,3,3,140,118,22,62,0,0
102,22/05/2021,3,0,60,60,0,NA,NA,NA
544,28/05/2021,3,0,53,38,15,55,0,0
180,27/05/2021,3,1,40,18,22,49,0,0
316,26/05/2021,3,1,38,35,3,149,0,0
2,28/05/2021,3,3,56,43,13,67,0,0
289,30/05/2021,3,2,66,22,44,49,0,0
658,25/05/2021,3,1,80,34,46,77,0,0
257,25/05/2021,3,1,43,33,10,85,0,0
576,25/05/2021,3,1,57,37,20,52,0,0
789,30/05/2021,3,1,71,71,0,NA,NA,NA
472,30/05/2021,3,4,230,215,15,80,0,0
772,23/05/2021,3,0,57,42,15,54,0,0
854,25/05/2021,3,5,105,33,72,110,0,0
41,29/05/2021,3,1,83,82,1,115,0,0
288,22/05/2021,3,0,60,27,33,55,0,0
117,22/05/2021,3,1,93,79,14,136,0,0
785,27/05/2021,3,20,90,90,0,NA,NA,NA
455,27/05/2021,3,6,245,30,215,85,0,0
88,26/05/2021,3,1,41,28,13,67,0,0
501,29/05/2021,3,24,209,209,0,NA,NA,NA
558,29/05/2021,3,0,44,44,0,NA,NA,NA
264,24/05/2021,3,1,59,35,24,55,0,0
225,24/05/2021,3,13,67,34,33,77,0,0
874,25/05/2021,3,2,87,14,73,49,0,0
635,30/05/2021,3,0,88,87,1,75,0,0
580,27/05/2021,3,0,98,83,15,62,0,0
599,27/05/2021,3,2,151,126,25,87,0,0
50,21/05/2021,3,2,119,13,106,55,0,0
351,30/05/2021,3,0,66,67,-1,NA,NA,NA
550,27/05/2021,3,2,110,86,24,57,0,0
298,30/05/2021,3,2,227,85,142,49,0,0
662,30/05/2021,3,1,106,106,0,NA,NA,NA
800,26/05/2021,3,2,55,39,16,57,0,0
802,26/05/2021,3,1,64,64,0,NA,NA,NA
565,26/05/2021,3,0,62,45,17,85,0,0
518,26/05/2021,3,1,16,16,0,NA,NA,NA
600,26/05/2021,3,0,50,50,0,NA,NA,NA
173,23/05/2021,3,1,70,21,49,49,0,0
575,27/05/2021,3,1,49,30,19,55,0,0
302,28/05/2021,3,0,61,61,0,NA,NA,NA
91,25/05/2021,3,2,78,49,29,67,0,0
852,26/05/2021,3,0,80,75,5,79,0,0
670,29/05/2021,3,0,108,108,0,NA,NA,NA
707,30/05/2021,3,1,39,39,0,NA,NA,NA
747,24/05/2021,3,0,64,59,5,59,0,0
787,28/05/2021,3,4,104,104,0,NA,NA,NA
614,30/05/2021,3,2,80,42,38,49,0,0
713,28/05/2021,3,1,60,60,0,NA,NA,NA
211,28/05/2021,3,3,57,44,13,60,0,0
47,30/05/2021,3,0,57,50,7,77,0,0
514,26/05/2021,3,5,229,61,168,49,0,0
511,25/05/2021,3,0,76,46,30,62,0,0
932,26/05/2021,3,11,96,5,91,45,0,0
307,30/05/2021,3,1,78,78,0,NA,NA,NA
442,29/05/2021,3,8,150,147,3,90,0,0
512,28/05/2021,3,1,61,49,12,67,0,0
846,29/05/2021,3,1,188,85,103,45,0,0
686,30/05/2021,3,0,46,39,7,62,0,0
151,28/05/2021,3,6,70,50,20,60,0,0
361,28/05/2021,3,37,28,16,12,107,0,0
582,25/05/2021,3,0,53,32,21,139,0,0
544,29/05/2021,3,0,53,52,1,79,0,0
143,26/05/2021,3,2,118,68,50,67,0,0
559,28/05/2021,3,44,141,140,1,98,0,0
96,28/05/2021,3,14,55,46,9,67,0,0
144,29/05/2021,3,1,98,96,2,119,0,0
752,25/05/2021,3,1,43,21,22,74,0,0
257,26/05/2021,3,1,43,39,4,90,0,0
146,25/05/2021,3,1,40,24,16,80,0,0
282,30/05/2021,3,2,699,182,517,49,0,0
603,29/05/2021,3,0,84,84,0,NA,NA,NA
52,23/05/2021,3,24,118,86,32,67,0,0
33,26/05/2021,3,3,77,33,44,67,0,0
775,29/05/2021,3,4,105,99,6,74,0,0
454,18/05/2021,3,0,184,26,158,66,0,0
117,23/05/2021,3,1,93,82,11,83,0,0
895,28/05/2021,3,0,69,69,0,NA,NA,NA
445,28/05/2021,3,3,166,58,108,49,0,0
460,25/05/2021,3,10,99,48,51,60,0,0
870,29/05/2021,3,3,43,43,0,NA,NA,NA
858,29/05/2021,3,0,81,81,0,NA,NA,NA
83,23/05/2021,3,9,159,105,54,65,0,0
827,25/05/2021,3,1,69,44,25,81,0,0
874,28/05/2021,3,11,78,42,36,49,0,0
635,27/05/2021,3,0,88,57,31,49,0,0
578,28/05/2021,3,0,58,48,10,74,0,0
36,30/05/2021,3,1,62,48,14,57,0,0
50,22/05/2021,3,2,119,24,95,55,0,0
606,29/05/2021,3,1,45,45,0,NA,NA,NA
856,27/05/2021,3,1,119,79,40,57,0,0
774,30/05/2021,3,5,100,51,49,49,0,0
135,29/05/2021,3,2,64,64,0,NA,NA,NA
800,24/05/2021,3,2,55,25,30,49,0,0
37,26/05/2021,3,2,79,56,23,52,0,0
528,27/05/2021,3,0,119,113,6,62,0,0
782,25/05/2021,3,0,20,20,0,NA,NA,NA
266,26/05/2021,3,0,61,50,11,80,0,0
173,24/05/2021,3,1,70,49,21,55,0,0
113,27/05/2021,3,1,31,21,10,49,0,0
693,27/05/2021,3,3,122,29,93,49,0,0
572,26/05/2021,3,0,61,35,26,60,0,0
852,27/05/2021,3,0,80,78,2,85,0,0
670,30/05/2021,3,0,108,108,0,NA,NA,NA
784,30/05/2021,3,1,48,48,0,NA,NA,NA
297,22/05/2021,3,1,75,14,61,55,0,0
230,27/05/2021,3,0,80,36,44,49,0,0
717,27/05/2021,3,2,191,113,78,55,0,0
524,28/05/2021,3,3,107,94,13,67,0,0
152,26/05/2021,3,1,90,40,50,55,0,0
221,26/05/2021,3,1,61,23,38,60,0,0
371,27/05/2021,3,0,36,22,14,107,0,0
487,25/05/2021,3,0,39,22,17,62,0,0
193,26/05/2021,3,1,107,42,65,49,0,0
659,28/05/2021,3,1,42,42,0,NA,NA,NA
448,29/05/2021,3,2,151,115,36,120,0,0
683,28/05/2021,3,1,65,43,22,55,0,0
43,28/05/2021,3,2,71,52,19,74,0,0
838,30/05/2021,3,3,62,62,0,NA,NA,NA
526,26/05/2021,3,1,37,38,-1,NA,NA,NA
571,28/05/2021,3,2,159,71,88,55,0,0
102,25/05/2021,3,0,60,52,8,59,0,0
323,30/05/2021,3,0,31,29,2,70,0,0
750,26/05/2021,3,3,109,72,37,93,0,0
821,26/05/2021,3,0,79,57,22,107,0,0
203,28/05/2021,3,1,39,20,19,79,0,0
289,29/05/2021,3,1,67,38,29,55,0,0
534,23/05/2021,3,1,84,23,61,49,0,0
505,25/05/2021,3,0,84,30,54,49,0,0
146,26/05/2021,3,1,40,29,11,82,0,0
65,30/05/2021,3,0,78,70,8,62,0,0
603,30/05/2021,3,0,84,84,0,NA,NA,NA
310,23/05/2021,3,1,71,34,37,49,0,0
854,26/05/2021,3,5,105,30,75,110,0,0
793,30/05/2021,3,2,129,116,13,62,0,0
359,22/05/2021,3,3,101,101,0,NA,NA,NA
212,23/05/2021,3,1,77,35,42,59,0,0
28,28/05/2021,3,2,126,118,8,119,0,0
621,28/05/2021,3,0,60,44,16,56,0,0
99,25/05/2021,3,1,166,118,48,57,0,0
355,27/05/2021,3,2,97,51,46,55,0,0
378,30/05/2021,3,0,84,69,15,57,0,0
408,24/05/2021,3,5,160,39,121,55,0,0
346,26/05/2021,3,4,116,99,17,67,0,0
44,25/05/2021,3,4,104,43,61,109,0,0
877,27/05/2021,3,0,158,79,79,35,0,0
578,30/05/2021,3,0,58,45,13,57,0,0
13,29/05/2021,3,3,78,58,20,110,0,0
23,21/05/2021,3,2,62,33,29,55,0,0
552,30/05/2021,3,12,172,172,0,NA,NA,NA
716,26/05/2021,3,0,104,75,29,82,0,0
196,30/05/2021,3,0,138,102,36,52,0,0
135,30/05/2021,3,2,64,64,0,NA,NA,NA
761,25/05/2021,3,2,81,49,32,52,0,0
443,24/05/2021,3,6,84,49,35,59,0,0
155,27/05/2021,3,0,93,75,18,62,0,0
202,25/05/2021,3,0,76,74,2,118,0,0
836,27/05/2021,3,0,101,71,30,55,0,0
433,24/05/2021,3,1,317,86,231,95,0,0
137,27/05/2021,3,24,122,45,77,49,0,0
536,27/05/2021,3,1,80,65,15,66,0,0
435,24/05/2021,3,51,69,48,21,59,0,0
278,24/05/2021,3,0,105,26,79,49,0,0
48,26/05/2021,3,11,168,43,125,49,0,0
239,30/05/2021,3,0,40,40,0,NA,NA,NA
297,24/05/2021,3,1,75,47,28,55,0,0
118,27/05/2021,3,2,57,20,37,49,0,0
717,28/05/2021,3,3,190,91,99,49,0,0
736,28/05/2021,3,3,102,82,20,67,0,0
368,27/05/2021,3,1,84,33,51,78,0,0
759,26/05/2021,3,3,84,42,42,49,0,0
371,29/05/2021,3,0,36,31,5,115,0,0
624,25/05/2021,3,1,78,46,32,52,0,0
475,26/05/2021,3,1,98,84,14,79,0,0
659,29/05/2021,3,1,42,42,0,NA,NA,NA
555,30/05/2021,3,0,117,116,1,75,0,0
247,27/05/2021,3,2,91,61,30,55,0,0
465,28/05/2021,3,32,235,206,29,67,0,0
832,30/05/2021,3,3,97,54,43,49,0,0
593,26/05/2021,3,26,55,56,-1,NA,NA,NA
153,27/05/2021,3,3,61,44,17,60,0,0
543,22/05/2021,3,1,64,42,22,149,0,0
75,26/05/2021,3,0,81,57,24,84,0,0
34,28/05/2021,3,4,84,32,52,49,0,0
559,27/05/2021,3,44,141,135,6,65,0,0
531,28/05/2021,3,1,58,48,10,67,0,0
124,28/05/2021,3,0,54,48,6,74,0,0
675,24/05/2021,3,1,55,50,5,84,0,0
176,26/05/2021,3,2,98,34,64,49,0,0
26,26/05/2021,3,2,64,38,26,64,0,0
779,30/05/2021,3,0,104,99,5,75,0,0
308,28/05/2021,3,1,47,47,0,NA,NA,NA
326,23/05/2021,3,4,77,42,35,49,0,0
120,25/05/2021,3,2,152,107,45,80,0,0
41,30/05/2021,3,1,83,62,21,70,0,0
454,17/05/2021,3,0,184,20,164,66,0,0
493,24/05/2021,3,1,34,22,12,52,0,0
400,27/05/2021,3,3,27,19,8,57,0,0
641,26/05/2021,3,0,160,60,100,49,0,0
19,26/05/2021,3,1,93,49,44,57,0,0
601,28/05/2021,3,4,64,38,26,67,0,0
69,29/05/2021,3,2,58,58,0,NA,NA,NA
83,25/05/2021,3,9,159,109,50,96,0,0
664,26/05/2021,3,10,145,97,48,74,0,0
876,26/05/2021,3,7,175,54,121,45,0,0
877,28/05/2021,3,0,158,64,94,35,0,0
578,26/05/2021,3,0,58,42,16,49,0,0
503,30/05/2021,3,7,177,139,38,62,0,0
379,19/05/2021,3,2,285,153,132,66,0,0
81,29/05/2021,3,1,59,33,26,55,0,0
55,26/05/2021,3,1,32,14,18,55,0,0
105,30/05/2021,3,5,70,70,0,NA,NA,NA
542,30/05/2021,3,2,73,73,0,NA,NA,NA
800,27/05/2021,3,2,55,44,11,52,0,0
37,24/05/2021,3,2,79,42,37,49,0,0
565,27/05/2021,3,0,62,37,25,72,0,0
754,26/05/2021,3,0,62,49,13,62,0,0
417,27/05/2021,3,0,103,60,43,49,0,0
390,24/05/2021,3,2,134,68,66,49,0,0
430,27/05/2021,3,2,87,53,34,55,0,0
693,28/05/2021,3,3,122,54,68,55,0,0
374,23/05/2021,3,0,56,11,45,49,0,0
278,25/05/2021,3,0,105,24,81,49,0,0
249,26/05/2021,3,2,125,115,10,55,0,0
446,30/05/2021,3,7,126,95,31,52,0,0
315,23/05/2021,3,1,61,39,22,55,0,0
258,26/05/2021,3,1,142,125,17,85,0,0
705,26/05/2021,3,1,90,74,16,62,0,0
229,28/05/2021,3,5,51,52,-1,NA,NA,NA
152,28/05/2021,3,1,90,31,59,55,0,0
47,27/05/2021,3,0,57,44,13,72,0,0
371,28/05/2021,3,0,36,17,19,75,0,0
703,25/05/2021,3,1,90,84,6,74,0,0
917,26/05/2021,3,1,105,29,76,35,0,0
554,29/05/2021,3,0,42,42,0,NA,NA,NA
133,30/05/2021,3,3,61,60,1,65,0,0
825,27/05/2021,3,3,143,84,59,57,0,0
797,28/05/2021,3,0,67,64,3,135,0,0
362,30/05/2021,3,4,116,104,12,99,0,0
593,28/05/2021,3,17,64,64,0,NA,NA,NA
413,28/05/2021,3,3,113,65,48,55,0,0
341,25/05/2021,3,41,73,73,0,NA,NA,NA
384,28/05/2021,3,0,101,95,6,74,0,0
220,28/05/2021,3,5,98,96,2,98,0,0
821,27/05/2021,3,0,79,57,22,77,0,0
732,28/05/2021,3,0,60,37,23,60,0,0
850,29/05/2021,3,3,80,82,-2,NA,NA,NA
863,23/05/2021,3,7,88,32,56,49,0,0
709,26/05/2021,3,0,83,58,25,72,0,0
810,26/05/2021,3,5,384,34,350,80,0,0
254,30/05/2021,3,1,77,72,5,62,0,0
308,29/05/2021,3,1,47,47,0,NA,NA,NA
310,24/05/2021,3,1,71,57,14,67,0,0
429,26/05/2021,3,2,123,46,77,49,0,0
449,28/05/2021,3,1,94,32,62,90,0,0
261,17/05/2021,3,3,99,35,64,49,0,0
117,24/05/2021,3,1,93,80,13,102,0,0
897,27/05/2021,3,6,102,73,29,67,0,0
156,28/05/2021,3,0,148,122,26,85,0,0
99,26/05/2021,3,1,166,138,28,62,0,0
656,29/05/2021,3,0,115,116,-1,NA,NA,NA
504,29/05/2021,3,2,81,81,0,NA,NA,NA
272,25/05/2021,3,2,125,56,69,52,0,0
214,24/05/2021,3,3,83,49,34,49,0,0
577,29/05/2021,3,11,67,56,11,74,0,0
453,25/05/2021,3,3,135,99,36,67,0,0
680,27/05/2021,3,3,77,37,40,49,0,0
605,26/05/2021,3,14,146,75,71,52,0,0
470,22/05/2021,3,3,77,76,1,77,0,0
81,30/05/2021,3,0,60,27,33,49,0,0
337,26/05/2021,3,0,60,38,22,57,0,0
125,22/05/2021,3,2,34,34,0,NA,NA,NA
662,29/05/2021,3,1,106,106,0,NA,NA,NA
471,27/05/2021,3,6,114,96,18,67,0,0
244,24/05/2021,3,2,198,80,118,49,0,0
458,26/05/2021,3,2,179,121,58,49,0,0
782,24/05/2021,3,0,20,19,1,85,0,0
163,26/05/2021,3,1,61,52,9,90,0,0
739,24/05/2021,3,1,74,37,37,49,0,0
569,27/05/2021,3,0,120,51,69,49,0,0
693,29/05/2021,3,2,123,122,1,77,0,0
737,23/05/2021,3,2,40,13,27,49,0,0
615,24/05/2021,3,0,71,62,9,65,0,0
768,28/05/2021,3,11,76,60,16,77,0,0
491,30/05/2021,3,5,174,162,12,57,0,0
548,23/05/2021,3,1,90,36,54,49,0,0
258,27/05/2021,3,1,142,136,6,79,0,0
11,27/05/2021,3,1,83,63,20,52,0,0
168,28/05/2021,3,0,48,43,5,72,0,0
57,26/05/2021,3,1,139,78,61,49,0,0
154,27/05/2021,3,2,102,69,33,49,0,0
265,28/05/2021,3,1,56,47,9,89,0,0
583,26/05/2021,3,1,80,49,31,67,0,0
594,25/05/2021,3,12,106,81,25,82,0,0
554,30/05/2021,3,0,42,42,0,NA,NA,NA
442,30/05/2021,3,7,151,139,12,62,0,0
462,28/05/2021,3,10,179,29,150,80,0,0
311,28/05/2021,3,0,97,69,28,82,0,0
574,30/05/2021,3,11,76,60,16,52,0,0
420,26/05/2021,3,0,69,69,0,NA,NA,NA
332,28/05/2021,3,0,40,16,24,55,0,0
706,23/05/2021,3,1,73,34,39,49,0,0
77,26/05/2021,3,0,103,63,40,94,0,0
385,28/05/2021,3,2,61,60,1,94,0,0
107,28/05/2021,3,1,88,75,13,76,0,0
830,28/05/2021,3,0,66,67,-1,NA,NA,NA
30,30/05/2021,3,1,70,70,0,NA,NA,NA
863,24/05/2021,3,8,87,52,35,52,0,0
835,26/05/2021,3,6,98,78,20,82,0,0
148,26/05/2021,3,0,25,25,0,77,0,0
676,30/05/2021,3,1,114,77,37,57,0,0
322,29/05/2021,3,3,97,97,0,NA,NA,NA
481,24/05/2021,3,0,56,32,24,57,0,0
767,25/05/2021,3,1,66,50,16,77,0,0
775,28/05/2021,3,4,105,58,47,55,0,0
82,18/05/2021,3,1,95,79,16,94,0,0
330,21/05/2021,3,3,116,45,71,49,0,0
570,27/05/2021,3,0,149,91,58,49,0,0
641,28/05/2021,3,0,160,108,52,55,0,0
172,26/05/2021,3,2,83,71,12,77,0,0
97,29/05/2021,3,5,102,102,0,NA,NA,NA
858,30/05/2021,3,0,81,81,0,NA,NA,NA
408,23/05/2021,3,7,158,76,82,49,0,0
618,24/05/2021,3,21,130,71,59,49,0,0
532,23/05/2021,3,0,84,62,22,88,0,0
453,26/05/2021,3,3,135,97,38,60,0,0
461,28/05/2021,3,2,120,26,94,95,0,0
605,27/05/2021,3,14,146,97,49,57,0,0
849,18/05/2021,3,1,83,44,39,49,0,0
773,30/05/2021,3,0,74,72,2,65,0,0
329,26/05/2021,3,9,98,82,16,62,0,0
157,22/05/2021,3,1,82,82,0,NA,NA,NA
756,29/05/2021,3,0,106,106,0,NA,NA,NA
268,27/05/2021,3,3,75,43,32,59,0,0
244,26/05/2021,3,2,198,104,94,49,0,0
458,27/05/2021,3,2,179,147,32,49,0,0
813,26/05/2021,3,1,129,116,13,74,0,0
875,27/05/2021,3,2,90,81,9,72,0,0
467,25/05/2021,3,2,110,9,101,90,0,0
551,26/05/2021,3,0,115,76,39,52,0,0
693,30/05/2021,3,2,123,90,33,52,0,0
87,23/05/2021,3,45,73,17,56,49,0,0
100,24/05/2021,3,77,147,74,73,49,0,0
312,29/05/2021,3,2,95,84,11,109,0,0
416,30/05/2021,3,0,34,31,3,62,0,0
871,21/05/2021,3,2,76,61,15,74,0,0
364,27/05/2021,3,1,129,90,39,80,0,0
638,27/05/2021,3,1,100,74,26,64,0,0
794,28/05/2021,3,0,137,34,103,85,0,0
437,26/05/2021,3,2,163,96,67,49,0,0
759,27/05/2021,3,2,85,46,39,49,0,0
701,26/05/2021,3,2,60,52,8,79,0,0
624,26/05/2021,3,1,78,34,44,52,0,0
848,25/05/2021,3,25,113,24,89,35,0,0
270,29/05/2021,3,1,59,59,0,NA,NA,NA
448,30/05/2021,3,2,151,115,36,84,0,0
654,28/05/2021,3,6,53,37,16,113,0,0
907,28/05/2021,3,3,77,47,30,64,0,0
714,30/05/2021,3,0,59,58,1,68,0,0
689,28/05/2021,3,0,130,130,0,NA,NA,NA
589,28/05/2021,3,4,139,82,57,55,0,0
510,24/05/2021,3,2,141,22,119,49,0,0
556,28/05/2021,3,0,117,103,14,94,0,0
432,27/05/2021,3,0,165,8,157,85,0,0
476,26/05/2021,3,1,172,46,126,49,0,0
921,28/05/2021,3,10,165,15,150,39,0,0
850,28/05/2021,3,3,80,80,0,NA,NA,NA
681,25/05/2021,3,7,64,61,3,90,0,0
103,24/05/2021,3,2,159,125,34,104,0,0
317,26/05/2021,3,0,80,72,8,90,0,0
419,30/05/2021,3,17,93,84,9,94,0,0
715,30/05/2021,3,1,87,87,0,NA,NA,NA
452,24/05/2021,3,3,57,43,14,60,0,0
366,26/05/2021,3,4,76,64,12,116,0,0
793,28/05/2021,3,2,129,85,44,55,0,0
82,19/05/2021,3,1,95,81,14,89,0,0
411,22/05/2021,3,0,185,176,9,158,0,0
777,28/05/2021,3,3,117,96,21,81,0,0
741,27/05/2021,3,0,70,60,10,49,0,0
815,26/05/2021,3,12,117,87,30,96,0,0
601,29/05/2021,3,2,66,66,0,NA,NA,NA
504,30/05/2021,3,2,81,61,20,52,0,0
402,23/05/2021,3,1,154,77,77,49,0,0
208,24/05/2021,3,0,60,34,26,55,0,0
719,26/05/2021,3,0,41,37,4,59,0,0
457,27/05/2021,3,1,62,37,25,52,0,0
680,29/05/2021,3,3,77,69,8,77,0,0
599,28/05/2021,3,2,151,132,19,109,0,0
50,19/05/2021,3,2,119,37,82,49,0,0
331,29/05/2021,3,16,78,78,0,NA,NA,NA
856,26/05/2021,3,5,115,67,48,57,0,0
123,22/05/2021,3,5,90,35,55,55,0,0
756,30/05/2021,3,0,106,106,0,NA,NA,NA
268,25/05/2021,3,1,77,71,6,85,0,0
59,24/05/2021,3,5,70,11,59,49,0,0
628,26/05/2021,3,1,58,36,22,80,0,0
139,26/05/2021,3,2,57,38,19,63,0,0
427,27/05/2021,3,6,304,36,268,85,0,0
209,24/05/2021,3,1,113,69,44,67,0,0
563,26/05/2021,3,3,67,40,27,55,0,0
367,28/05/2021,3,0,74,36,38,58,0,0
246,23/05/2021,3,1,111,26,85,49,0,0
745,24/05/2021,3,1,104,63,41,55,0,0
312,30/05/2021,3,2,95,85,10,69,0,0
450,30/05/2021,3,3,181,172,9,63,0,0
649,23/05/2021,3,2,62,58,4,81,0,0
258,28/05/2021,3,1,142,134,8,129,0,0
614,28/05/2021,3,1,81,36,45,49,0,0
713,27/05/2021,3,1,60,57,3,131,0,0
498,27/05/2021,3,0,87,59,28,49,0,0
765,27/05/2021,3,0,101,94,7,85,0,0
514,29/05/2021,3,7,227,225,2,77,0,0
216,25/05/2021,3,2,56,51,5,103,0,0
451,25/05/2021,3,2,81,49,32,160,0,0
270,30/05/2021,3,1,59,59,0,NA,NA,NA
608,30/05/2021,3,10,130,123,7,70,0,0
251,26/05/2021,3,2,122,58,64,49,0,0
293,28/05/2021,3,4,56,44,12,74,0,0
431,30/05/2021,3,3,127,117,10,77,0,0
184,26/05/2021,3,0,51,32,19,95,0,0
648,27/05/2021,3,1,63,34,29,64,0,0
412,24/05/2021,3,15,86,28,58,49,0,0
619,30/05/2021,3,0,101,71,30,52,0,0
84,26/05/2021,3,0,20,18,2,108,0,0
5,28/05/2021,3,6,83,57,26,55,0,0
256,28/05/2021,3,1,108,83,25,77,0,0
124,29/05/2021,3,0,54,54,0,NA,NA,NA
863,25/05/2021,3,9,86,45,41,52,0,0
709,24/05/2021,3,0,83,57,26,60,0,0
317,27/05/2021,3,0,80,62,18,79,0,0
515,30/05/2021,3,5,107,97,10,62,0,0
509,29/05/2021,3,1,111,111,0,NA,NA,NA
861,24/05/2021,3,0,61,56,5,180,0,0
767,26/05/2021,3,1,66,33,33,67,0,0
793,27/05/2021,3,3,128,59,69,49,0,0
261,19/05/2021,3,3,99,68,31,52,0,0
78,24/05/2021,3,0,44,40,4,120,0,0
897,28/05/2021,3,3,107,91,16,104,0,0
621,27/05/2021,3,0,60,47,13,74,0,0
890,25/05/2021,3,0,150,26,124,87,0,0
636,29/05/2021,3,2,118,118,0,NA,NA,NA
795,30/05/2021,3,6,99,93,6,62,0,0
479,23/05/2021,3,2,53,30,23,49,0,0
346,24/05/2021,3,5,115,58,57,55,0,0
532,27/05/2021,3,0,84,83,1,90,0,0
692,27/05/2021,3,1,86,54,32,52,0,0
661,26/05/2021,3,19,153,77,76,52,0,0
599,29/05/2021,3,2,151,147,4,162,0,0
801,19/05/2021,3,8,159,53,106,49,0,0
388,29/05/2021,3,1,59,59,0,NA,NA,NA
808,26/05/2021,3,2,166,139,27,80,0,0
125,23/05/2021,3,2,34,22,12,67,0,0
9,29/05/2021,3,0,27,27,0,NA,NA,NA
761,28/05/2021,3,1,82,54,28,60,0,0
309,24/05/2021,3,0,16,15,1,74,0,0
786,27/05/2021,3,2,60,54,6,86,0,0
642,24/05/2021,3,2,93,54,39,52,0,0
51,27/05/2021,3,2,78,53,25,63,0,0
527,24/05/2021,3,5,56,51,5,65,0,0
551,27/05/2021,3,0,115,80,35,52,0,0
302,27/05/2021,3,0,61,55,6,62,0,0
533,23/05/2021,3,1,90,20,70,49,0,0
122,27/05/2021,3,3,118,92,26,74,0,0
540,27/05/2021,3,1,81,62,19,49,0,0
182,30/05/2021,3,2,78,78,0,NA,NA,NA
315,22/05/2021,3,1,61,35,26,55,0,0
873,27/05/2021,3,4,97,81,16,57,0,0
11,26/05/2021,3,1,83,67,16,67,0,0
811,28/05/2021,3,3,87,52,35,55,0,0
437,27/05/2021,3,2,163,113,50,49,0,0
236,30/05/2021,3,2,117,87,30,63,0,0
391,28/05/2021,3,1,75,58,17,60,0,0
583,25/05/2021,3,3,78,50,28,60,0,0
451,26/05/2021,3,2,81,51,30,150,0,0
659,30/05/2021,3,1,42,42,0,NA,NA,NA
133,26/05/2021,3,2,62,37,25,62,0,0
186,27/05/2021,3,1,57,34,23,49,0,0
500,28/05/2021,3,6,73,49,24,112,0,0
439,30/05/2021,3,2,89,70,19,57,0,0
259,28/05/2021,3,0,60,60,0,NA,NA,NA
17,28/05/2021,3,1,93,67,26,60,0,0
39,24/05/2021,3,1,60,35,25,60,0,0
77,28/05/2021,3,0,103,80,23,115,0,0
857,27/05/2021,3,133,77,79,-2,NA,NA,NA
668,28/05/2021,3,4,299,53,246,49,0,0
441,28/05/2021,3,0,168,72,96,80,0,0
604,29/05/2021,3,0,82,82,0,NA,NA,NA
681,24/05/2021,3,3,68,51,17,84,0,0
277,24/05/2021,3,6,66,50,16,65,0,0
345,24/05/2021,3,0,101,92,9,94,0,0
629,30/05/2021,3,2,60,46,14,52,0,0
579,29/05/2021,3,0,44,44,0,NA,NA,NA
612,24/05/2021,3,1,41,34,7,74,0,0
33,25/05/2021,3,2,78,36,42,67,0,0
775,27/05/2021,3,2,107,58,49,49,0,0
843,17/05/2021,3,2,64,28,36,49,0,0
78,23/05/2021,3,0,44,31,13,93,0,0
187,26/05/2021,3,1,40,27,13,49,0,0
641,27/05/2021,3,0,160,73,87,49,0,0
466,26/05/2021,3,1,139,43,96,49,0,0
636,28/05/2021,3,0,120,97,23,91,0,0
702,30/05/2021,3,1,49,42,7,62,0,0
272,24/05/2021,3,2,125,44,81,49,0,0
31,24/05/2021,3,2,61,31,30,49,0,0
874,29/05/2021,3,4,85,80,5,65,0,0
453,29/05/2021,3,1,137,135,2,74,0,0
694,26/05/2021,3,4,105,49,56,49,0,0
468,26/05/2021,3,4,92,42,50,49,0,0
801,22/05/2021,3,7,160,109,51,49,0,0
645,29/05/2021,3,3,38,38,0,NA,NA,NA
55,27/05/2021,3,1,32,24,8,57,0,0
123,23/05/2021,3,5,90,14,76,49,0,0
428,29/05/2021,3,2,90,78,12,119,0,0
730,27/05/2021,3,1,74,37,37,49,0,0
802,24/05/2021,3,1,64,57,7,84,0,0
628,27/05/2021,3,1,58,53,5,67,0,0
813,25/05/2021,3,1,129,127,2,85,0,0
836,26/05/2021,3,0,101,92,9,74,0,0
816,24/05/2021,3,1,81,78,3,136,0,0
839,27/05/2021,3,3,152,109,43,52,0,0
367,27/05/2021,3,0,74,32,42,65,0,0
625,23/05/2021,3,0,161,55,106,49,0,0
700,27/05/2021,3,6,126,76,50,57,0,0
833,30/05/2021,3,1,82,64,18,63,0,0
401,30/05/2021,3,0,79,79,0,NA,NA,NA
169,24/05/2021,3,1,19,16,3,72,0,0
234,28/05/2021,3,1,61,54,7,67,0,0
11,29/05/2021,3,1,83,81,2,77,0,0
27,27/05/2021,3,0,78,58,20,92,0,0
57,27/05/2021,3,1,139,80,59,49,0,0
242,30/05/2021,3,1,137,133,4,71,0,0
1,25/05/2021,3,3,97,80,17,77,0,0
685,26/05/2021,3,2,138,108,30,72,0,0
594,26/05/2021,3,12,106,79,27,82,0,0
639,29/05/2021,3,0,59,59,0,NA,NA,NA
145,26/05/2021,3,3,55,20,35,70,0,0
393,28/05/2021,3,1,59,52,7,74,0,0
360,28/05/2021,3,1,43,35,8,57,0,0
506,30/05/2021,3,1,194,168,26,57,0,0
243,27/05/2021,3,1,126,67,59,60,0,0
571,27/05/2021,3,2,159,27,132,49,0,0
45,25/05/2021,3,1,155,76,79,49,0,0
887,28/05/2021,3,24,299,35,264,39,0,0
220,27/05/2021,3,7,96,96,0,NA,NA,NA
290,27/05/2021,3,2,105,73,32,55,0,0
256,27/05/2021,3,1,108,77,31,62,0,0
604,30/05/2021,3,0,82,82,0,NA,NA,NA
383,24/05/2021,3,4,81,63,18,82,0,0
314,24/05/2021,3,2,67,44,23,52,0,0
240,24/05/2021,3,1,70,37,33,60,0,0
207,30/05/2021,3,2,61,58,3,63,0,0
308,30/05/2021,3,1,47,47,0,NA,NA,NA
426,23/05/2021,3,8,155,83,72,49,0,0
429,25/05/2021,3,2,123,37,86,49,0,0
449,29/05/2021,3,2,93,57,36,100,0,0
261,20/05/2021,3,2,100,96,4,65,0,0
78,21/05/2021,3,0,44,35,9,129,0,0
570,26/05/2021,3,0,149,79,70,49,0,0
179,26/05/2021,3,1,91,45,46,59,0,0
460,26/05/2021,3,10,99,45,54,55,0,0
656,26/05/2021,3,1,114,75,39,88,0,0
477,29/05/2021,3,5,115,40,75,55,0,0
535,24/05/2021,3,1,82,26,56,49,0,0
618,25/05/2021,3,15,136,77,59,49,0,0
719,25/05/2021,3,0,41,36,5,59,0,0
840,30/05/2021,3,2,310,310,0,62,0,0
517,27/05/2021,3,2,56,48,8,62,0,0
640,26/05/2021,3,5,121,51,70,49,0,0
573,18/05/2021,3,0,57,47,10,77,0,0
773,29/05/2021,3,0,74,74,0,NA,NA,NA
313,27/05/2021,3,1,30,23,7,57,0,0
196,23/05/2021,3,0,138,24,114,49,0,0
115,30/05/2021,3,5,110,72,38,57,0,0
546,27/05/2021,3,10,142,46,96,49,0,0
95,24/05/2021,3,2,86,41,45,57,0,0
528,26/05/2021,3,0,119,97,22,82,0,0
422,24/05/2021,3,1,78,39,39,49,0,0
684,26/05/2021,3,3,95,63,32,52,0,0
209,25/05/2021,3,1,113,75,38,74,0,0
137,25/05/2021,3,24,122,33,89,49,0,0
727,27/05/2021,3,0,75,57,18,92,0,0
533,24/05/2021,3,1,90,13,77,49,0,0
753,24/05/2021,3,8,119,80,39,62,0,0
833,26/05/2021,3,0,83,70,13,65,0,0
267,25/05/2021,3,2,81,81,0,NA,NA,NA
548,24/05/2021,3,1,90,75,15,57,0,0
230,28/05/2021,3,1,79,66,13,60,0,0
70,27/05/2021,3,1,38,18,20,88,0,0
456,27/05/2021,3,9,81,61,20,52,0,0
152,27/05/2021,3,1,90,46,44,49,0,0
18,27/05/2021,3,2,90,71,19,62,0,0
823,26/05/2021,3,1,60,54,6,77,0,0
703,26/05/2021,3,2,89,77,12,67,0,0
106,26/05/2021,3,1,30,17,13,80,0,0
919,29/05/2021,3,0,123,123,0,NA,NA,NA
904,26/05/2021,3,4,270,6,264,95,0,0
15,28/05/2021,3,0,31,26,5,105,0,0
360,29/05/2021,3,1,43,41,2,62,0,0
838,23/05/2021,3,3,62,42,20,66,0,0
526,27/05/2021,3,1,37,31,6,62,0,0
413,27/05/2021,3,3,113,87,26,49,0,0
199,24/05/2021,3,2,80,65,15,60,0,0
349,30/05/2021,3,5,85,69,16,57,0,0
76,28/05/2021,3,1,92,92,0,NA,NA,NA
5,27/05/2021,3,6,83,45,38,55,0,0
386,27/05/2021,3,2,83,65,18,57,0,0
850,30/05/2021,3,3,80,80,0,NA,NA,NA
752,24/05/2021,3,1,43,22,21,57,0,0
176,24/05/2021,3,3,97,36,61,49,0,0
576,24/05/2021,3,1,57,45,12,62,0,0
335,30/05/2021,3,4,82,55,27,49,0,0
579,30/05/2021,3,1,43,43,0,NA,NA,NA
52,24/05/2021,3,18,124,90,34,74,0,0
120,26/05/2021,3,2,152,119,33,80,0,0
602,27/05/2021,3,0,64,43,21,62,0,0
288,19/05/2021,3,0,60,43,17,74,0,0
304,23/05/2021,3,2,58,34,24,49,0,0
276,27/05/2021,3,1,203,80,123,49,0,0
494,26/05/2021,3,4,135,80,55,52,0,0
868,26/05/2021,3,0,83,40,43,52,0,0
610,26/05/2021,3,2,65,43,22,67,0,0
883,30/05/2021,3,6,98,15,83,45,0,0
535,25/05/2021,3,1,82,20,62,49,0,0
363,25/05/2021,3,2,97,92,5,59,0,0
532,28/05/2021,3,0,84,79,5,127,0,0
463,29/05/2021,3,9,154,128,26,155,0,0
578,27/05/2021,3,0,58,48,10,57,0,0
468,27/05/2021,3,5,91,50,41,49,0,0
896,19/05/2021,3,0,82,79,3,95,0,0
645,30/05/2021,3,2,39,39,0,NA,NA,NA
724,27/05/2021,3,1,85,59,26,161,0,0
497,22/05/2021,3,3,190,190,0,NA,NA,NA
428,30/05/2021,3,0,92,72,20,63,0,0
303,26/05/2021,3,2,63,41,22,72,0,0
161,24/05/2021,3,1,60,47,13,80,0,0
54,26/05/2021,3,1,60,54,6,83,0,0
422,26/05/2021,3,1,78,38,40,49,0,0
138,26/05/2021,3,1,97,45,52,55,0,0
12,24/05/2021,3,1,42,30,12,52,0,0
373,25/05/2021,3,1,102,67,35,60,0,0
908,28/05/2021,3,0,136,109,27,74,0,0
205,25/05/2021,3,0,126,63,63,49,0,0
122,25/05/2021,3,3,118,95,23,80,0,0
557,27/05/2021,3,0,104,74,30,60,0,0
267,26/05/2021,3,2,81,81,0,NA,NA,NA
720,23/05/2021,3,0,39,14,25,49,0,0
539,26/05/2021,3,2,95,64,31,57,0,0
705,28/05/2021,3,1,90,76,14,67,0,0
811,27/05/2021,3,3,87,52,35,60,0,0
437,28/05/2021,3,3,162,109,53,52,0,0
704,26/05/2021,3,1,31,24,7,57,0,0
660,25/05/2021,3,6,180,42,138,49,0,0
440,25/05/2021,3,0,265,34,231,90,0,0
475,25/05/2021,3,1,98,83,15,79,0,0
674,28/05/2021,3,1,97,82,15,74,0,0
25,27/05/2021,3,1,51,44,7,62,0,0
512,26/05/2021,3,1,61,22,39,49,0,0
333,30/05/2021,3,1,56,55,1,152,0,0
832,23/05/2021,3,2,98,26,72,49,0,0
526,28/05/2021,3,1,37,34,3,74,0,0
607,27/05/2021,3,1,74,49,25,55,0,0
341,23/05/2021,3,10,104,80,24,78,0,0
564,26/05/2021,3,1,73,60,13,57,0,0
143,28/05/2021,3,1,119,119,0,NA,NA,NA
357,26/05/2021,3,2,81,79,2,83,0,0
791,27/05/2021,3,37,91,70,21,57,0,0
185,28/05/2021,3,1,167,69,98,49,0,0
235,24/05/2021,3,4,153,42,111,49,0,0
831,24/05/2021,3,1,149,52,97,49,0,0
146,24/05/2021,3,1,40,38,2,79,0,0
869,30/05/2021,3,1,59,59,0,NA,NA,NA
509,28/05/2021,3,1,111,86,25,60,0,0
222,24/05/2021,3,0,77,52,25,57,0,0
274,25/05/2021,3,2,208,39,169,39,0,0
449,27/05/2021,3,1,94,20,74,85,0,0
454,20/05/2021,3,0,184,31,153,66,0,0
304,21/05/2021,3,2,58,48,10,67,0,0
189,28/05/2021,3,0,165,113,52,49,0,0
455,26/05/2021,3,6,245,32,213,90,0,0
890,26/05/2021,3,0,150,32,118,84,0,0
340,26/05/2021,3,16,118,18,100,49,0,0
889,29/05/2021,3,1,123,10,113,45,0,0
248,23/05/2021,3,0,82,35,47,49,0,0
845,25/05/2021,3,0,120,86,34,67,0,0
876,23/05/2021,3,2,180,52,128,45,0,0
453,30/05/2021,3,2,136,113,23,67,0,0
469,28/05/2021,3,4,192,73,119,95,0,0
640,27/05/2021,3,5,121,64,57,49,0,0
573,20/05/2021,3,0,57,54,3,75,0,0
116,29/05/2021,3,0,61,61,0,NA,NA,NA
301,27/05/2021,3,1,100,42,58,49,0,0
798,22/05/2021,3,1,80,80,0,NA,NA,NA
68,30/05/2021,3,1,115,77,38,49,0,0
800,25/05/2021,3,2,55,29,26,52,0,0
443,26/05/2021,3,5,85,48,37,59,0,0
237,26/05/2021,3,6,115,38,77,49,0,0
204,25/05/2021,3,0,64,13,51,49,0,0
213,26/05/2021,3,3,145,101,44,52,0,0
496,24/05/2021,3,1,59,25,34,49,0,0
430,25/05/2021,3,3,86,63,23,60,0,0
536,28/05/2021,3,0,81,80,1,74,0,0
246,26/05/2021,3,1,111,38,73,49,0,0
753,25/05/2021,3,14,113,89,24,65,0,0
300,30/05/2021,3,0,210,133,77,57,0,0
296,25/05/2021,3,3,57,26,31,55,0,0
315,24/05/2021,3,0,62,50,12,72,0,0
234,27/05/2021,3,2,60,38,22,49,0,0
11,28/05/2021,3,1,83,58,25,60,0,0
673,28/05/2021,3,4,119,101,18,67,0,0
915,28/05/2021,3,5,184,17,167,35,0,0
826,27/05/2021,3,2,96,88,8,63,0,0
878,27/05/2021,3,0,218,16,202,44,0,0
263,26/05/2021,3,0,66,25,41,49,0,0
228,25/05/2021,3,2,40,16,24,49,0,0
627,29/05/2021,3,0,41,39,2,77,0,0
231,26/05/2021,3,0,41,16,25,60,0,0
399,26/05/2021,3,7,54,51,3,95,0,0
824,29/05/2021,3,0,339,130,209,95,0,0
728,23/05/2021,3,0,47,24,23,49,0,0
131,27/05/2021,3,4,45,29,16,52,0,0
648,28/05/2021,3,1,63,47,16,60,0,0
341,24/05/2021,3,41,73,71,2,129,0,0
633,26/05/2021,3,1,49,42,7,79,0,0
699,26/05/2021,3,1,61,41,20,85,0,0
559,26/05/2021,3,45,140,115,25,65,0,0
921,27/05/2021,3,11,164,35,129,45,0,0
842,28/05/2021,3,2,89,69,20,68,0,0
235,23/05/2021,3,4,153,29,124,49,0,0
389,24/05/2021,3,2,124,71,53,49,0,0
240,25/05/2021,3,1,70,38,32,67,0,0
396,26/05/2021,3,3,27,14,13,52,0,0
58,28/05/2021,3,1,66,57,9,67,0,0
326,24/05/2021,3,3,78,55,23,67,0,0
274,26/05/2021,3,2,208,45,163,39,0,0
775,30/05/2021,3,1,108,53,55,49,0,0
82,17/05/2021,3,1,95,88,7,89,0,0
210,23/05/2021,3,2,100,63,37,57,0,0
276,26/05/2021,3,1,203,80,123,49,0,0
358,27/05/2021,3,2,91,63,28,55,0,0
485,26/05/2021,3,0,65,27,38,61,0,0
188,28/05/2021,3,7,114,106,8,74,0,0
613,30/05/2021,3,0,56,47,9,57,0,0
112,24/05/2021,3,0,84,47,37,49,0,0
618,26/05/2021,3,16,135,55,80,49,0,0
44,27/05/2021,3,12,96,64,32,115,0,0
463,26/05/2021,3,7,156,67,89,110,0,0
580,29/05/2021,3,0,98,97,1,140,0,0
36,26/05/2021,3,1,62,31,31,49,0,0
819,20/05/2021,3,0,80,78,2,147,0,0
291,29/05/2021,3,0,61,61,0,NA,NA,NA
459,27/05/2021,3,2,90,55,35,49,0,0
125,24/05/2021,3,2,34,34,0,NA,NA,NA
9,30/05/2021,3,0,27,21,6,125,0,0
800,28/05/2021,3,2,55,30,25,55,0,0
473,26/05/2021,3,1,49,32,17,69,0,0
788,27/05/2021,3,2,89,79,10,89,0,0
204,26/05/2021,3,0,64,14,50,49,0,0
427,26/05/2021,3,6,304,37,267,90,0,0
862,25/05/2021,3,1,109,72,37,57,0,0
563,25/05/2021,3,3,67,35,32,67,0,0
908,27/05/2021,3,0,136,67,69,49,0,0
205,23/05/2021,3,0,126,38,88,49,0,0
753,27/05/2021,3,7,120,119,1,65,0,0
851,28/05/2021,3,1,91,74,17,67,0,0
296,26/05/2021,3,3,57,12,45,55,0,0
315,21/05/2021,3,0,62,33,29,55,0,0
364,26/05/2021,3,1,129,103,26,82,0,0
70,26/05/2021,3,1,38,19,19,92,0,0
27,28/05/2021,3,0,78,76,2,101,0,0
67,27/05/2021,3,1,51,39,12,64,0,0
488,27/05/2021,3,3,63,57,6,79,0,0
111,28/05/2021,3,0,60,54,6,82,0,0
841,25/05/2021,3,0,182,39,143,55,0,0
519,25/05/2021,3,1,63,47,16,77,0,0
372,30/05/2021,3,18,74,76,-2,149,0,0
555,26/05/2021,3,0,117,81,36,82,0,0
350,27/05/2021,3,3,57,55,2,65,0,0
824,30/05/2021,3,0,339,107,232,60,0,0
574,23/05/2021,3,12,75,21,54,49,0,0
190,27/05/2021,3,4,76,67,9,63,0,0
864,28/05/2021,3,1,84,37,47,55,0,0
102,24/05/2021,3,0,60,42,18,59,0,0
323,26/05/2021,3,0,31,17,14,64,0,0
206,27/05/2021,3,16,197,128,69,59,0,0
668,26/05/2021,3,4,299,50,249,49,0,0
410,27/05/2021,3,0,56,44,12,49,0,0
185,29/05/2021,3,2,166,142,24,62,0,0
675,23/05/2021,3,1,55,32,23,49,0,0
855,24/05/2021,3,6,170,92,78,49,0,0
812,26/05/2021,3,2,135,67,68,49,0,0
20,26/05/2021,3,1,81,53,28,93,0,0
403,28/05/2021,3,4,94,58,36,78,0,0
275,24/05/2021,3,1,116,111,5,142,0,0
250,25/05/2021,3,0,115,88,27,80,0,0
41,28/05/2021,3,1,83,57,26,55,0,0
288,17/05/2021,3,0,60,50,10,83,0,0
210,22/05/2021,3,2,100,98,2,55,0,0
777,26/05/2021,3,3,117,94,23,77,0,0
494,27/05/2021,3,4,135,75,60,49,0,0
334,26/05/2021,3,1,57,22,35,60,0,0
355,28/05/2021,3,2,97,77,20,67,0,0
93,30/05/2021,3,2,139,114,25,57,0,0
248,25/05/2021,3,0,82,51,31,55,0,0
827,24/05/2021,3,1,69,49,20,84,0,0
874,30/05/2021,3,6,83,51,32,49,0,0
453,27/05/2021,3,3,135,93,42,55,0,0
24,30/05/2021,3,0,84,70,14,62,0,0
36,27/05/2021,3,1,62,28,34,49,0,0
379,18/05/2021,3,2,285,139,146,66,0,0
773,21/05/2021,3,1,73,61,12,74,0,0
459,26/05/2021,3,2,90,46,44,55,0,0
7,22/05/2021,3,4,99,31,68,55,0,0
115,29/05/2021,3,5,110,110,0,NA,NA,NA
471,28/05/2021,3,6,114,96,18,62,0,0
473,24/05/2021,3,2,48,32,16,72,0,0
735,26/05/2021,3,1,28,13,15,49,0,0
754,25/05/2021,3,0,62,26,36,49,0,0
875,26/05/2021,3,0,92,80,12,85,0,0
527,25/05/2021,3,5,56,55,1,95,0,0
373,27/05/2021,3,1,102,45,57,55,0,0
302,29/05/2021,3,0,61,61,0,NA,NA,NA
631,23/05/2021,3,1,70,23,47,49,0,0
370,27/05/2021,3,0,40,16,24,87,0,0
898,27/05/2021,3,1,99,69,30,67,0,0
784,26/05/2021,3,3,46,33,13,102,0,0
726,23/05/2021,3,0,39,20,19,49,0,0
521,26/05/2021,3,1,54,35,19,74,0,0
638,30/05/2021,3,0,101,81,20,57,0,0
159,28/05/2021,3,0,77,76,1,79,0,0
67,28/05/2021,3,1,51,37,14,60,0,0
704,28/05/2021,3,1,31,24,7,67,0,0
660,30/05/2021,3,6,180,66,114,49,0,0
487,26/05/2021,3,0,39,22,17,62,0,0
617,26/05/2021,3,0,44,27,17,72,0,0
270,28/05/2021,3,1,59,50,9,96,0,0
677,26/05/2021,3,0,40,8,32,49,0,0
399,27/05/2021,3,7,54,36,18,80,0,0
217,30/05/2021,3,0,41,37,4,63,0,0
362,23/05/2021,3,4,116,81,35,89,0,0
243,28/05/2021,3,1,126,109,17,82,0,0
42,27/05/2021,3,0,99,76,23,52,0,0
134,23/05/2021,3,1,47,28,19,53,0,0
544,26/05/2021,3,0,53,22,31,49,0,0
385,27/05/2021,3,2,61,51,10,82,0,0
668,27/05/2021,3,4,299,54,245,49,0,0
757,28/05/2021,3,0,117,81,36,82,0,0
30,29/05/2021,3,1,70,69,1,183,0,0
534,24/05/2021,3,1,84,30,54,49,0,0
505,26/05/2021,3,0,84,16,68,49,0,0
26,24/05/2021,3,2,64,37,27,60,0,0
224,26/05/2021,3,1,56,25,31,49,0,0
438,28/05/2021,3,11,85,59,26,60,0,0
426,24/05/2021,3,9,154,93,61,64,0,0
108,26/05/2021,3,0,78,49,29,52,0,0
671,27/05/2021,3,1,64,63,1,110,0,0
359,17/05/2021,3,5,99,58,41,57,0,0
807,24/05/2021,3,2,98,50,48,55,0,0
238,28/05/2021,3,0,66,51,15,67,0,0
201,28/05/2021,3,5,133,66,67,55,0,0
172,25/05/2021,3,2,83,66,17,74,0,0
656,28/05/2021,3,1,114,105,9,113,0,0
613,29/05/2021,3,0,56,48,8,90,0,0
264,23/05/2021,3,2,58,20,38,49,0,0
845,26/05/2021,3,0,120,100,20,74,0,0
44,24/05/2021,3,3,105,64,41,112,0,0
463,27/05/2021,3,7,156,65,91,100,0,0
469,30/05/2021,3,2,194,114,80,70,0,0
503,27/05/2021,3,0,184,77,107,49,0,0
379,21/05/2021,3,2,285,173,112,90,0,0
116,21/05/2021,3,0,61,61,0,NA,NA,NA
508,26/05/2021,3,2,78,58,20,57,0,0
298,22/05/2021,3,2,227,78,149,55,0,0
129,29/05/2021,3,10,190,194,-4,NA,NA,NA
268,28/05/2021,3,1,77,67,10,82,0,0
195,24/05/2021,3,1,50,32,18,57,0,0
155,26/05/2021,3,0,93,45,48,72,0,0
292,25/05/2021,3,0,239,39,200,49,0,0
266,27/05/2021,3,0,61,47,14,67,0,0
739,23/05/2021,3,2,73,14,59,49,0,0
538,27/05/2021,3,1,43,37,6,57,0,0
367,29/05/2021,3,0,74,42,32,98,0,0
87,25/05/2021,3,46,72,45,27,49,0,0
710,24/05/2021,3,0,20,16,4,67,0,0
397,29/05/2021,3,1,74,70,4,77,0,0
666,25/05/2021,3,2,64,42,22,62,0,0
649,21/05/2021,3,2,62,61,1,113,0,0
734,28/05/2021,3,1,60,55,5,67,0,0
638,26/05/2021,3,0,101,72,29,80,0,0
164,27/05/2021,3,0,62,42,20,52,0,0
560,27/05/2021,3,0,80,78,2,77,0,0
242,26/05/2021,3,3,135,70,65,57,0,0
660,26/05/2021,3,6,180,34,146,49,0,0
841,26/05/2021,3,0,182,40,142,55,0,0
183,26/05/2021,3,0,80,30,50,64,0,0
197,29/05/2021,3,0,118,85,33,74,0,0
677,27/05/2021,3,0,40,12,28,49,0,0
350,28/05/2021,3,3,57,47,10,74,0,0
797,29/05/2021,3,0,67,66,1,196,0,0
584,23/05/2021,3,0,97,77,20,77,0,0
271,27/05/2021,3,0,70,60,10,62,0,0
776,27/05/2021,3,0,104,51,53,49,0,0
134,24/05/2021,3,1,47,31,16,74,0,0
323,27/05/2021,3,0,31,23,8,72,0,0
699,27/05/2021,3,1,61,56,5,90,0,0
174,28/05/2021,3,4,24,13,11,55,0,0
820,27/05/2021,3,0,127,97,30,80,0,0
185,30/05/2021,3,1,167,121,46,52,0,0
632,24/05/2021,3,1,81,30,51,55,0,0
32,24/05/2021,3,1,104,91,13,102,0,0
513,26/05/2021,3,2,75,45,30,57,0,0
867,26/05/2021,3,1,59,47,12,134,0,0
472,28/05/2021,3,5,229,126,103,90,0,0
275,23/05/2021,3,1,116,84,32,62,0,0
250,26/05/2021,3,0,115,86,29,80,0,0
41,27/05/2021,3,1,83,59,24,60,0,0
288,18/05/2021,3,0,60,40,20,79,0,0
330,22/05/2021,3,3,116,62,54,49,0,0
696,27/05/2021,3,1,88,51,37,49,0,0
653,28/05/2021,3,3,112,27,85,55,0,0
815,25/05/2021,3,11,118,79,39,99,0,0
80,26/05/2021,3,0,125,70,55,49,0,0
378,29/05/2021,3,1,83,80,3,77,0,0
899,23/05/2021,3,1,104,51,53,79,0,0
346,25/05/2021,3,4,116,61,55,55,0,0
532,24/05/2021,3,0,84,71,13,85,0,0
877,29/05/2021,3,16,142,43,99,35,0,0
260,26/05/2021,3,1,119,82,37,62,0,0
377,27/05/2021,3,0,149,112,37,77,0,0
23,18/05/2021,3,3,61,41,20,52,0,0
552,19/05/2021,3,11,173,116,57,52,0,0
698,26/05/2021,3,3,113,52,61,52,0,0
585,23/05/2021,3,2,58,44,14,101,0,0
115,16/05/2021,3,0,115,11,104,49,0,0
22,28/05/2021,3,0,64,41,23,55,0,0
95,26/05/2021,3,0,88,39,49,60,0,0
478,26/05/2021,3,0,20,14,6,118,0,0
292,26/05/2021,3,0,239,52,187,49,0,0
252,26/05/2021,3,2,262,114,148,49,0,0
529,23/05/2021,3,3,38,22,16,49,0,0
839,25/05/2021,3,3,152,109,43,60,0,0
908,14/05/2021,3,0,136,0,136,49,0,0
625,25/05/2021,3,0,161,92,69,49,0,0
122,24/05/2021,3,3,118,79,39,74,0,0
833,29/05/2021,3,2,81,78,3,85,0,0
666,26/05/2021,3,2,64,41,23,62,0,0
297,23/05/2021,3,1,75,14,61,49,0,0
118,28/05/2021,3,2,57,36,21,55,0,0
866,26/05/2021,3,0,100,48,52,67,0,0
547,27/05/2021,3,0,74,40,34,126,0,0
657,27/05/2021,3,0,48,45,3,113,0,0
488,26/05/2021,3,3,63,42,21,80,0,0
701,27/05/2021,3,2,60,47,13,67,0,0
440,26/05/2021,3,0,265,32,233,90,0,0
848,26/05/2021,3,12,126,28,98,35,0,0
197,30/05/2021,3,1,117,78,39,49,0,0
591,26/05/2021,3,0,68,55,13,82,0,0
654,27/05/2021,3,6,53,13,40,90,0,0
114,29/05/2021,3,0,75,69,6,153,0,0
439,23/05/2021,3,5,86,33,53,49,0,0
689,27/05/2021,3,0,130,127,3,63,0,0
776,28/05/2021,3,0,104,62,42,55,0,0
543,24/05/2021,3,1,64,57,7,111,0,0
544,30/05/2021,3,0,53,39,14,57,0,0
294,28/05/2021,3,1,116,115,1,79,0,0
357,27/05/2021,3,1,82,65,17,67,0,0
757,27/05/2021,3,0,117,100,17,89,0,0
61,28/05/2021,3,1,99,57,42,55,0,0
235,25/05/2021,3,3,154,45,109,49,0,0
121,24/05/2021,3,0,110,103,7,142,0,0
63,27/05/2021,3,6,58,46,12,52,0,0
867,27/05/2021,3,1,59,58,1,108,0,0
218,28/05/2021,3,3,75,61,14,67,0,0
742,23/05/2021,3,2,72,30,42,49,0,0
860,26/05/2021,3,0,92,64,28,52,0,0
722,28/05/2021,3,0,42,34,8,67,0,0
328,20/05/2021,3,5,93,70,23,64,0,0
330,23/05/2021,3,2,117,26,91,49,0,0
276,28/05/2021,3,1,203,61,142,49,0,0
201,26/05/2021,3,6,132,78,54,49,0,0
88,25/05/2021,3,1,41,36,5,55,0,0
340,27/05/2021,3,18,116,22,94,49,0,0
69,30/05/2021,3,2,58,52,6,63,0,0
248,24/05/2021,3,0,82,66,16,77,0,0
483,24/05/2021,3,4,95,39,56,49,0,0
719,27/05/2021,3,0,41,21,20,80,0,0
877,30/05/2021,3,16,142,48,94,35,0,0
651,27/05/2021,3,1,77,31,46,49,0,0
283,26/05/2021,3,0,76,25,51,59,0,0
896,20/05/2021,3,0,82,72,10,80,0,0
771,20/05/2021,3,2,28,21,7,67,0,0
508,27/05/2021,3,2,78,59,19,52,0,0
798,23/05/2021,3,1,80,67,13,67,0,0
115,18/05/2021,3,0,115,26,89,49,0,0
730,25/05/2021,3,0,75,31,44,49,0,0
244,25/05/2021,3,2,198,91,107,49,0,0
318,27/05/2021,3,0,59,40,19,66,0,0
92,25/05/2021,3,2,120,52,68,49,0,0
138,27/05/2021,3,1,97,51,46,49,0,0
12,23/05/2021,3,2,41,18,23,49,0,0
563,27/05/2021,3,2,68,53,15,49,0,0
693,11/05/2021,3,5,120,8,112,49,0,0
625,26/05/2021,3,0,161,90,71,49,0,0
852,24/05/2021,3,0,80,54,26,67,0,0
898,29/05/2021,3,1,99,98,1,173,0,0
707,25/05/2021,3,1,39,38,1,142,0,0
169,23/05/2021,3,1,19,17,2,62,0,0
539,28/05/2021,3,2,95,76,19,67,0,0
170,27/05/2021,3,0,105,81,24,52,0,0
90,27/05/2021,3,9,69,43,26,49,0,0
669,28/05/2021,3,0,87,79,8,74,0,0
826,28/05/2021,3,3,95,88,7,74,0,0
391,26/05/2021,3,1,75,51,24,52,0,0
369,25/05/2021,3,4,86,65,21,123,0,0
193,25/05/2021,3,1,107,48,59,49,0,0
674,30/05/2021,3,1,97,85,12,62,0,0
442,26/05/2021,3,8,150,117,33,67,0,0
56,26/05/2021,3,1,64,53,11,90,0,0
566,29/05/2021,3,1,74,73,1,84,0,0
506,23/05/2021,3,2,193,44,149,49,0,0
271,28/05/2021,3,0,70,55,15,67,0,0
864,27/05/2021,3,1,84,55,29,55,0,0
39,25/05/2021,3,1,60,38,22,72,0,0
323,29/05/2021,3,0,31,30,1,93,0,0
805,28/05/2021,3,3,110,81,29,60,0,0
316,27/05/2021,3,1,38,32,6,95,0,0
158,27/05/2021,3,0,24,15,9,59,0,0
61,29/05/2021,3,1,99,100,-1,NA,NA,NA
534,25/05/2021,3,1,84,56,28,49,0,0
835,24/05/2021,3,6,98,72,26,80,0,0
146,27/05/2021,3,1,40,38,2,83,0,0
65,26/05/2021,3,0,78,52,26,57,0,0
58,29/05/2021,3,1,66,65,1,79,0,0
127,24/05/2021,3,1,59,35,24,55,0,0
392,25/05/2021,3,0,176,82,94,49,0,0
449,30/05/2021,3,2,93,55,38,70,0,0
359,20/05/2021,3,3,101,69,32,52,0,0
807,23/05/2021,3,2,98,36,62,49,0,0
380,28/05/2021,3,1,159,132,27,57,0,0
741,26/05/2021,3,0,70,57,13,57,0,0
466,25/05/2021,3,1,139,48,91,49,0,0
97,27/05/2021,3,5,102,74,28,72,0,0
586,30/05/2021,3,4,79,75,4,72,0,0
112,25/05/2021,3,0,84,63,21,62,0,0
664,24/05/2021,3,11,144,64,80,49,0,0
577,22/05/2021,3,0,78,44,34,55,0,0
663,26/05/2021,3,11,137,27,110,49,0,0
694,27/05/2021,3,3,106,49,57,49,0,0
13,26/05/2021,3,0,81,58,23,82,0,0
23,22/05/2021,3,2,62,42,20,60,0,0
773,20/05/2021,3,2,72,69,3,89,0,0
698,27/05/2021,3,3,113,45,68,49,0,0
497,23/05/2021,3,3,190,80,110,49,0,0
933,16/05/2021,3,116,31,12,19,35,0,0
546,25/05/2021,3,9,143,39,104,49,0,0
802,25/05/2021,3,1,64,62,2,103,0,0
279,26/05/2021,3,0,57,31,26,60,0,0
622,25/05/2021,3,13,31,21,10,111,0,0
213,27/05/2021,3,3,145,119,26,57,0,0
467,23/05/2021,3,2,110,13,97,70,0,0
650,27/05/2021,3,5,123,107,16,67,0,0
727,12/05/2021,3,3,72,24,48,55,0,0
749,26/05/2021,3,5,149,33,116,49,0,0
89,25/05/2021,3,2,58,54,4,62,0,0
348,26/05/2021,3,8,132,126,6,77,0,0
790,25/05/2021,3,1,98,37,61,95,0,0
871,23/05/2021,3,2,76,35,41,49,0,0
521,27/05/2021,3,1,54,44,10,63,0,0
829,30/05/2021,3,0,150,91,59,49,0,0
524,27/05/2021,3,3,107,104,3,62,0,0
498,26/05/2021,3,0,87,64,23,52,0,0
826,26/05/2021,3,2,96,73,23,57,0,0
514,28/05/2021,3,8,226,192,34,67,0,0
731,25/05/2021,3,4,95,69,26,62,0,0
755,25/05/2021,3,0,87,75,12,118,0,0
35,30/05/2021,3,9,101,70,31,52,0,0
448,26/05/2021,3,2,151,62,89,100,0,0
162,26/05/2021,3,1,121,87,34,88,0,0
293,29/05/2021,3,4,56,53,3,77,0,0
110,23/05/2021,3,1,86,34,52,49,0,0
420,27/05/2021,3,0,69,66,3,85,0,0
361,27/05/2021,3,41,24,18,6,80,0,0
743,22/05/2021,3,1,125,78,47,55,0,0
544,23/05/2021,3,0,53,8,45,49,0,0
626,28/05/2021,3,4,98,79,19,62,0,0
107,27/05/2021,3,1,88,71,17,85,0,0
410,28/05/2021,3,0,56,46,10,67,0,0
61,15/05/2021,3,1,99,8,91,49,0,0
675,30/05/2021,3,0,56,54,2,103,0,0
103,26/05/2021,3,1,160,96,64,112,0,0
812,27/05/2021,3,56,81,52,29,57,0,0
396,27/05/2021,3,2,28,24,4,62,0,0
438,29/05/2021,3,9,87,72,15,82,0,0
861,26/05/2021,3,0,61,51,10,184,0,0
108,30/05/2021,3,0,78,63,15,57,0,0
602,28/05/2021,3,0,64,60,4,85,0,0
261,30/05/2021,3,2,100,99,1,161,0,0
411,23/05/2021,3,0,185,123,62,49,0,0
895,27/05/2021,3,0,69,58,11,57,0,0
156,26/05/2021,3,2,146,124,22,79,0,0
868,30/05/2021,3,0,83,83,0,71,0,0
697,27/05/2021,3,2,107,56,51,52,0,0
175,30/05/2021,3,6,114,57,57,49,0,0
688,29/05/2021,3,2,117,118,-1,NA,NA,NA
31,25/05/2021,3,2,61,29,32,52,0,0
577,24/05/2021,3,0,78,38,40,49,0,0
663,27/05/2021,3,13,135,41,94,49,0,0
694,29/05/2021,3,3,106,105,1,77,0,0
377,30/05/2021,3,0,149,145,4,120,0,0
50,20/05/2021,3,2,119,38,81,49,0,0
331,20/05/2021,3,28,66,60,6,90,0,0
808,27/05/2021,3,2,166,156,10,80,0,0
123,24/05/2021,3,5,90,17,73,49,0,0
933,18/05/2021,3,116,31,14,17,35,0,0
268,19/05/2021,3,1,77,69,8,89,0,0
195,26/05/2021,3,1,50,33,17,57,0,0
735,27/05/2021,3,1,28,10,18,49,0,0
3,25/05/2021,3,8,105,46,59,49,0,0
684,27/05/2021,3,4,94,54,40,49,0,0
467,27/05/2021,3,2,110,9,101,85,0,0
650,25/05/2021,3,3,125,65,60,60,0,0
302,14/05/2021,3,0,61,56,5,62,0,0
91,23/05/2021,3,1,79,43,36,49,0,0
100,26/05/2021,3,77,147,108,39,62,0,0
853,26/05/2021,3,4,98,83,15,67,0,0
707,26/05/2021,3,1,39,34,5,119,0,0
315,25/05/2021,3,0,62,38,24,64,0,0
230,26/05/2021,3,0,80,33,47,49,0,0
866,30/05/2021,3,0,100,95,5,107,0,0
673,27/05/2021,3,3,120,72,48,49,0,0
806,28/05/2021,3,2,134,131,3,74,0,0
488,22/05/2021,3,1,65,65,0,NA,NA,NA
111,18/05/2021,3,0,60,60,0,NA,NA,NA
634,30/05/2021,3,0,20,20,0,NA,NA,NA
917,30/05/2021,3,1,105,11,94,35,0,0
627,27/05/2021,3,0,41,21,20,64,0,0
809,26/05/2021,3,5,96,75,21,55,0,0
253,26/05/2021,3,1,57,32,25,67,0,0
43,30/05/2021,3,2,71,67,4,70,0,0
647,23/05/2021,3,5,88,27,61,49,0,0
184,27/05/2021,3,0,51,36,15,77,0,0
42,25/05/2021,3,0,99,81,18,77,0,0
582,30/05/2021,3,0,53,53,0,NA,NA,NA
323,25/05/2021,3,0,31,28,3,123,0,0
220,26/05/2021,3,6,97,96,1,65,0,0
5,25/05/2021,3,6,83,56,27,67,0,0
820,28/05/2021,3,0,127,121,6,77,0,0
289,15/05/2021,3,1,67,20,47,49,0,0
658,30/05/2021,3,0,81,81,0,NA,NA,NA
32,30/05/2021,3,1,104,104,0,NA,NA,NA
812,24/05/2021,3,2,135,63,72,49,0,0
224,27/05/2021,3,1,56,26,30,49,0,0
438,21/05/2021,3,7,89,49,40,55,0,0
772,25/05/2021,3,0,57,44,13,95,0,0
177,30/05/2021,3,0,48,28,20,49,0,0
671,20/05/2021,3,0,65,63,2,85,0,0
261,29/05/2021,3,2,100,100,0,NA,NA,NA
493,25/05/2021,3,1,34,23,11,49,0,0
570,28/05/2021,3,0,149,97,52,55,0,0
828,23/05/2021,3,0,75,75,0,NA,NA,NA
99,30/05/2021,3,1,166,165,1,103,0,0
733,28/05/2021,3,1,99,40,59,55,0,0
889,24/05/2021,3,1,123,6,117,45,0,0
899,30/05/2021,3,1,104,105,-1,NA,NA,NA
827,30/05/2021,3,0,70,70,0,NA,NA,NA
719,07/05/2021,3,0,41,1,40,49,0,0
663,23/05/2021,3,5,143,32,111,49,0,0
461,22/05/2021,3,2,120,26,94,105,0,0
283,28/05/2021,3,0,76,42,34,55,0,0
470,27/05/2021,3,3,77,77,0,NA,NA,NA
116,28/05/2021,3,0,61,61,0,NA,NA,NA
724,26/05/2021,3,1,85,59,26,182,0,0
646,28/05/2021,3,15,121,105,16,91,0,0
933,19/05/2021,3,116,31,18,13,35,0,0
8,18/05/2021,3,1,39,39,0,NA,NA,NA
443,28/05/2021,3,6,84,77,7,73,0,0
178,26/05/2021,3,0,38,37,1,85,0,0
72,30/05/2021,3,2,58,49,9,62,0,0
252,27/05/2021,3,2,262,118,144,49,0,0
816,26/05/2021,3,1,81,79,2,125,0,0
113,22/05/2021,3,1,31,26,5,67,0,0
727,20/05/2021,3,0,75,72,3,85,0,0
91,30/05/2021,3,2,78,74,4,63,0,0
710,22/05/2021,3,0,20,20,0,NA,NA,NA
540,22/05/2021,3,1,81,77,4,116,0,0
66,25/05/2021,3,1,151,20,131,49,0,0
315,28/05/2021,3,0,62,53,9,74,0,0
118,25/05/2021,3,2,57,19,38,49,0,0
70,21/05/2021,3,1,38,25,13,93,0,0
736,25/05/2021,3,2,103,48,55,52,0,0
226,25/05/2021,3,0,47,45,2,113,0,0
826,22/05/2021,3,2,96,96,0,NA,NA,NA
391,14/05/2021,3,1,75,12,63,49,0,0
86,30/05/2021,3,1,47,37,10,62,0,0
106,30/05/2021,3,1,30,30,0,NA,NA,NA
665,27/05/2021,3,1,105,51,54,60,0,0
809,27/05/2021,3,5,96,83,13,57,0,0
683,26/05/2021,3,1,65,43,22,57,0,0
824,25/05/2021,3,0,339,28,311,85,0,0
110,26/05/2021,3,1,86,86,0,NA,NA,NA
817,28/05/2021,3,0,83,64,19,67,0,0
17,25/05/2021,3,1,93,73,20,74,0,0
102,30/05/2021,3,0,60,60,0,NA,NA,NA
77,21/05/2021,3,0,103,86,17,115,0,0
34,27/05/2021,3,2,86,62,24,60,0,0
407,25/05/2021,3,1,40,15,25,49,0,0
2,27/05/2021,3,3,56,37,19,64,0,0
289,16/05/2021,3,1,67,8,59,49,0,0
752,30/05/2021,3,0,44,44,0,NA,NA,NA
121,30/05/2021,3,0,110,110,0,NA,NA,NA
576,30/05/2021,3,0,58,47,11,62,0,0
130,27/05/2021,3,1,80,80,0,NA,NA,NA
764,22/05/2021,3,2,67,31,36,55,0,0
222,26/05/2021,3,0,77,54,23,62,0,0
392,30/05/2021,3,0,176,103,73,49,0,0
671,21/05/2021,3,1,64,64,0,NA,NA,NA
82,30/05/2021,3,0,96,97,-1,NA,NA,NA
493,26/05/2021,3,1,34,21,13,49,0,0
897,23/05/2021,3,6,102,3,99,66,0,0
445,23/05/2021,3,2,167,33,134,49,0,0
64,30/05/2021,3,3,244,37,207,49,0,0
80,27/05/2021,3,0,125,77,48,49,0,0
889,25/05/2021,3,1,123,19,104,45,0,0
272,29/05/2021,3,4,123,123,0,NA,NA,NA
225,30/05/2021,3,13,67,67,0,NA,NA,NA
595,05/05/2021,3,2,48,20,28,52,0,0
663,22/05/2021,3,0,148,93,55,80,0,0
461,21/05/2021,3,2,120,23,97,95,0,0
599,22/05/2021,3,1,152,129,23,144,0,0
819,26/05/2021,3,1,79,79,0,NA,NA,NA
291,28/05/2021,3,0,61,61,0,NA,NA,NA
329,30/05/2021,3,9,98,98,0,112,0,0
123,29/05/2021,3,7,88,63,25,60,0,0
542,17/05/2021,3,3,72,69,3,115,0,0
800,19/05/2021,3,2,55,23,32,52,0,0
161,27/05/2021,3,1,60,46,14,79,0,0
478,25/05/2021,3,0,20,16,4,113,0,0
464,30/05/2021,3,1,265,171,94,70,0,0
427,28/05/2021,3,6,304,67,237,90,0,0
527,27/05/2021,3,6,55,56,-1,NA,NA,NA
569,22/05/2021,3,0,120,120,0,NA,NA,NA
536,19/05/2021,3,1,80,30,50,64,0,0
737,30/05/2021,3,2,40,31,9,52,0,0
171,21/05/2021,3,3,46,13,33,53,0,0
898,22/05/2021,3,1,99,70,29,144,0,0
66,26/05/2021,3,1,151,25,126,49,0,0
315,26/05/2021,3,0,62,45,17,72,0,0
734,24/05/2021,3,1,60,60,0,NA,NA,NA
614,21/05/2021,3,2,80,36,44,49,0,0
456,25/05/2021,3,5,85,49,36,49,0,0
498,25/05/2021,3,0,87,66,21,57,0,0
154,21/05/2021,3,4,100,101,-1,NA,NA,NA
391,15/05/2021,3,1,75,9,66,49,0,0
487,30/05/2021,3,0,39,38,1,71,0,0
594,30/05/2021,3,2,105,105,0,NA,NA,NA
85,25/05/2021,3,7,113,85,28,96,0,0
444,26/05/2021,3,4,115,66,49,49,0,0
253,27/05/2021,3,1,57,37,20,74,0,0
360,25/05/2021,3,1,43,21,22,72,0,0
574,25/05/2021,3,12,75,34,41,49,0,0
151,29/05/2021,3,6,70,68,2,119,0,0
648,25/05/2021,3,1,63,40,23,85,0,0
39,30/05/2021,3,1,60,59,1,75,0,0
564,21/05/2021,3,1,73,61,12,67,0,0
805,30/05/2021,3,2,111,109,2,70,0,0
530,25/05/2021,3,1,59,40,19,82,0,0
667,24/05/2021,3,0,10,0,10,NA,NA,NA
604,15/05/2021,3,0,82,16,66,49,0,0
60,29/05/2021,3,0,57,57,0,NA,NA,NA
835,30/05/2021,3,5,99,99,0,NA,NA,NA
146,28/05/2021,3,1,40,40,0,NA,NA,NA
676,26/05/2021,3,2,113,100,13,63,0,0
308,23/05/2021,3,2,46,18,28,49,0,0
772,26/05/2021,3,0,57,46,11,90,0,0
250,30/05/2021,3,0,115,59,56,64,0,0
449,19/05/2021,3,2,93,19,74,66,0,0
359,29/05/2021,3,3,101,103,-2,NA,NA,NA
493,27/05/2021,3,1,34,22,12,49,0,0
423,23/05/2021,3,6,44,14,30,49,0,0
621,25/05/2021,3,0,60,40,20,80,0,0
466,30/05/2021,3,4,136,99,37,52,0,0
340,29/05/2021,3,19,115,68,47,49,0,0
702,25/05/2021,3,1,49,43,6,77,0,0
804,29/05/2021,3,4,141,141,0,NA,NA,NA
664,30/05/2021,3,9,146,146,0,NA,NA,NA
595,08/05/2021,3,2,48,15,33,49,0,0
692,19/05/2021,3,0,87,28,59,49,0,0
651,21/05/2021,3,1,77,34,43,55,0,0
405,25/05/2021,3,1,89,90,-1,NA,NA,NA
819,25/05/2021,3,1,79,75,4,160,0,0
351,26/05/2021,3,1,65,48,17,82,0,0
550,30/05/2021,3,1,111,97,14,63,0,0
497,27/05/2021,3,4,189,136,53,52,0,0
135,18/05/2021,3,5,61,56,5,90,0,0
471,21/05/2021,3,7,113,94,19,57,0,0
309,19/05/2021,3,0,16,11,5,93,0,0
54,24/05/2021,3,1,60,60,0,NA,NA,NA
292,30/05/2021,3,0,239,84,155,49,0,0
684,28/05/2021,3,4,94,71,23,60,0,0
467,26/05/2021,3,2,110,13,97,90,0,0
872,22/05/2021,3,1,64,64,0,NA,NA,NA
727,19/05/2021,3,2,73,72,1,123,0,0
631,30/05/2021,3,1,70,28,42,49,0,0
278,21/05/2021,3,0,105,29,76,49,0,0
833,22/05/2021,3,1,82,83,-1,NA,NA,NA
239,25/05/2021,3,0,40,35,5,85,0,0
720,25/05/2021,3,0,39,28,11,77,0,0
364,25/05/2021,3,2,128,97,31,80,0,0
638,23/05/2021,3,1,100,38,62,49,0,0
547,26/05/2021,3,1,73,37,36,151,0,0
560,25/05/2021,3,0,80,52,28,85,0,0
154,22/05/2021,3,3,101,100,1,103,0,0
371,16/05/2021,3,1,35,9,26,49,0,0
685,30/05/2021,3,8,132,132,0,NA,NA,NA
519,30/05/2021,3,0,64,64,0,NA,NA,NA
376,26/05/2021,3,1,63,57,6,87,0,0
442,27/05/2021,3,8,150,80,70,49,0,0
253,28/05/2021,3,1,57,42,15,52,0,0
797,25/05/2021,3,1,66,51,15,164,0,0
439,25/05/2021,3,4,87,22,65,49,0,0
593,19/05/2021,3,4,77,65,12,93,0,0
153,25/05/2021,3,1,63,42,21,74,0,0
199,30/05/2021,3,2,80,65,15,57,0,0
619,22/05/2021,3,1,100,76,24,67,0,0
34,30/05/2021,3,2,86,47,39,49,0,0
316,25/05/2021,3,1,38,37,1,169,0,0
667,26/05/2021,3,0,10,0,10,NA,NA,NA
124,16/05/2021,3,2,52,14,38,49,0,0
675,29/05/2021,3,1,55,53,2,84,0,0
257,30/05/2021,3,1,43,43,0,NA,NA,NA
317,29/05/2021,3,0,80,80,0,NA,NA,NA
347,27/05/2021,3,13,49,48,1,82,0,0
308,21/05/2021,3,1,47,36,11,58,0,0
127,25/05/2021,3,1,59,32,27,72,0,0
120,30/05/2021,3,2,152,151,1,75,0,0
775,18/05/2021,3,5,104,46,58,49,0,0
843,30/05/2021,3,3,63,56,7,63,0,0
304,25/05/2021,3,2,58,32,26,72,0,0
305,25/05/2021,3,13,46,37,9,152,0,0
455,24/05/2021,3,7,244,29,215,85,0,0
460,30/05/2021,3,7,102,76,26,57,0,0
355,29/05/2021,3,2,97,86,11,89,0,0
406,25/05/2021,3,1,38,36,2,127,0,0
408,30/05/2021,3,7,158,158,0,NA,NA,NA
31,30/05/2021,3,1,62,60,2,62,0,0
44,09/05/2021,3,5,103,23,80,49,0,0
655,22/05/2021,3,0,72,54,18,109,0,0
469,22/05/2021,3,4,192,69,123,105,0,0
640,23/05/2021,3,5,121,39,82,49,0,0
23,28/05/2021,3,1,63,53,10,67,0,0
773,26/05/2021,3,1,73,64,9,80,0,0
508,30/05/2021,3,0,80,78,2,62,0,0
774,27/05/2021,3,7,98,71,27,52,0,0
344,18/05/2021,3,1,64,45,19,57,0,0
22,18/05/2021,3,0,64,62,2,115,0,0
95,18/05/2021,3,1,87,58,29,67,0,0
478,23/05/2021,3,0,20,20,0,NA,NA,NA
754,30/05/2021,3,0,62,48,14,57,0,0
213,28/05/2021,3,3,145,135,10,79,0,0
142,27/05/2021,3,1,61,49,12,80,0,0
872,23/05/2021,3,1,64,52,12,68,0,0
908,16/05/2021,3,0,136,2,134,49,0,0
246,30/05/2021,3,1,111,111,0,NA,NA,NA
71,21/05/2021,3,0,62,30,32,55,0,0
557,22/05/2021,3,0,104,104,0,NA,NA,NA
416,25/05/2021,3,0,34,13,21,49,0,0
726,25/05/2021,3,0,39,28,11,87,0,0
284,25/05/2021,3,1,25,16,9,60,0,0
866,23/05/2021,3,0,100,41,59,49,0,0
746,25/05/2021,3,1,59,39,20,77,0,0
657,25/05/2021,3,0,48,18,30,84,0,0
242,22/05/2021,3,6,132,101,31,74,0,0
265,14/05/2021,3,1,56,15,41,49,0,0
369,30/05/2021,3,24,66,63,3,80,0,0
755,30/05/2021,3,0,87,87,0,NA,NA,NA
639,25/05/2021,3,0,59,35,24,62,0,0
119,26/05/2021,3,2,66,28,38,49,0,0
192,28/05/2021,3,0,86,56,30,60,0,0
217,26/05/2021,3,1,40,27,13,52,0,0
362,25/05/2021,3,3,117,104,13,82,0,0
131,21/05/2021,3,4,45,21,24,55,0,0
571,25/05/2021,3,2,159,17,142,49,0,0
543,30/05/2021,3,1,64,65,-1,NA,NA,NA
219,23/05/2021,3,4,73,18,55,49,0,0
699,30/05/2021,3,1,61,45,16,52,0,0
679,24/05/2021,3,0,89,65,24,80,0,0
667,25/05/2021,3,0,10,0,10,NA,NA,NA
850,16/05/2021,3,4,79,13,66,49,0,0
681,29/05/2021,3,6,65,58,7,189,0,0
103,30/05/2021,3,0,161,161,0,NA,NA,NA
240,30/05/2021,3,1,70,60,10,63,0,0
779,27/05/2021,3,0,104,63,41,67,0,0
715,21/05/2021,3,1,87,43,44,91,0,0
612,25/05/2021,3,1,41,29,12,67,0,0
429,30/05/2021,3,3,122,37,85,49,0,0
41,21/05/2021,3,2,82,73,9,67,0,0
454,30/05/2021,3,0,184,132,52,70,0,0
210,27/05/2021,3,2,100,100,0,NA,NA,NA
28,25/05/2021,3,2,126,111,15,95,0,0
455,25/05/2021,3,7,244,26,218,90,0,0
803,30/05/2021,3,1,68,67,1,85,0,0
501,26/05/2021,3,22,211,93,118,49,0,0
492,24/05/2021,3,3,34,24,10,52,0,0
688,30/05/2021,3,2,117,117,0,NA,NA,NA
725,30/05/2021,3,0,17,15,2,74,0,0
595,11/05/2021,3,2,48,16,32,57,0,0
453,20/05/2021,3,3,135,92,43,60,0,0
461,23/05/2021,3,2,120,8,112,75,0,0
13,22/05/2021,3,4,77,50,27,100,0,0
573,26/05/2021,3,0,57,30,27,60,0,0
388,28/05/2021,3,1,59,34,25,55,0,0
844,30/05/2021,3,0,61,14,47,60,0,0
196,29/05/2021,3,0,138,133,5,74,0,0
616,18/05/2021,3,3,72,60,12,119,0,0
682,19/05/2021,3,1,79,30,49,60,0,0
59,18/05/2021,3,1,74,24,50,49,0,0
788,23/05/2021,3,2,89,74,15,68,0,0
813,30/05/2021,3,1,129,119,10,70,0,0
427,29/05/2021,3,5,305,146,159,100,0,0
167,26/05/2021,3,0,84,75,9,100,0,0
563,22/05/2021,3,2,68,68,0,NA,NA,NA
727,17/05/2021,3,2,73,47,26,55,0,0
749,30/05/2021,3,24,130,146,-16,NA,NA,NA
370,21/05/2021,3,0,40,25,15,75,0,0
853,25/05/2021,3,1,101,77,24,67,0,0
239,26/05/2021,3,0,40,32,8,82,0,0
720,26/05/2021,3,0,39,29,10,77,0,0
787,25/05/2021,3,2,106,69,37,105,0,0
705,21/05/2021,3,2,89,65,24,60,0,0
713,25/05/2021,3,1,60,45,15,143,0,0
915,24/05/2021,3,6,183,7,176,35,0,0
242,25/05/2021,3,3,135,68,67,57,0,0
265,15/05/2021,3,1,56,9,47,49,0,0
731,30/05/2021,3,5,94,64,30,57,0,0
848,30/05/2021,3,7,131,131,0,NA,NA,NA
372,26/05/2021,3,19,73,67,6,115,0,0
581,26/05/2021,3,43,182,148,34,72,0,0
512,27/05/2021,3,1,61,20,41,49,0,0
637,26/05/2021,3,1,73,45,28,159,0,0
838,25/05/2021,3,3,62,41,21,82,0,0
526,21/05/2021,3,1,37,27,10,60,0,0
361,25/05/2021,3,44,21,22,-1,NA,NA,NA
341,30/05/2021,3,47,67,67,0,NA,NA,NA
349,25/05/2021,3,6,84,49,35,64,0,0
180,30/05/2021,3,0,41,20,21,49,0,0
821,25/05/2021,3,0,79,57,22,108,0,0
203,25/05/2021,3,1,39,9,30,49,0,0
144,16/05/2021,3,1,98,11,87,49,0,0
863,29/05/2021,3,12,83,82,1,79,0,0
505,30/05/2021,3,0,84,72,12,63,0,0
63,28/05/2021,3,6,58,32,26,55,0,0
335,27/05/2021,3,5,81,50,31,49,0,0
579,21/05/2021,3,0,44,30,14,79,0,0
691,25/05/2021,3,1,31,30,1,127,0,0
854,30/05/2021,3,5,105,69,36,70,0,0
793,21/05/2021,3,2,129,60,69,55,0,0
328,29/05/2021,3,2,96,95,1,104,0,0
78,26/05/2021,3,0,44,24,20,159,0,0
189,25/05/2021,3,0,165,165,0,NA,NA,NA
343,25/05/2021,3,2,60,50,10,79,0,0
738,30/05/2021,3,1,123,122,1,75,0,0
501,27/05/2021,3,22,211,85,126,49,0,0
492,25/05/2021,3,3,34,24,10,62,0,0
248,29/05/2021,3,0,82,82,0,NA,NA,NA
21,30/05/2021,3,1,59,59,0,NA,NA,NA
595,13/05/2021,3,2,48,12,36,49,0,0
457,20/05/2021,3,3,60,41,19,52,0,0
469,23/05/2021,3,4,192,23,169,75,0,0
36,22/05/2021,3,2,61,47,14,74,0,0
896,23/05/2021,3,0,82,48,34,109,0,0
773,28/05/2021,3,1,73,58,15,67,0,0
724,30/05/2021,3,1,85,85,0,NA,NA,NA
157,27/05/2021,3,1,82,64,18,82,0,0
135,19/05/2021,3,4,62,54,8,85,0,0
8,19/05/2021,3,1,39,35,4,111,0,0
59,19/05/2021,3,1,74,25,49,49,0,0
237,25/05/2021,3,6,115,29,86,49,0,0
139,30/05/2021,3,2,57,57,0,NA,NA,NA
252,30/05/2021,3,47,217,96,121,49,0,0
816,27/05/2021,3,1,81,81,0,NA,NA,NA
563,21/05/2021,3,2,68,39,29,55,0,0
727,18/05/2021,3,2,73,55,18,67,0,0
87,30/05/2021,3,43,75,60,15,57,0,0
852,21/05/2021,3,0,80,78,2,146,0,0
833,23/05/2021,3,1,82,45,37,52,0,0
491,26/05/2021,3,6,173,58,115,49,0,0
726,26/05/2021,3,0,39,25,14,77,0,0
325,25/05/2021,3,1,44,26,18,74,0,0
614,25/05/2021,3,2,80,49,31,64,0,0
229,25/05/2021,3,3,53,48,5,113,0,0
67,25/05/2021,3,1,51,28,23,72,0,0
18,21/05/2021,3,2,90,62,28,67,0,0
265,16/05/2021,3,1,56,10,46,49,0,0
216,30/05/2021,3,2,56,24,32,49,0,0
451,30/05/2021,3,2,81,74,7,140,0,0
307,27/05/2021,3,1,78,69,9,62,0,0
792,26/05/2021,3,0,102,74,28,97,0,0
186,28/05/2021,3,1,57,47,10,67,0,0
797,26/05/2021,3,1,66,40,26,155,0,0
506,25/05/2021,3,2,193,58,135,49,0,0
184,19/05/2021,3,0,51,41,10,142,0,0
361,26/05/2021,3,44,21,21,0,NA,NA,NA
126,30/05/2021,3,2,118,118,0,NA,NA,NA
887,25/05/2021,3,19,304,28,276,39,0,0
432,30/05/2021,3,0,165,64,101,70,0,0
5,24/05/2021,3,5,84,51,33,55,0,0
327,25/05/2021,3,18,50,51,-1,NA,NA,NA
30,16/05/2021,3,1,70,21,49,49,0,0
534,30/05/2021,3,1,84,70,14,57,0,0
831,30/05/2021,3,1,149,88,61,57,0,0
26,30/05/2021,3,2,64,48,16,57,0,0
282,26/05/2021,3,27,674,124,550,49,0,0
579,22/05/2021,3,0,44,33,11,113,0,0
691,26/05/2021,3,1,31,23,8,85,0,0
274,30/05/2021,3,3,207,25,182,39,0,0
722,19/05/2021,3,0,42,41,1,93,0,0
359,30/05/2021,3,3,101,59,42,49,0,0
212,27/05/2021,3,1,77,55,22,72,0,0
276,23/05/2021,3,1,203,67,136,49,0,0
358,23/05/2021,3,2,91,42,49,49,0,0
88,30/05/2021,3,1,41,34,7,57,0,0
355,26/05/2021,3,2,97,77,20,67,0,0
586,25/05/2021,3,3,80,48,32,64,0,0
535,29/05/2021,3,2,81,78,3,119,0,0
214,30/05/2021,3,3,83,52,31,49,0,0
577,05/05/2021,3,0,78,13,65,49,0,0
453,21/05/2021,3,3,135,92,43,52,0,0
425,25/05/2021,3,10,240,42,198,90,0,0
405,22/05/2021,3,2,88,21,67,55,0,0
50,28/05/2021,3,2,119,118,1,101,0,0
645,25/05/2021,3,4,37,23,14,85,0,0
891,30/05/2021,3,16,66,66,0,NA,NA,NA
166,27/05/2021,3,1,65,61,4,63,0,0
542,19/05/2021,3,3,72,66,6,115,0,0
546,18/05/2021,3,12,140,27,113,49,0,0
802,18/05/2021,3,1,64,48,16,72,0,0
178,23/05/2021,3,1,37,15,22,49,0,0
622,30/05/2021,3,5,39,39,0,NA,NA,NA
427,30/05/2021,3,5,305,163,142,70,0,0
142,26/05/2021,3,2,60,45,15,97,0,0
113,21/05/2021,3,1,31,20,11,67,0,0
536,17/05/2021,3,3,78,28,50,64,0,0
435,30/05/2021,3,50,70,56,14,57,0,0
710,21/05/2021,3,0,20,13,7,60,0,0
853,22/05/2021,3,1,101,97,4,74,0,0
522,27/05/2021,3,4,58,46,12,63,0,0
169,28/05/2021,3,1,19,19,0,NA,NA,NA
539,25/05/2021,3,2,95,69,26,57,0,0
829,23/05/2021,3,2,148,16,132,49,0,0
770,25/05/2021,3,2,33,19,14,74,0,0
4,23/05/2021,3,1,63,44,19,82,0,0
236,21/05/2021,3,2,117,12,105,55,0,0
265,18/05/2021,3,1,56,28,28,49,0,0
263,30/05/2021,3,1,65,49,16,57,0,0
932,30/05/2021,3,21,86,6,80,45,0,0
659,25/05/2021,3,3,40,22,18,74,0,0
46,26/05/2021,3,1,59,48,11,80,0,0
825,28/05/2021,3,4,142,112,30,80,0,0
712,25/05/2021,3,7,78,37,41,49,0,0
110,25/05/2021,3,1,86,78,8,74,0,0
689,19/05/2021,3,0,130,94,36,57,0,0
864,25/05/2021,3,0,85,40,45,64,0,0
134,30/05/2021,3,1,47,47,0,NA,NA,NA
633,23/05/2021,3,1,49,11,38,49,0,0
84,23/05/2021,3,0,20,19,1,80,0,0
821,24/05/2021,3,0,79,68,11,90,0,0
818,24/05/2021,3,1,80,80,0,NA,NA,NA
842,14/05/2021,3,2,89,38,51,59,0,0
752,29/05/2021,3,0,44,43,1,142,0,0
709,30/05/2021,3,1,82,82,0,NA,NA,NA
345,28/05/2021,3,0,101,73,28,77,0,0
282,27/05/2021,3,25,676,177,499,49,0,0
579,23/05/2021,3,0,44,24,20,55,0,0
481,26/05/2021,3,0,56,26,30,67,0,0
588,30/05/2021,3,0,59,49,10,62,0,0
722,21/05/2021,3,0,42,34,8,67,0,0
328,30/05/2021,3,2,96,85,11,83,0,0
212,26/05/2021,3,1,77,54,23,72,0,0
696,23/05/2021,3,1,88,27,61,49,0,0
653,25/05/2021,3,3,112,39,73,49,0,0
815,30/05/2021,3,10,119,121,-2,NA,NA,NA
733,29/05/2021,3,1,99,82,17,60,0,0
69,25/05/2021,3,2,58,56,2,134,0,0
264,30/05/2021,3,1,59,49,10,62,0,0
346,30/05/2021,3,4,116,82,34,49,0,0
577,08/05/2021,3,0,78,9,69,49,0,0
453,22/05/2021,3,2,136,105,31,67,0,0
461,25/05/2021,3,2,120,18,102,95,0,0
336,25/05/2021,3,1,73,53,20,178,0,0
470,25/05/2021,3,3,77,77,0,NA,NA,NA
771,25/05/2021,3,2,28,16,12,74,0,0
459,30/05/2021,3,2,90,90,0,NA,NA,NA
298,28/05/2021,3,2,227,94,133,55,0,0
135,15/05/2021,3,5,61,10,51,49,0,0
761,18/05/2021,3,0,83,35,48,49,0,0
802,19/05/2021,3,1,64,57,7,90,0,0
735,23/05/2021,3,1,28,7,21,49,0,0
202,30/05/2021,3,0,76,76,0,NA,NA,NA
936,28/05/2021,3,0,80,11,69,92,0,0
173,26/05/2021,3,2,69,40,29,67,0,0
373,21/05/2021,3,1,102,71,31,60,0,0
908,17/05/2021,3,11,125,12,113,49,0,0
572,30/05/2021,3,0,61,48,13,57,0,0
100,22/05/2021,3,77,147,147,0,NA,NA,NA
768,25/05/2021,3,1,86,56,30,74,0,0
446,25/05/2021,3,7,126,76,50,52,0,0
169,29/05/2021,3,1,19,20,-1,NA,NA,NA
521,25/05/2021,3,1,54,27,27,67,0,0
829,24/05/2021,3,2,148,15,133,49,0,0
587,25/05/2021,3,2,79,44,35,74,0,0
4,25/05/2021,3,1,63,52,11,123,0,0
18,22/05/2021,3,2,90,89,1,87,0,0
701,16/05/2021,3,2,60,7,53,49,0,0
703,30/05/2021,3,0,91,75,16,70,0,0
475,30/05/2021,3,0,99,99,0,NA,NA,NA
85,27/05/2021,3,7,113,104,9,80,0,0
353,26/05/2021,3,1,51,39,12,72,0,0
683,27/05/2021,3,1,65,37,28,49,0,0
500,25/05/2021,3,6,73,24,49,49,0,0
352,27/05/2021,3,0,64,64,0,NA,NA,NA
184,20/05/2021,3,0,51,37,14,93,0,0
361,24/05/2021,3,44,21,23,-2,NA,NA,NA
706,30/05/2021,3,1,73,73,0,NA,NA,NA
564,22/05/2021,3,1,73,73,0,NA,NA,NA
76,23/05/2021,3,1,92,66,26,65,0,0
174,24/05/2021,3,2,26,21,5,67,0,0
53,25/05/2021,3,2,68,68,0,NA,NA,NA
30,17/05/2021,3,1,70,67,3,90,0,0
60,30/05/2021,3,0,57,52,5,62,0,0
277,30/05/2021,3,4,68,54,14,62,0,0
148,30/05/2021,3,0,25,24,1,115,0,0
419,26/05/2021,3,4,106,43,63,90,0,0
603,22/05/2021,3,0,84,84,0,NA,NA,NA
612,27/05/2021,3,1,41,41,0,NA,NA,NA
33,30/05/2021,3,4,76,77,-1,NA,NA,NA
722,18/05/2021,3,0,42,42,0,NA,NA,NA
288,30/05/2021,3,0,60,28,32,49,0,0
117,27/05/2021,3,1,93,74,19,92,0,0
785,25/05/2021,3,1,109,76,33,101,0,0
828,25/05/2021,3,0,75,69,6,123,0,0
334,30/05/2021,3,2,56,56,0,NA,NA,NA
499,26/05/2021,3,0,31,19,12,52,0,0
883,24/05/2021,3,6,98,12,86,45,0,0
104,29/05/2021,3,1,61,60,1,123,0,0
618,30/05/2021,3,7,144,93,51,49,0,0
577,11/05/2021,3,0,78,15,63,49,0,0
463,22/05/2021,3,5,158,114,44,140,0,0
24,21/05/2021,3,0,84,59,25,60,0,0
503,24/05/2021,3,0,184,69,115,49,0,0
470,26/05/2021,3,4,76,76,0,NA,NA,NA
645,26/05/2021,3,4,37,22,15,80,0,0
337,30/05/2021,3,0,60,37,23,52,0,0
774,29/05/2021,3,5,100,78,22,55,0,0
662,15/05/2021,3,2,105,16,89,49,0,0
682,23/05/2021,3,2,78,30,48,49,0,0
309,17/05/2021,3,0,16,15,1,128,0,0
54,25/05/2021,3,1,60,50,10,77,0,0
760,30/05/2021,3,0,36,36,0,NA,NA,NA
936,29/05/2021,3,0,80,42,38,107,0,0
209,27/05/2021,3,1,113,67,46,67,0,0
872,21/05/2021,3,1,64,45,19,93,0,0
727,16/05/2021,3,2,73,14,59,49,0,0
374,30/05/2021,3,0,56,52,4,62,0,0
122,21/05/2021,3,4,117,87,30,90,0,0
312,23/05/2021,3,2,95,33,62,49,0,0
450,25/05/2021,3,3,181,105,76,55,0,0
871,29/05/2021,3,2,76,76,0,NA,NA,NA
234,24/05/2021,3,2,60,52,8,62,0,0
829,25/05/2021,3,2,148,13,135,49,0,0
721,25/05/2021,3,39,101,81,20,161,0,0
560,23/05/2021,3,0,80,38,42,62,0,0
236,22/05/2021,3,2,117,11,106,55,0,0
1,14/05/2021,3,2,98,28,70,49,0,0
511,30/05/2021,3,0,76,51,25,52,0,0
262,30/05/2021,3,2,49,48,1,75,0,0
639,27/05/2021,3,0,59,38,21,57,0,0
231,27/05/2021,3,0,41,23,18,49,0,0
436,26/05/2021,3,9,197,77,120,55,0,0
566,25/05/2021,3,0,75,46,29,62,0,0
484,25/05/2021,3,0,40,31,9,79,0,0
259,22/05/2021,3,0,60,59,1,172,0,0
198,25/05/2021,3,0,135,135,0,NA,NA,NA
510,30/05/2021,3,2,141,97,44,49,0,0
633,22/05/2021,3,1,49,49,0,NA,NA,NA
385,22/05/2021,3,3,60,60,0,NA,NA,NA
407,24/05/2021,3,1,40,12,28,49,0,0
818,25/05/2021,3,1,80,80,0,NA,NA,NA
61,17/05/2021,3,1,99,67,32,52,0,0
235,29/05/2021,3,5,152,153,-1,NA,NA,NA
855,30/05/2021,3,3,173,134,39,52,0,0
678,15/05/2021,3,0,44,0,44,NA,NA,NA
419,27/05/2021,3,5,105,47,58,85,0,0
58,22/05/2021,3,1,66,66,0,NA,NA,NA
426,26/05/2021,3,8,155,105,50,69,0,0
623,30/05/2021,3,0,78,78,0,NA,NA,NA
671,19/05/2021,3,1,64,63,1,85,0,0
82,29/05/2021,3,0,96,95,1,103,0,0
117,25/05/2021,3,1,93,70,23,109,0,0
187,23/05/2021,3,1,40,16,24,49,0,0
741,25/05/2021,3,0,70,52,18,52,0,0
485,30/05/2021,3,0,65,65,0,NA,NA,NA
636,26/05/2021,3,0,120,69,51,74,0,0
795,25/05/2021,3,7,98,63,35,64,0,0
899,29/05/2021,3,0,105,105,0,NA,NA,NA
483,30/05/2021,3,4,95,85,10,63,0,0
577,12/05/2021,3,0,78,12,66,49,0,0
663,24/05/2021,3,6,142,14,128,115,0,0
578,21/05/2021,3,0,58,35,23,60,0,0
377,24/05/2021,3,0,149,138,11,79,0,0
819,24/05/2021,3,1,79,78,1,150,0,0
331,27/05/2021,3,28,66,44,22,106,0,0
319,30/05/2021,3,6,108,107,1,70,0,0
123,27/05/2021,3,5,90,37,53,49,0,0
344,16/05/2021,3,1,64,16,48,49,0,0
730,22/05/2021,3,1,74,61,13,67,0,0
161,18/05/2021,3,0,61,43,18,60,0,0
178,25/05/2021,3,1,37,35,2,80,0,0
518,30/05/2021,3,0,17,17,0,NA,NA,NA
417,28/05/2021,3,0,103,75,28,60,0,0
12,26/05/2021,3,1,42,30,12,57,0,0
113,23/05/2021,3,1,31,6,25,49,0,0
693,20/05/2021,3,2,123,43,80,49,0,0
533,30/05/2021,3,1,90,63,27,52,0,0
100,23/05/2021,3,77,147,73,74,49,0,0
540,23/05/2021,3,2,80,31,49,49,0,0
182,26/05/2021,3,2,78,41,37,49,0,0
649,25/05/2021,3,2,62,63,-1,NA,NA,NA
325,24/05/2021,3,0,45,23,22,57,0,0
409,22/05/2021,3,7,100,56,44,55,0,0
587,26/05/2021,3,2,79,42,37,74,0,0
560,24/05/2021,3,0,80,77,3,71,0,0
18,25/05/2021,3,2,90,70,20,74,0,0
660,17/05/2021,3,6,180,37,143,49,0,0
624,30/05/2021,3,0,79,56,23,57,0,0
617,30/05/2021,3,0,44,39,5,57,0,0
35,26/05/2021,3,0,110,35,75,49,0,0
145,27/05/2021,3,2,56,44,12,68,0,0
825,26/05/2021,3,4,142,61,81,57,0,0
114,25/05/2021,3,0,75,70,5,156,0,0
484,26/05/2021,3,0,40,28,12,67,0,0
689,21/05/2021,3,0,130,129,1,79,0,0
413,26/05/2021,3,3,113,74,39,52,0,0
743,30/05/2021,3,1,125,94,31,49,0,0
384,22/05/2021,3,0,101,101,0,NA,NA,NA
750,22/05/2021,3,3,109,109,0,NA,NA,NA
290,24/05/2021,3,2,105,60,45,55,0,0
921,24/05/2021,3,4,171,8,163,45,0,0
842,15/05/2021,3,2,89,49,40,59,0,0
658,29/05/2021,3,0,81,81,0,NA,NA,NA
434,30/05/2021,3,2,58,46,12,63,0,0
678,19/05/2021,3,0,44,0,44,NA,NA,NA
869,27/05/2021,3,1,59,50,9,138,0,0
603,21/05/2021,3,1,83,62,21,82,0,0
310,26/05/2021,3,1,71,55,16,67,0,0
480,30/05/2021,3,0,28,28,0,NA,NA,NA
671,17/05/2021,3,1,64,65,-1,NA,NA,NA
495,29/05/2021,3,1,84,83,1,84,0,0
330,25/05/2021,3,2,117,58,59,60,0,0
305,23/05/2021,3,13,46,36,10,52,0,0
641,23/05/2021,3,0,160,47,113,49,0,0
890,30/05/2021,3,0,150,150,0,NA,NA,NA
188,27/05/2021,3,7,114,95,19,52,0,0
613,25/05/2021,3,0,56,35,21,85,0,0
408,29/05/2021,3,7,158,157,1,162,0,0
363,30/05/2021,3,3,96,70,26,89,0,0
719,06/05/2021,3,0,41,12,29,59,0,0
663,19/05/2021,3,1,147,48,99,49,0,0
517,25/05/2021,3,0,58,42,16,65,0,0
377,22/05/2021,3,0,149,126,23,106,0,0
379,27/05/2021,3,18,269,160,109,85,0,0
331,28/05/2021,3,27,67,64,3,100,0,0
716,30/05/2021,3,1,103,81,22,62,0,0
298,27/05/2021,3,2,227,75,152,49,0,0
616,16/05/2021,3,3,72,9,63,49,0,0
730,20/05/2021,3,2,73,41,32,49,0,0
59,17/05/2021,3,0,75,16,59,49,0,0
735,25/05/2021,3,1,28,7,21,49,0,0
782,30/05/2021,3,0,20,20,0,NA,NA,NA
321,29/05/2021,3,1,39,37,2,84,0,0
209,26/05/2021,3,1,113,80,33,74,0,0
538,22/05/2021,3,1,43,37,6,79,0,0
908,19/05/2021,3,12,124,12,112,49,0,0
625,30/05/2021,3,3,158,130,28,62,0,0
89,21/05/2021,3,2,58,32,26,55,0,0
48,24/05/2021,3,2,177,24,153,49,0,0
522,25/05/2021,3,5,57,44,13,63,0,0
548,29/05/2021,3,1,90,91,-1,NA,NA,NA
539,24/05/2021,3,2,95,72,23,57,0,0
409,25/05/2021,3,7,100,67,33,57,0,0
721,26/05/2021,3,39,101,70,31,159,0,0
211,25/05/2021,3,3,57,49,8,74,0,0
236,25/05/2021,3,2,117,15,102,49,0,0
371,18/05/2021,3,1,35,31,4,95,0,0
583,30/05/2021,3,1,80,51,29,49,0,0
228,30/05/2021,3,2,40,31,9,57,0,0
197,25/05/2021,3,0,118,42,76,49,0,0
25,26/05/2021,3,1,51,37,14,60,0,0
15,27/05/2021,3,0,31,25,6,85,0,0
114,26/05/2021,3,0,75,62,13,140,0,0
728,26/05/2021,3,0,47,41,6,70,0,0
420,19/05/2021,3,1,68,68,0,NA,NA,NA
153,24/05/2021,3,2,62,40,22,67,0,0
45,30/05/2021,3,63,93,44,49,57,0,0
323,24/05/2021,3,0,31,27,4,89,0,0
857,22/05/2021,3,0,210,210,0,NA,NA,NA
107,25/05/2021,3,1,88,63,25,85,0,0
921,26/05/2021,3,11,164,36,128,45,0,0
850,14/05/2021,3,5,78,31,47,49,0,0
235,30/05/2021,3,5,152,112,40,52,0,0
837,30/05/2021,3,4,322,96,226,70,0,0
678,18/05/2021,3,0,44,0,44,NA,NA,NA
676,27/05/2021,3,1,114,79,35,52,0,0
308,22/05/2021,3,1,47,43,4,82,0,0
127,27/05/2021,3,1,59,48,11,74,0,0
767,30/05/2021,3,0,67,67,0,NA,NA,NA
671,18/05/2021,3,1,64,64,0,NA,NA,NA
454,29/05/2021,3,0,184,119,65,100,0,0
210,26/05/2021,3,2,100,94,6,79,0,0
423,25/05/2021,3,11,39,28,11,145,0,0
641,25/05/2021,3,0,160,50,110,49,0,0
723,30/05/2021,3,4,77,80,-3,NA,NA,NA
601,27/05/2021,3,5,63,45,18,62,0,0
398,25/05/2021,3,0,171,10,161,49,0,0
83,29/05/2021,3,10,158,160,-2,NA,NA,NA
845,30/05/2021,3,4,116,71,45,52,0,0
719,11/05/2021,3,0,41,20,21,59,0,0
840,19/05/2021,3,1,311,97,214,49,0,0
517,21/05/2021,3,0,58,34,24,55,0,0
377,23/05/2021,3,0,149,79,70,54,0,0
379,28/05/2021,3,12,275,213,62,98,0,0
645,28/05/2021,3,3,38,31,7,88,0,0
55,30/05/2021,3,1,32,20,12,49,0,0
585,28/05/2021,3,2,58,58,0,NA,NA,NA
68,18/05/2021,3,1,115,13,102,49,0,0
546,20/05/2021,3,11,141,59,82,49,0,0
473,17/05/2021,3,3,47,34,13,67,0,0
318,23/05/2021,3,0,59,40,19,52,0,0
642,30/05/2021,3,2,93,93,0,NA,NA,NA
138,28/05/2021,3,0,98,84,14,60,0,0
496,26/05/2021,3,1,59,18,41,49,0,0
538,23/05/2021,3,1,43,14,29,49,0,0
908,20/05/2021,3,11,125,24,101,49,0,0
205,30/05/2021,3,0,126,126,0,NA,NA,NA
753,22/05/2021,3,5,122,113,9,85,0,0
48,25/05/2021,3,2,177,26,151,49,0,0
707,27/05/2021,3,1,39,35,4,119,0,0
315,29/05/2021,3,0,62,62,0,NA,NA,NA
234,25/05/2021,3,2,60,56,4,71,0,0
424,23/05/2021,3,1,27,19,8,52,0,0
27,25/05/2021,3,0,78,64,14,114,0,0
669,25/05/2021,3,0,87,65,22,63,0,0
879,22/05/2021,3,3,161,19,142,39,0,0
823,15/05/2021,3,1,60,57,3,62,0,0
233,30/05/2021,3,2,65,51,14,70,0,0
193,30/05/2021,3,1,107,79,28,52,0,0
295,26/05/2021,3,2,103,24,79,49,0,0
792,27/05/2021,3,0,102,71,31,83,0,0
597,28/05/2021,3,3,98,74,24,60,0,0
824,26/05/2021,3,0,339,31,308,85,0,0
506,26/05/2021,3,1,194,65,129,49,0,0
526,19/05/2021,3,1,37,37,0,NA,NA,NA
42,24/05/2021,3,1,98,91,7,63,0,0
412,30/05/2021,3,10,91,82,9,62,0,0
887,23/05/2021,3,19,304,5,299,39,0,0
626,23/05/2021,3,2,100,42,58,49,0,0
559,25/05/2021,3,45,140,118,22,65,0,0
2,25/05/2021,3,3,56,48,8,89,0,0
604,17/05/2021,3,0,82,46,36,49,0,0
863,30/05/2021,3,2,93,70,23,57,0,0
314,30/05/2021,3,1,68,66,2,75,0,0
678,16/05/2021,3,0,44,0,44,NA,NA,NA
207,26/05/2021,3,2,61,34,27,59,0,0
715,23/05/2021,3,1,87,58,29,68,0,0
275,27/05/2021,3,0,117,75,42,80,0,0
860,30/05/2021,3,0,92,92,0,NA,NA,NA
41,17/05/2021,3,1,83,68,15,60,0,0
843,29/05/2021,3,1,65,61,4,87,0,0
807,26/05/2021,3,2,98,53,45,59,0,0
895,25/05/2021,3,0,69,60,9,74,0,0
156,24/05/2021,3,3,145,143,2,71,0,0
172,30/05/2021,3,2,83,83,0,NA,NA,NA
636,27/05/2021,3,0,120,96,24,63,0,0
378,24/05/2021,3,1,83,55,28,52,0,0
402,29/05/2021,3,3,152,153,-1,NA,NA,NA
208,30/05/2021,3,0,60,52,8,57,0,0
595,06/05/2021,3,2,48,16,32,49,0,0
463,21/05/2021,3,4,159,94,65,120,0,0
421,24/05/2021,3,0,19,18,1,112,0,0
605,22/05/2021,3,2,158,143,15,85,0,0
470,28/05/2021,3,3,77,57,20,67,0,0
771,28/05/2021,3,2,28,23,5,79,0,0
181,30/05/2021,3,0,34,32,2,123,0,0
798,21/05/2021,3,1,80,80,0,NA,NA,NA
756,19/05/2021,3,2,104,105,-1,NA,NA,NA
303,23/05/2021,3,2,63,37,26,49,0,0
443,18/05/2021,3,11,79,41,38,60,0,0
279,25/05/2021,3,0,57,35,22,67,0,0
422,30/05/2021,3,2,77,78,-1,NA,NA,NA
936,30/05/2021,3,0,80,67,13,65,0,0
394,26/05/2021,3,0,68,43,25,52,0,0
758,21/05/2021,3,0,73,62,11,94,0,0
908,18/05/2021,3,11,125,15,110,49,0,0
631,21/05/2021,3,1,70,32,38,55,0,0
745,21/05/2021,3,1,104,58,46,55,0,0
540,25/05/2021,3,2,80,43,37,49,0,0
296,27/05/2021,3,3,57,15,42,49,0,0
747,29/05/2021,3,1,63,63,0,NA,NA,NA
734,25/05/2021,3,1,60,59,1,85,0,0
424,22/05/2021,3,1,27,26,1,93,0,0
168,25/05/2021,3,0,48,40,8,90,0,0
4,24/05/2021,3,1,63,58,5,100,0,0
704,21/05/2021,3,1,31,29,2,74,0,0
111,15/05/2021,3,0,60,23,37,49,0,0
748,30/05/2021,3,7,137,89,48,49,0,0
865,30/05/2021,3,1,84,83,1,71,0,0
372,25/05/2021,3,19,73,63,10,106,0,0
507,26/05/2021,3,4,196,60,136,49,0,0
192,26/05/2021,3,1,85,51,34,52,0,0
824,27/05/2021,3,0,339,24,315,80,0,0
362,26/05/2021,3,3,117,104,13,82,0,0
593,22/05/2021,3,6,75,75,0,NA,NA,NA
147,25/05/2021,3,1,79,49,30,57,0,0
102,21/05/2021,3,0,60,60,0,NA,NA,NA
544,25/05/2021,3,0,53,26,27,49,0,0
180,22/05/2021,3,1,40,23,17,49,0,0
668,25/05/2021,3,4,299,49,250,49,0,0
96,25/05/2021,3,13,56,42,14,71,0,0
850,17/05/2021,3,3,80,58,22,49,0,0
632,30/05/2021,3,1,81,45,36,49,0,0
389,30/05/2021,3,2,124,110,14,62,0,0
678,17/05/2021,3,0,44,0,44,NA,NA,NA
781,27/05/2021,3,2,81,71,10,62,0,0
509,21/05/2021,3,1,111,37,74,55,0,0
52,26/05/2021,3,5,137,95,42,80,0,0
232,30/05/2021,3,2,63,65,-2,NA,NA,NA
602,19/05/2021,3,0,64,43,21,60,0,0
495,30/05/2021,3,1,84,77,7,62,0,0
212,25/05/2021,3,1,77,52,25,72,0,0
238,25/05/2021,3,0,66,56,10,77,0,0
343,24/05/2021,3,2,60,52,8,57,0,0
19,30/05/2021,3,1,93,93,0,NA,NA,NA
870,27/05/2021,3,3,43,34,9,60,0,0
406,24/05/2021,3,1,38,33,5,85,0,0
479,29/05/2021,3,3,52,53,-1,NA,NA,NA
725,22/05/2021,3,0,17,17,0,NA,NA,NA
874,11/05/2021,3,0,89,6,83,49,0,0
453,23/05/2021,3,2,136,63,73,55,0,0
24,23/05/2021,3,0,84,36,48,49,0,0
468,24/05/2021,3,3,93,64,29,57,0,0
470,23/05/2021,3,4,76,37,39,49,0,0
81,25/05/2021,3,1,59,11,48,49,0,0
313,30/05/2021,3,0,31,16,15,49,0,0
125,19/05/2021,3,2,34,34,0,NA,NA,NA
9,19/05/2021,3,0,27,27,0,NA,NA,NA
303,20/05/2021,3,2,63,39,24,72,0,0
802,17/05/2021,3,1,64,45,19,59,0,0
318,25/05/2021,3,0,59,58,1,129,0,0
3,30/05/2021,3,8,105,36,69,49,0,0
252,28/05/2021,3,2,262,77,185,49,0,0
12,27/05/2021,3,2,41,32,9,52,0,0
872,24/05/2021,3,1,64,64,0,NA,NA,NA
536,16/05/2021,3,1,80,15,65,49,0,0
374,22/05/2021,3,0,56,56,0,NA,NA,NA
753,21/05/2021,3,6,121,112,9,79,0,0
312,22/05/2021,3,2,95,50,45,101,0,0
790,26/05/2021,3,1,98,40,58,95,0,0
169,25/05/2021,3,1,19,19,0,NA,NA,NA
118,24/05/2021,3,2,57,13,44,49,0,0
829,22/05/2021,3,1,149,45,104,49,0,0
149,25/05/2021,3,0,88,76,12,101,0,0
806,24/05/2021,3,1,135,113,22,67,0,0
704,22/05/2021,3,1,31,29,2,74,0,0
391,16/05/2021,3,0,76,16,60,49,0,0
440,30/05/2021,3,0,265,91,174,70,0,0
183,30/05/2021,3,0,80,53,27,52,0,0
665,25/05/2021,3,2,104,48,56,67,0,0
652,27/05/2021,3,0,69,43,26,64,0,0
393,26/05/2021,3,1,59,39,20,57,0,0
356,25/05/2021,3,1,135,103,32,67,0,0
647,26/05/2021,3,4,89,75,14,57,0,0
778,22/05/2021,3,2,79,80,-1,NA,NA,NA
17,26/05/2021,3,1,93,75,18,74,0,0
582,19/05/2021,3,1,52,52,0,NA,NA,NA
544,22/05/2021,3,0,53,35,18,55,0,0
285,22/05/2021,3,1,79,76,3,84,0,0
476,25/05/2021,3,1,172,52,120,49,0,0
2,26/05/2021,3,3,56,37,19,80,0,0
604,16/05/2021,3,0,82,17,65,49,0,0
383,29/05/2021,3,3,82,81,1,113,0,0
176,30/05/2021,3,4,96,61,35,49,0,0
26,16/05/2021,3,3,63,8,55,49,0,0
629,26/05/2021,3,1,61,51,10,65,0,0
509,22/05/2021,3,1,111,86,25,60,0,0
612,26/05/2021,3,1,41,23,18,55,0,0
366,30/05/2021,3,3,77,76,1,NA,NA,NA
775,17/05/2021,3,5,104,45,59,49,0,0
288,29/05/2021,3,0,60,34,26,55,0,0
78,25/05/2021,3,0,44,28,16,167,0,0
895,23/05/2021,3,0,69,44,25,49,0,0
494,24/05/2021,3,4,135,84,51,52,0,0
101,30/05/2021,3,1,59,59,0,NA,NA,NA
501,28/05/2021,3,24,209,157,52,60,0,0
378,25/05/2021,3,1,83,67,16,74,0,0
83,30/05/2021,3,10,158,158,0,NA,NA,NA
346,22/05/2021,3,5,115,100,15,79,0,0
577,07/05/2021,3,0,78,4,74,49,0,0
463,23/05/2021,3,6,157,55,102,70,0,0
517,23/05/2021,3,0,58,15,43,49,0,0
283,22/05/2021,3,1,75,61,14,74,0,0
849,24/05/2021,3,2,82,46,36,49,0,0
116,26/05/2021,3,0,61,45,16,95,0,0
808,30/05/2021,3,2,166,162,4,103,0,0
125,20/05/2021,3,2,34,34,0,NA,NA,NA
9,18/05/2021,3,0,27,27,0,NA,NA,NA
447,20/05/2021,3,2,141,116,25,64,0,0
37,18/05/2021,3,0,81,55,26,52,0,0
155,23/05/2021,3,0,93,62,31,61,0,0
92,30/05/2021,3,1,121,81,40,52,0,0
252,29/05/2021,3,1,263,139,124,49,0,0
173,27/05/2021,3,2,69,57,12,60,0,0
430,21/05/2021,3,4,85,66,19,59,0,0
536,20/05/2021,3,1,80,44,36,59,0,0
572,22/05/2021,3,0,61,61,0,NA,NA,NA
745,22/05/2021,3,1,104,81,23,60,0,0
898,25/05/2021,3,2,98,73,25,73,0,0
401,26/05/2021,3,0,79,48,31,55,0,0
747,25/05/2021,3,0,64,64,0,NA,NA,NA
6,25/05/2021,3,0,190,23,167,49,0,0
170,22/05/2021,3,0,105,105,0,NA,NA,NA
149,26/05/2021,3,0,88,65,23,78,0,0
226,23/05/2021,3,0,47,34,13,72,0,0
765,23/05/2021,3,0,101,56,45,60,0,0
878,16/05/2021,3,0,218,2,216,44,0,0
841,30/05/2021,3,0,182,22,160,55,0,0
917,23/05/2021,3,1,105,6,99,35,0,0
85,26/05/2021,3,7,113,87,26,95,0,0
687,27/05/2021,3,2,85,52,33,49,0,0
474,26/05/2021,3,0,112,61,51,49,0,0
333,25/05/2021,3,1,56,45,11,122,0,0
838,26/05/2021,3,3,62,46,16,85,0,0
271,19/05/2021,3,0,70,49,21,60,0,0
147,26/05/2021,3,1,79,51,28,57,0,0
706,21/05/2021,3,1,73,73,0,NA,NA,NA
384,23/05/2021,3,0,101,57,44,49,0,0
432,22/05/2021,3,0,165,38,127,100,0,0
679,25/05/2021,3,0,89,49,40,64,0,0
386,25/05/2021,3,2,83,51,32,52,0,0
842,16/05/2021,3,2,89,37,52,49,0,0
632,29/05/2021,3,1,81,55,26,55,0,0
837,23/05/2021,3,4,322,25,297,70,0,0
148,15/05/2021,3,0,25,10,15,49,0,0
629,27/05/2021,3,1,61,46,15,52,0,0
403,22/05/2021,3,2,96,57,39,108,0,0
52,27/05/2021,3,5,137,123,14,77,0,0
120,22/05/2021,3,2,152,151,1,90,0,0
793,18/05/2021,3,2,129,37,92,49,0,0
454,16/05/2021,3,0,184,1,183,66,0,0
78,27/05/2021,3,0,44,36,8,134,0,0
189,24/05/2021,3,0,165,114,51,64,0,0
156,23/05/2021,3,1,147,58,89,49,0,0
520,30/05/2021,3,0,58,58,0,NA,NA,NA
859,28/05/2021,3,1,84,83,1,69,0,0
175,24/05/2021,3,14,106,52,54,49,0,0
402,30/05/2021,3,3,152,154,-2,NA,NA,NA
363,22/05/2021,3,3,96,79,17,136,0,0
876,05/05/2021,3,1,181,47,134,45,0,0
457,23/05/2021,3,4,59,27,32,49,0,0
421,21/05/2021,3,0,19,16,3,108,0,0
599,23/05/2021,3,1,152,89,63,56,0,0
896,24/05/2021,3,0,82,55,27,129,0,0
116,25/05/2021,3,0,61,53,8,97,0,0
911,30/05/2021,3,0,158,96,62,49,0,0
166,21/05/2021,3,3,63,63,0,NA,NA,NA
756,18/05/2021,3,2,104,104,0,NA,NA,NA
447,23/05/2021,3,0,143,123,20,57,0,0
95,17/05/2021,3,1,87,59,28,52,0,0
565,25/05/2021,3,0,62,62,0,NA,NA,NA
204,30/05/2021,3,0,64,61,3,87,0,0
836,28/05/2021,3,0,101,101,0,NA,NA,NA
862,27/05/2021,3,2,108,77,31,57,0,0
839,22/05/2021,3,3,152,145,7,74,0,0
536,18/05/2021,3,1,80,27,53,72,0,0
205,21/05/2021,3,0,126,54,72,58,0,0
745,23/05/2021,3,1,104,61,43,49,0,0
249,24/05/2021,3,2,125,108,17,55,0,0
401,25/05/2021,3,0,79,52,27,60,0,0
720,29/05/2021,3,0,39,39,0,NA,NA,NA
230,25/05/2021,3,1,79,41,38,49,0,0
829,21/05/2021,3,0,150,39,111,49,0,0
168,26/05/2021,3,0,48,39,9,87,0,0
368,24/05/2021,3,1,84,33,51,89,0,0
18,23/05/2021,3,2,90,34,56,49,0,0
701,15/05/2021,3,1,61,15,46,49,0,0
216,22/05/2021,3,1,57,41,16,67,0,0
917,22/05/2021,3,1,105,9,96,35,0,0
270,26/05/2021,3,1,59,37,22,116,0,0
133,27/05/2021,3,1,63,45,18,62,0,0
269,27/05/2021,3,0,80,49,31,49,0,0
566,26/05/2021,3,0,75,37,38,52,0,0
362,27/05/2021,3,4,116,85,31,80,0,0
184,21/05/2021,3,0,51,51,0,NA,NA,NA
287,24/05/2021,3,1,122,61,61,49,0,0
341,21/05/2021,3,2,112,111,1,113,0,0
77,23/05/2021,3,0,103,38,65,71,0,0
294,23/05/2021,3,0,117,46,71,49,0,0
290,25/05/2021,3,2,105,55,50,55,0,0
53,24/05/2021,3,0,70,70,0,NA,NA,NA
185,14/05/2021,3,1,167,19,148,49,0,0
383,30/05/2021,3,8,77,63,14,83,0,0
121,22/05/2021,3,1,109,109,0,NA,NA,NA
810,15/05/2021,3,0,389,8,381,55,0,0
869,26/05/2021,3,1,59,45,14,143,0,0
472,21/05/2021,3,2,232,102,130,90,0,0
222,27/05/2021,3,0,77,50,27,57,0,0
232,23/05/2021,3,1,64,51,13,75,0,0
775,20/05/2021,3,3,106,70,36,49,0,0
495,14/05/2021,3,2,83,7,76,49,0,0
411,26/05/2021,3,0,185,81,104,55,0,0
400,24/05/2021,3,3,27,16,11,49,0,0
201,23/05/2021,3,8,130,29,101,49,0,0
723,23/05/2021,3,2,79,25,54,49,0,0
80,28/05/2021,3,2,123,47,76,55,0,0
586,24/05/2021,3,4,79,49,30,59,0,0
112,29/05/2021,3,0,84,80,4,89,0,0
483,23/05/2021,3,5,94,28,66,49,0,0
876,09/05/2021,3,1,181,29,152,45,0,0
463,24/05/2021,3,6,157,50,107,100,0,0
421,25/05/2021,3,0,19,19,0,NA,NA,NA
36,23/05/2021,3,2,61,22,39,49,0,0
573,23/05/2021,3,0,57,40,17,52,0,0
351,28/05/2021,3,0,66,64,2,153,0,0
814,30/05/2021,3,1,67,66,1,81,0,0
105,20/05/2021,3,5,70,63,7,82,0,0
68,17/05/2021,3,0,116,18,98,49,0,0
268,20/05/2021,3,1,77,69,8,82,0,0
195,17/05/2021,3,1,50,30,20,62,0,0
786,23/05/2021,3,2,60,33,27,55,0,0
518,22/05/2021,3,1,16,16,0,NA,NA,NA
213,30/05/2021,3,3,145,145,0,NA,NA,NA
862,26/05/2021,3,1,109,84,25,63,0,0
650,21/05/2021,3,1,127,86,41,55,0,0
302,19/05/2021,3,0,61,33,28,49,0,0
749,21/05/2021,3,4,150,87,63,49,0,0
852,22/05/2021,3,0,80,53,27,104,0,0
249,25/05/2021,3,2,125,105,20,55,0,0
281,25/05/2021,3,2,81,64,17,76,0,0
726,29/05/2021,3,0,39,39,0,NA,NA,NA
873,25/05/2021,3,4,97,79,18,57,0,0
866,22/05/2021,3,0,100,64,36,79,0,0
567,26/05/2021,3,0,61,46,15,74,0,0
211,23/05/2021,3,3,57,35,22,49,0,0
47,22/05/2021,3,1,56,46,10,92,0,0
701,13/05/2021,3,2,60,32,28,55,0,0
369,22/05/2021,3,3,87,47,40,96,0,0
917,24/05/2021,3,1,105,2,103,35,0,0
295,25/05/2021,3,2,103,23,80,49,0,0
353,27/05/2021,3,1,51,35,16,72,0,0
192,27/05/2021,3,0,86,50,36,49,0,0
846,26/05/2021,3,1,188,82,106,45,0,0
574,27/05/2021,3,12,75,41,34,49,0,0
190,19/05/2021,3,3,77,37,40,49,0,0
287,25/05/2021,3,1,122,68,54,49,0,0
582,18/05/2021,3,1,52,50,2,90,0,0
323,23/05/2021,3,0,31,24,7,57,0,0
143,23/05/2021,3,3,117,64,53,54,0,0
38,24/05/2021,3,2,48,39,9,74,0,0
757,26/05/2021,3,0,117,114,3,118,0,0
185,16/05/2021,3,1,167,20,147,49,0,0
418,29/05/2021,3,0,116,113,3,67,0,0
709,22/05/2021,3,0,83,83,0,NA,NA,NA
810,16/05/2021,3,0,389,7,382,55,0,0
347,26/05/2021,3,22,40,34,6,95,0,0
764,21/05/2021,3,2,67,22,45,55,0,0
326,27/05/2021,3,2,79,50,29,55,0,0
767,22/05/2021,3,1,66,45,21,79,0,0
793,20/05/2021,3,2,129,62,67,49,0,0
328,11/05/2021,3,3,95,66,29,64,0,0
411,27/05/2021,3,0,185,108,77,55,0,0
777,24/05/2021,3,3,117,56,61,52,0,0
201,24/05/2021,3,8,130,86,44,49,0,0
466,22/05/2021,3,3,137,114,23,57,0,0
697,26/05/2021,3,2,107,38,69,60,0,0
477,25/05/2021,3,5,115,38,77,49,0,0
272,30/05/2021,3,4,123,109,14,83,0,0
208,23/05/2021,3,0,60,12,48,49,0,0
874,10/05/2021,3,0,89,3,86,49,0,0
635,19/05/2021,3,0,88,71,17,62,0,0
421,22/05/2021,3,0,19,19,0,NA,NA,NA
283,23/05/2021,3,1,75,23,52,49,0,0
849,23/05/2021,3,0,84,31,53,49,0,0
552,15/05/2021,3,12,172,26,146,49,0,0
301,30/05/2021,3,1,100,56,44,49,0,0
105,21/05/2021,3,6,69,60,9,76,0,0
756,17/05/2021,3,1,105,104,1,85,0,0
447,19/05/2021,3,0,143,107,36,72,0,0
443,17/05/2021,3,11,79,51,28,52,0,0
786,25/05/2021,3,2,60,40,20,101,0,0
782,22/05/2021,3,1,19,19,0,NA,NA,NA
266,25/05/2021,3,0,61,45,16,80,0,0
433,26/05/2021,3,1,317,72,245,100,0,0
575,22/05/2021,3,1,49,42,7,67,0,0
693,19/05/2021,3,0,125,33,92,49,0,0
749,22/05/2021,3,17,137,142,-5,NA,NA,NA
710,23/05/2021,3,0,20,9,11,49,0,0
348,24/05/2021,3,8,132,128,4,63,0,0
784,25/05/2021,3,3,46,26,20,101,0,0
169,19/05/2021,3,1,19,18,1,119,0,0
284,24/05/2021,3,1,25,15,10,62,0,0
717,23/05/2021,3,3,190,54,136,49,0,0
794,26/05/2021,3,0,137,51,86,85,0,0
437,23/05/2021,3,2,163,54,109,49,0,0
242,24/05/2021,3,5,133,64,69,52,0,0
1,17/05/2021,3,1,99,87,12,79,0,0
511,23/05/2021,3,0,76,24,52,49,0,0
475,22/05/2021,3,1,98,85,13,125,0,0
85,22/05/2021,3,7,113,102,11,169,0,0
591,27/05/2021,3,0,68,51,17,67,0,0
474,27/05/2021,3,0,112,77,35,49,0,0
465,26/05/2021,3,32,235,125,110,55,0,0
647,27/05/2021,3,3,90,89,1,63,0,0
151,20/05/2021,3,6,70,49,21,60,0,0
287,26/05/2021,3,1,122,67,55,49,0,0
134,18/05/2021,3,1,47,26,21,60,0,0
384,24/05/2021,3,0,101,73,28,60,0,0
206,22/05/2021,3,16,197,53,144,59,0,0
559,24/05/2021,3,45,140,99,41,62,0,0
158,25/05/2021,3,0,24,16,8,90,0,0
144,17/05/2021,3,1,98,43,55,49,0,0
918,29/05/2021,3,0,201,19,182,39,0,0
835,22/05/2021,3,5,99,99,0,NA,NA,NA
148,17/05/2021,3,0,25,17,8,57,0,0
515,26/05/2021,3,5,107,58,49,57,0,0
472,23/05/2021,3,5,229,60,169,70,0,0
426,27/05/2021,3,7,156,102,54,64,0,0
392,22/05/2021,3,6,170,145,25,74,0,0
793,19/05/2021,3,2,129,48,81,49,0,0
495,12/05/2021,3,2,83,14,69,49,0,0
210,25/05/2021,3,2,100,90,10,79,0,0
696,24/05/2021,3,1,88,59,29,52,0,0
741,24/05/2021,3,0,70,54,16,52,0,0
101,22/05/2021,3,1,59,52,7,88,0,0
656,27/05/2021,3,1,114,96,18,76,0,0
558,24/05/2021,3,0,44,21,23,52,0,0
104,30/05/2021,3,1,61,56,5,103,0,0
31,22/05/2021,3,1,62,55,7,67,0,0
876,12/05/2021,3,2,180,61,119,45,0,0
655,21/05/2021,3,0,72,50,22,89,0,0
517,22/05/2021,3,0,58,58,0,NA,NA,NA
605,23/05/2021,3,8,152,40,112,49,0,0
573,24/05/2021,3,0,57,38,19,52,0,0
771,17/05/2021,3,2,28,28,0,NA,NA,NA
856,30/05/2021,3,0,120,121,-1,NA,NA,NA
125,21/05/2021,3,2,34,31,3,100,0,0
344,19/05/2021,3,1,64,59,5,63,0,0
761,19/05/2021,3,0,83,35,48,49,0,0
473,18/05/2021,3,4,46,39,7,80,0,0
628,23/05/2021,3,2,57,40,17,63,0,0
3,23/05/2021,3,8,105,23,82,49,0,0
836,25/05/2021,3,0,101,93,8,74,0,0
739,26/05/2021,3,2,73,31,42,49,0,0
373,23/05/2021,3,1,102,37,65,49,0,0
367,17/05/2021,3,0,74,25,49,55,0,0
246,21/05/2021,3,1,111,51,60,55,0,0
370,23/05/2021,3,0,40,16,24,49,0,0
348,25/05/2021,3,8,132,125,7,77,0,0
522,26/05/2021,3,5,57,51,6,65,0,0
649,19/05/2021,3,2,62,61,1,127,0,0
787,24/05/2021,3,2,106,71,35,82,0,0
409,24/05/2021,3,7,100,62,38,49,0,0
164,26/05/2021,3,0,62,35,27,57,0,0
57,24/05/2021,3,1,139,73,66,49,0,0
221,23/05/2021,3,0,62,21,41,49,0,0
823,16/05/2021,3,1,60,42,18,52,0,0
685,22/05/2021,3,2,138,137,1,137,0,0
865,23/05/2021,3,1,84,10,74,49,0,0
674,23/05/2021,3,1,97,15,82,49,0,0
448,27/05/2021,3,2,151,67,84,95,0,0
251,28/05/2021,3,1,123,46,77,49,0,0
846,27/05/2021,3,1,188,89,99,45,0,0
838,27/05/2021,3,3,62,51,11,63,0,0
778,20/05/2021,3,2,79,74,5,127,0,0
198,26/05/2021,3,0,135,127,8,85,0,0
510,21/05/2021,3,1,142,59,83,55,0,0
544,24/05/2021,3,0,53,29,24,49,0,0
220,22/05/2021,3,8,95,93,2,114,0,0
357,24/05/2021,3,2,81,58,23,67,0,0
830,25/05/2021,3,0,66,42,24,151,0,0
30,14/05/2021,3,1,70,21,49,49,0,0
534,29/05/2021,3,1,84,83,1,74,0,0
103,22/05/2021,3,1,160,160,0,NA,NA,NA
148,18/05/2021,3,0,25,22,3,77,0,0
592,27/05/2021,3,1,83,70,13,82,0,0
438,22/05/2021,3,9,87,56,31,59,0,0
691,27/05/2021,3,1,31,30,1,95,0,0
33,22/05/2021,3,3,77,75,2,113,0,0
793,17/05/2021,3,2,129,35,94,49,0,0
359,14/05/2021,3,3,101,16,85,49,0,0
330,27/05/2021,3,2,117,54,63,55,0,0
897,24/05/2021,3,6,102,29,73,55,0,0
562,24/05/2021,3,0,68,56,12,63,0,0
88,22/05/2021,3,1,41,39,2,77,0,0
499,27/05/2021,3,0,31,19,12,49,0,0
613,24/05/2021,3,0,56,37,19,64,0,0
248,30/05/2021,3,0,82,60,22,63,0,0
664,22/05/2021,3,8,147,110,37,117,0,0
532,07/05/2021,3,0,84,17,67,49,0,0
635,20/05/2021,3,0,88,67,21,57,0,0
260,21/05/2021,3,1,119,106,13,89,0,0
605,24/05/2021,3,14,146,66,80,49,0,0
379,25/05/2021,3,19,268,153,115,90,0,0
81,15/05/2021,3,1,59,5,54,49,0,0
98,30/05/2021,3,2,93,93,0,NA,NA,NA
497,21/05/2021,3,3,190,169,21,67,0,0
933,17/05/2021,3,116,31,15,16,35,0,0
682,22/05/2021,3,1,79,69,10,67,0,0
37,19/05/2021,3,2,79,55,24,52,0,0
318,24/05/2021,3,0,59,57,2,94,0,0
760,23/05/2021,3,2,34,14,20,49,0,0
128,25/05/2021,3,1,20,16,4,80,0,0
390,27/05/2021,3,2,134,94,40,49,0,0
551,21/05/2021,3,0,115,68,47,55,0,0
693,16/05/2021,3,0,125,24,101,49,0,0
533,21/05/2021,3,1,90,23,67,55,0,0
615,22/05/2021,3,0,71,60,11,132,0,0
300,22/05/2021,3,0,210,138,72,80,0,0
281,26/05/2021,3,1,82,32,50,49,0,0
315,17/05/2021,3,0,62,49,13,72,0,0
258,25/05/2021,3,1,142,98,44,82,0,0
170,21/05/2021,3,0,105,69,36,60,0,0
811,25/05/2021,3,2,88,40,48,64,0,0
498,24/05/2021,3,0,87,56,31,49,0,0
765,21/05/2021,3,0,101,92,9,100,0,0
111,13/05/2021,3,0,60,41,19,72,0,0
86,23/05/2021,3,2,46,25,21,49,0,0
228,22/05/2021,3,2,40,15,25,55,0,0
295,22/05/2021,3,3,102,14,88,55,0,0
652,26/05/2021,3,0,69,51,18,64,0,0
350,26/05/2021,3,3,57,41,16,74,0,0
465,27/05/2021,3,33,234,160,74,55,0,0
647,25/05/2021,3,2,91,73,18,62,0,0
151,21/05/2021,3,6,70,51,19,60,0,0
332,26/05/2021,3,0,40,28,12,67,0,0
412,18/05/2021,3,8,93,23,70,49,0,0
75,25/05/2021,3,0,81,56,25,88,0,0
626,22/05/2021,3,4,98,89,9,79,0,0
668,24/05/2021,3,7,296,31,265,49,0,0
53,26/05/2021,3,0,70,64,6,142,0,0
61,14/05/2021,3,1,99,20,79,49,0,0
681,30/05/2021,3,4,67,66,1,70,0,0
434,22/05/2021,3,2,58,10,48,55,0,0
810,18/05/2021,3,0,389,41,348,55,0,0
20,27/05/2021,3,1,81,59,22,72,0,0
472,22/05/2021,3,5,229,131,98,100,0,0
452,26/05/2021,3,2,58,33,25,69,0,0
860,22/05/2021,3,2,90,63,27,72,0,0
449,17/05/2021,3,2,93,18,75,66,0,0
495,15/05/2021,3,2,83,11,72,49,0,0
338,27/05/2021,3,4,396,108,288,49,0,0
895,24/05/2021,3,0,69,61,8,62,0,0
621,24/05/2021,3,0,60,44,16,77,0,0
803,23/05/2021,3,1,68,50,18,73,0,0
733,27/05/2021,3,0,100,38,62,49,0,0
858,25/05/2021,3,0,81,80,1,127,0,0
804,30/05/2021,3,4,141,139,2,62,0,0
827,22/05/2021,3,1,69,68,1,119,0,0
577,09/05/2021,3,0,78,12,66,49,0,0
692,21/05/2021,3,0,87,70,17,76,0,0
651,22/05/2021,3,1,77,49,28,55,0,0
640,24/05/2021,3,5,121,50,71,49,0,0
849,25/05/2021,3,2,82,39,43,49,0,0
606,15/05/2021,3,1,45,5,40,49,0,0
698,30/05/2021,3,2,114,114,0,NA,NA,NA
196,19/05/2021,3,0,138,26,112,49,0,0
428,18/05/2021,3,4,88,63,25,72,0,0
471,18/05/2021,3,4,116,94,22,72,0,0
161,17/05/2021,3,0,61,39,22,60,0,0
458,23/05/2021,3,4,177,96,81,49,0,0
518,23/05/2021,3,1,16,11,5,75,0,0
128,23/05/2021,3,1,20,5,15,49,0,0
433,27/05/2021,3,1,317,84,233,95,0,0
551,24/05/2021,3,0,115,77,38,49,0,0
367,20/05/2021,3,0,74,48,26,55,0,0
533,22/05/2021,3,1,90,27,63,55,0,0
278,23/05/2021,3,0,105,28,77,49,0,0
670,24/05/2021,3,0,108,79,29,125,0,0
416,26/05/2021,3,0,34,10,24,49,0,0
548,20/05/2021,3,0,91,79,12,62,0,0
258,24/05/2021,3,1,142,97,45,67,0,0
717,21/05/2021,3,3,190,83,107,49,0,0
229,24/05/2021,3,5,51,51,0,NA,NA,NA
57,23/05/2021,3,1,139,49,90,49,0,0
765,24/05/2021,3,0,101,69,32,80,0,0
878,13/05/2021,3,0,218,8,210,44,0,0
634,23/05/2021,3,0,20,19,1,62,0,0
228,23/05/2021,3,2,40,8,32,49,0,0
372,22/05/2021,3,17,75,64,11,169,0,0
46,27/05/2021,3,1,59,45,14,67,0,0
56,28/05/2021,3,0,65,53,12,67,0,0
566,27/05/2021,3,1,74,38,36,49,0,0
439,26/05/2021,3,3,88,27,61,49,0,0
151,19/05/2021,3,6,70,52,18,74,0,0
864,26/05/2021,3,0,85,29,56,64,0,0
412,19/05/2021,3,8,93,33,60,49,0,0
544,21/05/2021,3,0,53,30,23,55,0,0
220,23/05/2021,3,9,94,67,27,76,0,0
357,25/05/2021,3,2,81,70,11,74,0,0
386,26/05/2021,3,2,83,54,29,52,0,0
144,14/05/2021,3,1,98,32,66,49,0,0
918,30/05/2021,3,0,201,22,179,39,0,0
257,22/05/2021,3,1,43,43,0,NA,NA,NA
345,19/05/2021,3,0,101,96,5,89,0,0
789,27/05/2021,3,1,71,51,20,74,0,0
218,23/05/2021,3,3,75,47,28,49,0,0
227,25/05/2021,3,2,42,26,16,49,0,0
366,23/05/2021,3,2,78,67,11,77,0,0
449,18/05/2021,3,2,93,18,75,66,0,0
288,11/05/2021,3,0,60,43,17,77,0,0
117,26/05/2021,3,1,93,67,26,108,0,0
276,25/05/2021,3,1,203,82,121,49,0,0
179,23/05/2021,3,1,91,21,70,49,0,0
88,23/05/2021,3,1,41,19,22,49,0,0
97,26/05/2021,3,4,103,67,36,82,0,0
504,25/05/2021,3,0,83,21,62,49,0,0
535,30/05/2021,3,1,82,80,2,75,0,0
664,23/05/2021,3,9,146,94,52,61,0,0
532,10/05/2021,3,0,84,71,13,80,0,0
635,22/05/2021,3,0,88,81,7,74,0,0
651,24/05/2021,3,1,77,28,49,49,0,0
36,25/05/2021,3,1,62,33,29,49,0,0
23,25/05/2021,3,0,64,43,21,60,0,0
645,15/05/2021,3,2,39,16,23,49,0,0
913,30/05/2021,3,0,105,105,0,NA,NA,NA
157,19/05/2021,3,2,81,71,10,80,0,0
542,18/05/2021,3,3,72,61,11,115,0,0
22,19/05/2021,3,0,64,58,6,89,0,0
95,19/05/2021,3,1,87,62,25,67,0,0
279,24/05/2021,3,0,57,31,26,55,0,0
782,23/05/2021,3,1,19,17,2,73,0,0
163,24/05/2021,3,1,61,61,0,NA,NA,NA
529,26/05/2021,3,3,38,33,5,71,0,0
575,21/05/2021,3,1,49,34,15,60,0,0
302,20/05/2021,3,0,61,46,15,57,0,0
631,22/05/2021,3,1,70,36,34,55,0,0
615,23/05/2021,3,0,71,31,40,49,0,0
397,22/05/2021,3,0,75,63,12,67,0,0
446,26/05/2021,3,7,126,76,50,52,0,0
720,19/05/2021,3,0,39,30,9,67,0,0
364,24/05/2021,3,2,128,116,12,85,0,0
717,22/05/2021,3,3,190,87,103,55,0,0
90,24/05/2021,3,0,78,43,35,49,0,0
67,23/05/2021,3,1,51,25,26,49,0,0
765,25/05/2021,3,0,101,70,31,82,0,0
265,13/05/2021,3,1,56,23,33,49,0,0
487,24/05/2021,3,0,39,18,21,57,0,0
106,22/05/2021,3,1,30,20,10,103,0,0
674,22/05/2021,3,1,97,83,14,74,0,0
581,27/05/2021,3,38,187,156,31,67,0,0
162,27/05/2021,3,1,121,83,38,75,0,0
712,27/05/2021,3,8,77,45,32,49,0,0
574,26/05/2021,3,12,75,30,45,49,0,0
420,20/05/2021,3,1,68,54,14,74,0,0
42,26/05/2021,3,0,99,73,26,67,0,0
45,21/05/2021,3,1,155,17,138,49,0,0
556,21/05/2021,3,0,117,102,15,92,0,0
750,23/05/2021,3,3,109,76,33,74,0,0
107,24/05/2021,3,1,88,65,23,85,0,0
158,24/05/2021,3,0,24,16,8,72,0,0
124,15/05/2021,3,1,53,9,44,49,0,0
418,30/05/2021,3,0,116,64,52,49,0,0
389,22/05/2021,3,2,124,124,0,NA,NA,NA
148,16/05/2021,3,0,25,7,18,49,0,0
254,26/05/2021,3,1,77,27,50,64,0,0
322,22/05/2021,3,2,98,75,23,60,0,0
742,26/05/2021,3,1,73,42,31,52,0,0
120,24/05/2021,3,2,152,97,55,57,0,0
775,19/05/2021,3,3,106,51,55,49,0,0
454,11/05/2021,3,0,184,11,173,66,0,0
304,27/05/2021,3,0,60,47,13,64,0,0
187,24/05/2021,3,1,40,26,14,65,0,0
653,23/05/2021,3,2,113,34,79,49,0,0
99,23/05/2021,3,1,166,74,92,49,0,0
97,28/05/2021,3,5,102,91,11,76,0,0
504,24/05/2021,3,0,83,19,64,49,0,0
112,30/05/2021,3,0,84,78,6,70,0,0
827,23/05/2021,3,1,69,47,22,64,0,0
532,11/05/2021,3,0,84,83,1,90,0,0
692,24/05/2021,3,0,87,34,53,49,0,0
578,25/05/2021,3,1,57,47,10,49,0,0
640,25/05/2021,3,5,121,52,69,49,0,0
573,25/05/2021,3,0,57,34,23,67,0,0
291,16/05/2021,3,1,60,21,39,49,0,0
844,25/05/2021,3,0,61,29,32,80,0,0
298,19/05/2021,3,2,227,50,177,49,0,0
662,18/05/2021,3,2,105,56,49,60,0,0
730,19/05/2021,3,2,73,49,24,52,0,0
161,19/05/2021,3,1,60,42,18,67,0,0
565,24/05/2021,3,0,62,37,25,80,0,0
754,22/05/2021,3,0,62,26,36,55,0,0
138,23/05/2021,3,0,98,32,66,49,0,0
529,27/05/2021,3,3,38,32,6,62,0,0
839,21/05/2021,3,5,150,121,29,57,0,0
693,17/05/2021,3,0,125,47,78,49,0,0
737,20/05/2021,3,2,40,31,9,57,0,0
122,22/05/2021,3,3,118,107,11,132,0,0
833,25/05/2021,3,0,83,67,16,65,0,0
239,27/05/2021,3,0,40,30,10,80,0,0
726,19/05/2021,3,0,39,33,6,90,0,0
521,24/05/2021,3,1,54,28,26,49,0,0
11,23/05/2021,3,3,81,29,52,49,0,0
159,24/05/2021,3,0,77,60,17,49,0,0
669,23/05/2021,3,0,87,35,52,49,0,0
826,24/05/2021,3,2,96,77,19,52,0,0
823,13/05/2021,3,1,60,33,27,49,0,0
634,24/05/2021,3,0,20,19,1,126,0,0
106,24/05/2021,3,1,30,14,16,82,0,0
372,23/05/2021,3,18,74,67,7,88,0,0
119,27/05/2021,3,2,66,42,24,49,0,0
162,28/05/2021,3,1,121,108,13,94,0,0
712,26/05/2021,3,7,78,37,41,49,0,0
404,25/05/2021,3,0,67,36,31,159,0,0
420,21/05/2021,3,1,68,51,17,99,0,0
571,26/05/2021,3,2,159,26,133,49,0,0
510,18/05/2021,3,1,142,18,124,49,0,0
75,23/05/2021,3,0,81,48,33,53,0,0
180,23/05/2021,3,1,40,12,28,49,0,0
316,24/05/2021,3,1,38,36,2,126,0,0
410,24/05/2021,3,0,56,27,29,49,0,0
185,15/05/2021,3,1,167,24,143,49,0,0
658,21/05/2021,3,1,80,75,5,123,0,0
176,22/05/2021,3,1,99,90,9,67,0,0
345,18/05/2021,3,0,101,101,0,NA,NA,NA
335,26/05/2021,3,5,81,40,41,55,0,0
58,21/05/2021,3,2,65,46,19,55,0,0
310,27/05/2021,3,1,71,58,13,67,0,0
232,24/05/2021,3,1,64,43,21,89,0,0
602,20/05/2021,3,0,64,31,33,49,0,0
454,14/05/2021,3,0,184,6,178,66,0,0
411,25/05/2021,3,1,184,69,115,55,0,0
28,24/05/2021,3,2,126,117,9,82,0,0
445,24/05/2021,3,2,167,61,106,49,0,0
172,23/05/2021,3,2,83,49,34,49,0,0
870,28/05/2021,3,4,42,30,12,67,0,0
537,25/05/2021,3,3,99,79,20,109,0,0
264,29/05/2021,3,1,59,59,0,NA,NA,NA
214,22/05/2021,3,3,83,57,26,60,0,0
532,12/05/2021,3,0,84,70,14,85,0,0
877,22/05/2021,3,0,158,69,89,35,0,0
260,24/05/2021,3,1,119,65,54,52,0,0
468,22/05/2021,3,1,95,66,29,52,0,0
896,25/05/2021,3,0,82,42,40,156,0,0
645,16/05/2021,3,4,37,8,29,49,0,0
913,24/05/2021,3,0,105,11,94,103,0,0
166,19/05/2021,3,4,62,62,0,NA,NA,NA
129,16/05/2021,3,11,189,47,142,49,0,0
8,20/05/2021,3,1,39,28,11,57,0,0
244,18/05/2021,3,1,199,81,118,49,0,0
54,23/05/2021,3,1,60,32,28,49,0,0
202,23/05/2021,3,0,76,47,29,71,0,0
600,25/05/2021,3,0,50,49,1,71,0,0
390,26/05/2021,3,2,134,69,65,49,0,0
430,22/05/2021,3,3,86,83,3,72,0,0
302,16/05/2021,3,0,61,38,23,49,0,0
87,22/05/2021,3,42,76,58,18,67,0,0
700,23/05/2021,3,11,121,53,68,49,0,0
670,22/05/2021,3,0,108,79,29,134,0,0
401,27/05/2021,3,0,79,65,14,60,0,0
548,17/05/2021,3,1,90,65,25,52,0,0
49,24/05/2021,3,9,139,65,74,49,0,0
866,21/05/2021,3,0,100,69,31,81,0,0
164,24/05/2021,3,0,62,37,25,57,0,0
525,23/05/2021,3,1,74,38,36,49,0,0
826,25/05/2021,3,2,96,90,6,63,0,0
371,14/05/2021,3,0,36,14,22,49,0,0
487,23/05/2021,3,0,39,19,20,49,0,0
519,23/05/2021,3,0,64,47,17,81,0,0
659,23/05/2021,3,3,40,29,11,67,0,0
608,27/05/2021,3,12,128,57,71,49,0,0
247,28/05/2021,3,1,92,90,2,79,0,0
43,27/05/2021,3,2,71,37,34,55,0,0
598,27/05/2021,3,0,146,119,27,87,0,0
420,22/05/2021,3,1,68,58,10,135,0,0
413,25/05/2021,3,3,113,80,33,57,0,0
510,19/05/2021,3,1,142,21,121,49,0,0
619,23/05/2021,3,0,101,33,68,49,0,0
699,23/05/2021,3,1,61,31,30,49,0,0
530,24/05/2021,3,1,59,45,14,63,0,0
158,26/05/2021,3,0,24,21,3,77,0,0
289,17/05/2021,3,1,67,30,37,49,0,0
383,21/05/2021,3,3,82,72,10,92,0,0
277,22/05/2021,3,6,66,58,8,83,0,0
317,19/05/2021,3,0,80,80,0,NA,NA,NA
779,26/05/2021,3,0,104,53,51,67,0,0
322,23/05/2021,3,2,98,18,80,49,0,0
742,27/05/2021,3,1,73,55,18,52,0,0
250,24/05/2021,3,0,115,84,31,72,0,0
722,20/05/2021,3,0,42,41,1,93,0,0
454,15/05/2021,3,0,184,6,178,66,0,0
902,25/05/2021,3,1,125,91,34,52,0,0
777,23/05/2021,3,3,117,55,62,49,0,0
156,25/05/2021,3,4,144,124,20,79,0,0
520,23/05/2021,3,0,58,34,24,59,0,0
80,29/05/2021,3,2,123,86,37,67,0,0
883,25/05/2021,3,6,98,16,82,45,0,0
479,30/05/2021,3,4,51,51,0,NA,NA,NA
618,22/05/2021,3,6,145,128,17,67,0,0
595,12/05/2021,3,2,48,22,26,52,0,0
877,23/05/2021,3,0,158,57,101,35,0,0
260,25/05/2021,3,1,119,84,35,62,0,0
336,24/05/2021,3,1,73,71,2,168,0,0
896,27/05/2021,3,0,82,58,24,134,0,0
771,16/05/2021,3,2,28,13,15,49,0,0
313,25/05/2021,3,0,31,28,3,70,0,0
105,19/05/2021,3,5,70,60,10,95,0,0
129,17/05/2021,3,12,188,62,126,49,0,0
471,20/05/2021,3,7,113,93,20,67,0,0
37,17/05/2021,3,0,81,40,41,49,0,0
279,23/05/2021,3,0,57,20,37,49,0,0
204,23/05/2021,3,0,64,13,51,49,0,0
321,23/05/2021,3,1,39,13,26,49,0,0
739,27/05/2021,3,2,73,35,38,49,0,0
650,24/05/2021,3,3,125,62,63,55,0,0
302,17/05/2021,3,0,61,45,16,57,0,0
572,21/05/2021,3,0,61,41,20,60,0,0
89,22/05/2021,3,2,58,57,1,79,0,0
670,25/05/2021,3,0,108,80,28,148,0,0
666,27/05/2021,3,2,64,54,10,62,0,0
649,17/05/2021,3,2,62,49,13,72,0,0
230,24/05/2021,3,1,79,33,46,49,0,0
638,21/05/2021,3,1,100,72,28,60,0,0
567,24/05/2021,3,0,61,46,15,60,0,0
806,23/05/2021,3,1,135,63,72,49,0,0
242,23/05/2021,3,8,130,61,69,49,0,0
111,14/05/2021,3,0,60,26,34,49,0,0
487,22/05/2021,3,0,39,39,0,NA,NA,NA
519,22/05/2021,3,0,64,64,0,NA,NA,NA
554,23/05/2021,3,0,42,21,21,49,0,0
507,27/05/2021,3,4,196,90,106,49,0,0
247,26/05/2021,3,1,92,42,50,55,0,0
293,27/05/2021,3,2,58,40,18,52,0,0
352,26/05/2021,3,0,64,55,9,59,0,0
259,20/05/2021,3,0,60,58,2,95,0,0
648,26/05/2021,3,1,63,34,29,80,0,0
341,18/05/2021,3,2,112,111,1,90,0,0
77,24/05/2021,3,0,103,59,44,81,0,0
857,23/05/2021,3,1,209,57,152,49,0,0
476,24/05/2021,3,0,173,32,141,49,0,0
732,26/05/2021,3,0,60,36,24,52,0,0
289,14/05/2021,3,1,67,29,38,49,0,0
752,22/05/2021,3,2,42,32,10,82,0,0
314,22/05/2021,3,2,67,65,2,83,0,0
146,19/05/2021,3,1,40,39,1,115,0,0
781,26/05/2021,3,2,81,66,15,63,0,0
403,23/05/2021,3,3,95,21,74,59,0,0
227,26/05/2021,3,2,42,25,17,49,0,0
588,24/05/2021,3,0,59,51,8,67,0,0
449,20/05/2021,3,7,88,29,59,66,0,0
454,12/05/2021,3,0,184,6,178,66,0,0
330,26/05/2021,3,2,117,53,64,55,0,0
423,24/05/2021,3,11,39,32,7,74,0,0
562,25/05/2021,3,0,68,66,2,63,0,0
64,22/05/2021,3,4,243,39,204,55,0,0
340,28/05/2021,3,18,116,41,75,49,0,0
93,25/05/2021,3,3,138,64,74,49,0,0
688,22/05/2021,3,4,115,116,-1,NA,NA,NA
845,22/05/2021,3,1,119,56,63,55,0,0
719,05/05/2021,3,0,41,14,27,59,0,0
877,21/05/2021,3,0,158,62,96,35,0,0
680,21/05/2021,3,3,77,47,30,60,0,0
395,24/05/2021,3,3,69,52,17,57,0,0
573,28/05/2021,3,0,57,51,6,67,0,0
331,17/05/2021,3,29,65,51,14,82,0,0
911,24/05/2021,3,0,158,9,149,49,0,0
585,20/05/2021,3,2,58,56,2,90,0,0
428,15/05/2021,3,6,86,37,49,49,0,0
546,21/05/2021,3,14,138,113,25,56,0,0
244,17/05/2021,3,1,199,77,122,49,0,0
528,23/05/2021,3,0,119,72,47,49,0,0
622,22/05/2021,3,1,43,40,3,119,0,0
427,23/05/2021,3,5,305,33,272,70,0,0
496,27/05/2021,3,1,59,34,25,49,0,0
839,24/05/2021,3,3,152,98,54,52,0,0
367,19/05/2021,3,0,74,33,41,55,0,0
625,21/05/2021,3,0,161,84,77,55,0,0
171,22/05/2021,3,2,47,10,37,66,0,0
300,24/05/2021,3,0,210,97,113,55,0,0
784,27/05/2021,3,2,47,42,5,90,0,0
871,17/05/2021,3,2,76,55,21,52,0,0
873,24/05/2021,3,3,98,68,30,49,0,0
11,24/05/2021,3,2,82,55,27,52,0,0
794,24/05/2021,3,0,137,44,93,80,0,0
57,25/05/2021,3,1,139,72,67,49,0,0
221,24/05/2021,3,0,62,28,34,60,0,0
1,16/05/2021,3,2,98,54,44,49,0,0
731,22/05/2021,3,4,95,87,8,65,0,0
755,22/05/2021,3,0,87,87,0,NA,NA,NA
270,24/05/2021,3,1,59,36,23,103,0,0
608,26/05/2021,3,11,129,67,62,49,0,0
269,26/05/2021,3,0,80,50,30,49,0,0
360,26/05/2021,3,1,43,15,28,59,0,0
584,26/05/2021,3,0,97,86,11,123,0,0
365,21/05/2021,3,0,68,63,5,94,0,0
332,24/05/2021,3,0,40,21,19,67,0,0
706,18/05/2021,3,1,73,60,13,62,0,0
215,24/05/2021,3,0,46,40,6,80,0,0
76,22/05/2021,3,1,92,70,22,144,0,0
38,25/05/2021,3,2,48,33,15,49,0,0
327,24/05/2021,3,18,50,48,2,85,0,0
144,15/05/2021,3,1,98,30,68,49,0,0
752,27/05/2021,3,1,43,33,10,63,0,0
505,22/05/2021,3,0,84,64,20,60,0,0
26,18/05/2021,3,3,63,16,47,72,0,0
789,26/05/2021,3,0,72,61,11,85,0,0
218,21/05/2021,3,0,78,49,29,55,0,0
222,30/05/2021,3,0,77,76,1,78,0,0
120,23/05/2021,3,2,152,64,88,49,0,0
775,21/05/2021,3,3,106,47,59,55,0,0
328,12/05/2021,3,1,97,45,52,59,0,0
338,26/05/2021,3,3,397,97,300,49,0,0
380,23/05/2021,3,0,160,62,98,49,0,0
653,24/05/2021,3,2,113,47,66,49,0,0
460,22/05/2021,3,12,97,89,8,77,0,0
610,29/05/2021,3,1,66,63,3,112,0,0
558,25/05/2021,3,0,44,21,23,55,0,0
688,21/05/2021,3,3,116,111,5,69,0,0
31,23/05/2021,3,2,61,24,37,49,0,0
532,06/05/2021,3,0,84,46,38,59,0,0
457,22/05/2021,3,4,59,63,-4,NA,NA,NA
680,22/05/2021,3,3,77,65,12,74,0,0
405,23/05/2021,3,2,88,30,58,49,0,0
849,28/05/2021,3,0,84,70,14,67,0,0
116,17/05/2021,3,0,61,57,4,80,0,0
98,25/05/2021,3,2,93,80,13,95,0,0
585,19/05/2021,3,2,58,57,1,85,0,0
542,15/05/2021,3,4,71,13,58,49,0,0
447,22/05/2021,3,0,143,127,16,67,0,0
443,19/05/2021,3,10,80,48,32,67,0,0
458,24/05/2021,3,4,177,115,62,49,0,0
464,22/05/2021,3,1,265,67,198,100,0,0
836,23/05/2021,3,0,101,69,32,55,0,0
209,29/05/2021,3,1,113,110,3,90,0,0
839,23/05/2021,3,3,152,71,81,49,0,0
302,18/05/2021,3,0,61,38,23,52,0,0
374,21/05/2021,3,0,56,46,10,60,0,0
171,23/05/2021,3,2,47,8,39,49,0,0
397,25/05/2021,3,0,75,56,19,60,0,0
882,25/05/2021,3,0,130,52,78,39,0,0
871,18/05/2021,3,2,76,61,15,57,0,0
49,25/05/2021,3,9,139,61,78,49,0,0
638,24/05/2021,3,1,100,69,31,64,0,0
524,24/05/2021,3,2,108,79,29,57,0,0
437,24/05/2021,3,2,163,71,92,49,0,0
221,25/05/2021,3,0,62,30,32,55,0,0
514,16/05/2021,3,6,228,9,219,49,0,0
369,23/05/2021,3,3,87,34,53,54,0,0
183,22/05/2021,3,0,80,62,18,60,0,0
665,22/05/2021,3,2,104,105,-1,NA,NA,NA
200,28/05/2021,3,5,114,110,4,77,0,0
56,29/05/2021,3,2,63,63,0,NA,NA,NA
43,25/05/2021,3,2,71,40,31,72,0,0
598,26/05/2021,3,0,146,114,32,105,0,0
526,20/05/2021,3,0,38,18,20,49,0,0
571,30/05/2021,3,2,159,127,32,52,0,0
543,18/05/2021,3,1,64,64,0,NA,NA,NA
75,22/05/2021,3,0,81,52,29,125,0,0
699,22/05/2021,3,1,61,59,2,80,0,0
679,21/05/2021,3,1,88,88,0,NA,NA,NA
921,25/05/2021,3,10,165,35,130,45,0,0
289,21/05/2021,3,3,65,20,45,55,0,0
235,28/05/2021,3,6,151,82,69,49,0,0
103,23/05/2021,3,1,160,116,44,91,0,0
26,19/05/2021,3,3,63,23,40,64,0,0
207,27/05/2021,3,2,61,34,27,59,0,0
322,26/05/2021,3,3,97,28,69,49,0,0
426,29/05/2021,3,8,155,157,-2,NA,NA,NA
767,23/05/2021,3,1,66,41,25,49,0,0
41,19/05/2021,3,1,83,79,4,95,0,0
328,13/05/2021,3,4,94,33,61,59,0,0
902,28/05/2021,3,2,124,61,63,55,0,0
380,25/05/2021,3,1,159,80,79,55,0,0
343,30/05/2021,3,3,59,44,15,62,0,0
815,22/05/2021,3,11,118,108,10,135,0,0
610,27/05/2021,3,2,65,53,12,74,0,0
558,27/05/2021,3,0,44,16,28,49,0,0
112,27/05/2021,3,0,84,68,16,57,0,0
618,28/05/2021,3,12,139,78,61,55,0,0
44,12/05/2021,3,5,103,57,46,59,0,0
140,22/05/2021,3,1,169,169,0,NA,NA,NA
694,22/05/2021,3,4,105,81,24,52,0,0
468,23/05/2021,3,2,94,39,55,49,0,0
23,26/05/2021,3,0,64,39,25,55,0,0
81,19/05/2021,3,1,59,23,36,49,0,0
508,25/05/2021,3,2,78,60,18,57,0,0
646,20/05/2021,3,4,132,89,43,52,0,0
662,19/05/2021,3,2,105,80,25,74,0,0
546,22/05/2021,3,8,144,124,20,116,0,0
309,30/05/2021,3,0,16,13,3,123,0,0
735,24/05/2021,3,1,28,8,20,49,0,0
813,22/05/2021,3,1,129,125,4,77,0,0
600,23/05/2021,3,0,50,41,9,77,0,0
433,29/05/2021,3,2,316,290,26,135,0,0
113,30/05/2021,3,1,31,30,1,103,0,0
727,24/05/2021,3,0,75,40,35,69,0,0
205,20/05/2021,3,0,126,71,55,49,0,0
370,28/05/2021,3,0,40,20,20,69,0,0
397,23/05/2021,3,0,75,29,46,49,0,0
450,26/05/2021,3,3,181,97,84,55,0,0
871,20/05/2021,3,2,76,61,15,57,0,0
325,26/05/2021,3,0,45,24,21,67,0,0
614,24/05/2021,3,2,80,52,28,64,0,0
811,24/05/2021,3,2,88,40,48,60,0,0
57,22/05/2021,3,2,138,137,1,85,0,0
704,25/05/2021,3,1,31,22,9,52,0,0
660,16/05/2021,3,6,180,22,158,49,0,0
685,23/05/2021,3,2,138,91,47,49,0,0
617,23/05/2021,3,1,43,14,29,49,0,0
919,22/05/2021,3,1,122,123,-1,NA,NA,NA
687,28/05/2021,3,2,85,57,28,60,0,0
825,29/05/2021,3,3,143,143,0,NA,NA,NA
907,26/05/2021,3,3,77,56,21,74,0,0
728,27/05/2021,3,0,47,42,5,63,0,0
365,20/05/2021,3,0,68,64,4,80,0,0
607,30/05/2021,3,1,74,72,2,65,0,0
341,19/05/2021,3,2,112,112,0,NA,NA,NA
619,25/05/2021,3,0,101,67,34,72,0,0
206,23/05/2021,3,16,197,39,158,55,0,0
530,22/05/2021,3,1,59,58,1,67,0,0
256,26/05/2021,3,1,108,78,30,63,0,0
30,19/05/2021,3,1,70,67,3,168,0,0
863,26/05/2021,3,11,84,49,35,52,0,0
855,28/05/2021,3,6,170,106,64,49,0,0
146,18/05/2021,3,2,39,38,1,136,0,0
396,29/05/2021,3,1,29,28,1,88,0,0
764,25/05/2021,3,3,66,32,34,55,0,0
742,30/05/2021,3,1,73,73,0,NA,NA,NA
588,23/05/2021,3,0,59,22,37,49,0,0
41,20/05/2021,3,1,83,67,16,67,0,0
359,12/05/2021,3,3,101,55,46,59,0,0
338,30/05/2021,3,1,399,135,264,49,0,0
187,28/05/2021,3,1,40,33,7,68,0,0
621,30/05/2021,3,0,60,52,8,58,0,0
815,23/05/2021,3,11,118,56,62,55,0,0
499,28/05/2021,3,0,31,19,12,55,0,0
613,27/05/2021,3,0,56,32,24,64,0,0
804,27/05/2021,3,5,140,44,96,49,0,0
725,28/05/2021,3,0,17,16,1,84,0,0
719,12/05/2021,3,0,41,17,24,59,0,0
692,22/05/2021,3,0,87,87,0,NA,NA,NA
661,21/05/2021,3,7,165,77,88,55,0,0
273,19/05/2021,3,0,103,103,0,NA,NA,NA
896,26/05/2021,3,0,82,44,38,151,0,0
291,20/05/2021,3,1,60,40,20,49,0,0
329,24/05/2021,3,9,98,57,41,57,0,0
125,25/05/2021,3,2,34,34,0,NA,NA,NA
616,19/05/2021,3,3,72,49,23,85,0,0
761,22/05/2021,3,2,81,69,12,67,0,0
802,30/05/2021,3,1,64,64,0,NA,NA,NA
279,30/05/2021,3,0,57,33,24,52,0,0
92,27/05/2021,3,1,121,54,67,49,0,0
138,25/05/2021,3,0,98,53,45,60,0,0
433,30/05/2021,3,2,316,278,38,90,0,0
650,28/05/2021,3,4,124,105,19,67,0,0
367,22/05/2021,3,0,74,40,34,86,0,0
572,27/05/2021,3,0,61,45,16,67,0,0
100,30/05/2021,3,76,148,144,4,123,0,0
300,23/05/2021,3,0,210,99,111,49,0,0
267,29/05/2021,3,2,81,77,4,74,0,0
297,17/05/2021,3,1,75,39,36,55,0,0
284,26/05/2021,3,1,25,16,9,74,0,0
780,24/05/2021,3,0,60,48,12,78,0,0
736,24/05/2021,3,2,103,44,59,49,0,0
226,21/05/2021,3,0,47,41,6,98,0,0
879,24/05/2021,3,4,160,13,147,39,0,0
660,18/05/2021,3,6,180,41,139,49,0,0
583,24/05/2021,3,4,77,48,29,49,0,0
865,24/05/2021,3,1,84,27,57,49,0,0
639,22/05/2021,3,0,59,59,0,NA,NA,NA
792,28/05/2021,3,0,102,96,6,94,0,0
350,29/05/2021,3,2,58,54,4,123,0,0
293,25/05/2021,3,1,59,24,35,49,0,0
686,26/05/2021,3,0,46,26,20,52,0,0
259,19/05/2021,3,0,60,58,2,127,0,0
153,22/05/2021,3,2,62,61,1,103,0,0
582,20/05/2021,3,0,53,53,0,NA,NA,NA
219,22/05/2021,3,4,73,20,53,55,0,0
84,25/05/2021,3,0,20,20,0,NA,NA,NA
38,22/05/2021,3,1,49,49,0,NA,NA,NA
531,26/05/2021,3,1,58,39,19,57,0,0
30,22/05/2021,3,1,70,44,26,147,0,0
918,27/05/2021,3,0,201,24,177,39,0,0
277,27/05/2021,3,5,67,58,9,62,0,0
26,15/05/2021,3,2,64,8,56,49,0,0
515,28/05/2021,3,5,107,61,46,55,0,0
438,26/05/2021,3,6,90,45,45,64,0,0
452,29/05/2021,3,2,58,58,0,NA,NA,NA
860,23/05/2021,3,2,90,36,54,49,0,0
602,17/05/2021,3,0,64,39,25,49,0,0
261,11/05/2021,3,3,99,23,76,49,0,0
411,28/05/2021,3,0,185,185,0,NA,NA,NA
238,27/05/2021,3,0,66,54,12,74,0,0
455,21/05/2021,3,6,245,60,185,90,0,0
172,24/05/2021,3,2,83,64,19,52,0,0
29,22/05/2021,3,0,54,0,54,NA,NA,NA
378,28/05/2021,3,1,83,48,35,55,0,0
535,27/05/2021,3,0,83,59,24,49,0,0
618,29/05/2021,3,16,135,127,8,67,0,0
719,13/05/2021,3,0,41,17,24,59,0,0
635,21/05/2021,3,0,88,65,23,60,0,0
425,23/05/2021,3,11,239,30,209,70,0,0
395,21/05/2021,3,1,71,45,26,60,0,0
896,28/05/2021,3,0,82,80,2,150,0,0
645,18/05/2021,3,3,38,25,13,80,0,0
459,25/05/2021,3,2,90,63,27,60,0,0
125,26/05/2021,3,2,34,34,0,NA,NA,NA
68,19/05/2021,3,1,115,30,85,49,0,0
471,19/05/2021,3,7,113,86,27,59,0,0
161,30/05/2021,3,0,61,61,0,NA,NA,NA
458,28/05/2021,3,2,179,137,42,52,0,0
464,27/05/2021,3,1,265,50,215,85,0,0
417,23/05/2021,3,0,103,58,45,49,0,0
529,30/05/2021,3,3,38,32,6,63,0,0
373,28/05/2021,3,2,101,61,40,55,0,0
367,23/05/2021,3,0,74,14,60,54,0,0
87,27/05/2021,3,44,74,31,43,49,0,0
745,29/05/2021,3,1,104,98,6,90,0,0
851,25/05/2021,3,0,92,31,61,49,0,0
491,29/05/2021,3,5,174,173,1,74,0,0
720,17/05/2021,3,0,39,26,13,55,0,0
325,28/05/2021,3,0,45,36,9,88,0,0
11,25/05/2021,3,1,83,70,13,74,0,0
770,24/05/2021,3,2,33,19,14,67,0,0
657,21/05/2021,3,0,48,42,6,105,0,0
154,23/05/2021,3,3,101,42,59,49,0,0
391,18/05/2021,3,0,76,52,24,52,0,0
748,24/05/2021,3,13,131,61,70,49,0,0
932,24/05/2021,3,11,96,4,92,45,0,0
295,23/05/2021,3,3,102,9,93,49,0,0
231,28/05/2021,3,0,41,24,17,49,0,0
186,30/05/2021,3,1,57,41,16,52,0,0
217,25/05/2021,3,1,40,25,15,52,0,0
136,26/05/2021,3,0,128,91,37,77,0,0
689,20/05/2021,3,0,130,121,9,62,0,0
153,23/05/2021,3,2,62,53,9,57,0,0
199,17/05/2021,3,1,81,81,0,NA,NA,NA
219,25/05/2021,3,5,72,35,37,49,0,0
385,25/05/2021,3,2,61,22,39,59,0,0
107,22/05/2021,3,2,87,87,0,NA,NA,NA
818,26/05/2021,3,1,80,70,10,144,0,0
124,18/05/2021,3,2,52,44,8,79,0,0
534,26/05/2021,3,1,84,32,52,49,0,0
176,28/05/2021,3,2,98,53,45,55,0,0
812,16/05/2021,3,2,135,15,120,49,0,0
335,29/05/2021,3,3,83,72,11,62,0,0
218,25/05/2021,3,3,75,43,32,49,0,0
52,29/05/2021,3,9,133,137,-4,NA,NA,NA
108,24/05/2021,3,0,78,43,35,49,0,0
722,17/05/2021,3,0,42,38,4,89,0,0
261,13/05/2021,3,2,100,21,79,49,0,0
78,30/05/2021,3,0,44,44,0,NA,NA,NA
897,26/05/2021,3,6,102,58,44,67,0,0
201,22/05/2021,3,11,127,87,40,60,0,0
723,24/05/2021,3,2,79,78,1,77,0,0
29,21/05/2021,3,0,54,0,54,NA,NA,NA
537,27/05/2021,3,3,99,72,27,86,0,0
402,27/05/2021,3,2,153,125,28,52,0,0
346,27/05/2021,3,5,115,113,2,74,0,0
44,05/05/2021,3,7,101,49,52,55,0,0
692,23/05/2021,3,0,87,33,54,53,0,0
425,24/05/2021,3,5,245,33,212,85,0,0
13,18/05/2021,3,4,77,72,5,94,0,0
801,23/05/2021,3,7,160,40,120,49,0,0
331,21/05/2021,3,28,66,65,1,96,0,0
181,25/05/2021,3,0,34,20,14,90,0,0
646,26/05/2021,3,19,117,114,3,71,0,0
9,15/05/2021,3,0,27,19,8,49,0,0
800,20/05/2021,3,2,55,36,19,49,0,0
195,30/05/2021,3,1,50,41,9,57,0,0
237,30/05/2021,3,6,115,113,2,62,0,0
72,28/05/2021,3,1,59,42,17,67,0,0
163,25/05/2021,3,1,61,60,1,90,0,0
167,29/05/2021,3,0,84,85,-1,NA,NA,NA
563,30/05/2021,3,2,68,61,7,57,0,0
908,21/05/2021,3,0,136,81,55,60,0,0
435,28/05/2021,3,51,69,37,32,49,0,0
89,28/05/2021,3,2,58,19,39,55,0,0
249,23/05/2021,3,2,125,81,44,57,0,0
401,28/05/2021,3,0,79,67,12,67,0,0
747,17/05/2021,3,0,64,58,6,59,0,0
787,26/05/2021,3,3,105,68,37,92,0,0
711,22/05/2021,3,0,89,80,9,67,0,0
746,24/05/2021,3,3,57,39,18,64,0,0
560,21/05/2021,3,0,80,53,27,79,0,0
488,21/05/2021,3,2,64,54,10,81,0,0
1,13/05/2021,3,2,98,53,45,55,0,0
369,24/05/2021,3,5,85,53,32,72,0,0
451,22/05/2021,3,2,81,78,3,200,0,0
270,23/05/2021,3,1,59,50,9,82,0,0
25,28/05/2021,3,1,51,51,0,NA,NA,NA
269,29/05/2021,3,0,80,43,37,55,0,0
333,26/05/2021,3,1,56,46,10,120,0,0
714,26/05/2021,3,0,59,23,36,72,0,0
365,22/05/2021,3,0,68,64,4,117,0,0
361,22/05/2021,3,38,27,14,13,129,0,0
543,20/05/2021,3,1,64,64,0,NA,NA,NA
556,22/05/2021,3,2,115,101,14,136,0,0
76,24/05/2021,3,1,92,81,11,75,0,0
357,22/05/2021,3,1,82,82,0,NA,NA,NA
203,24/05/2021,3,1,39,11,28,49,0,0
124,19/05/2021,3,2,52,44,8,115,0,0
658,27/05/2021,3,1,80,49,31,74,0,0
855,29/05/2021,3,3,173,168,5,77,0,0
63,15/05/2021,3,9,55,7,48,49,0,0
779,29/05/2021,3,0,104,100,4,90,0,0
308,25/05/2021,3,2,46,22,24,57,0,0
52,30/05/2021,3,10,132,137,-5,NA,NA,NA
392,24/05/2021,3,0,176,79,97,49,0,0
41,18/05/2021,3,1,83,71,12,82,0,0
328,15/05/2021,3,4,94,24,70,49,0,0
411,30/05/2021,3,0,185,184,1,NA,NA,NA
28,27/05/2021,3,2,126,124,2,123,0,0
455,22/05/2021,3,6,245,64,181,100,0,0
466,23/05/2021,3,4,136,38,98,49,0,0
29,20/05/2021,3,0,54,0,54,NA,NA,NA
93,26/05/2021,3,2,139,64,75,49,0,0
479,27/05/2021,3,2,53,32,21,49,0,0
21,28/05/2021,3,1,59,32,27,79,0,0
876,06/05/2021,3,1,181,50,131,45,0,0
140,19/05/2021,3,0,170,115,55,52,0,0
469,24/05/2021,3,4,192,26,166,90,0,0
13,19/05/2021,3,3,78,71,7,95,0,0
50,23/05/2021,3,2,119,29,90,49,0,0
351,18/05/2021,3,1,65,51,14,74,0,0
856,25/05/2021,3,1,119,66,53,52,0,0
166,25/05/2021,3,1,65,57,8,65,0,0
115,15/05/2021,3,0,115,18,97,49,0,0
761,20/05/2021,3,0,83,36,47,49,0,0
443,30/05/2021,3,3,87,76,11,62,0,0
458,30/05/2021,3,2,179,152,27,63,0,0
464,28/05/2021,3,1,265,87,178,90,0,0
51,24/05/2021,3,2,78,58,20,74,0,0
816,28/05/2021,3,0,82,82,0,NA,NA,NA
839,28/05/2021,3,3,152,128,24,57,0,0
908,22/05/2021,3,0,136,118,18,82,0,0
246,28/05/2021,3,1,111,85,26,74,0,0
89,29/05/2021,3,2,58,40,18,74,0,0
898,24/05/2021,3,2,98,78,20,73,0,0
790,29/05/2021,3,0,99,91,8,128,0,0
297,20/05/2021,3,1,75,34,41,55,0,0
364,28/05/2021,3,1,129,104,25,107,0,0
866,24/05/2021,3,0,100,46,54,57,0,0
456,26/05/2021,3,8,82,54,28,49,0,0
525,22/05/2021,3,1,74,56,18,67,0,0
488,25/05/2021,3,2,64,52,12,82,0,0
878,18/05/2021,3,0,218,6,212,44,0,0
685,24/05/2021,3,3,137,114,23,74,0,0
193,22/05/2021,3,1,107,63,44,55,0,0
307,23/05/2021,3,1,78,45,33,49,0,0
145,28/05/2021,3,2,56,56,0,NA,NA,NA
654,30/05/2021,3,3,56,56,0,105,0,0
797,27/05/2021,3,1,66,43,23,128,0,0
484,27/05/2021,3,0,40,35,5,77,0,0
342,22/05/2021,3,0,114,59,55,55,0,0
361,23/05/2021,3,46,19,11,8,89,0,0
39,19/05/2021,3,1,60,45,15,72,0,0
556,25/05/2021,3,2,115,81,34,62,0,0
857,25/05/2021,3,1,209,63,146,49,0,0
559,21/05/2021,3,46,139,138,1,98,0,0
96,26/05/2021,3,13,56,52,4,111,0,0
289,19/05/2021,3,2,66,30,36,60,0,0
681,27/05/2021,3,5,66,52,14,79,0,0
121,27/05/2021,3,0,110,100,10,133,0,0
812,18/05/2021,3,2,135,59,76,49,0,0
629,28/05/2021,3,2,60,47,13,67,0,0
58,24/05/2021,3,1,66,43,23,55,0,0
612,28/05/2021,3,1,41,41,0,NA,NA,NA
429,24/05/2021,3,3,122,39,83,49,0,0
449,21/05/2021,3,7,88,45,43,90,0,0
843,15/05/2021,3,3,63,19,44,49,0,0
493,20/05/2021,3,1,34,10,24,49,0,0
380,27/05/2021,3,24,136,94,42,52,0,0
653,21/05/2021,3,2,113,49,64,55,0,0
64,24/05/2021,3,3,244,47,197,49,0,0
549,22/05/2021,3,0,61,0,61,NA,NA,NA
69,27/05/2021,3,2,58,35,23,49,0,0
402,28/05/2021,3,2,153,141,12,74,0,0
214,28/05/2021,3,3,83,64,19,67,0,0
876,11/05/2021,3,2,180,55,125,45,0,0
655,19/05/2021,3,0,72,46,26,72,0,0
661,23/05/2021,3,5,167,46,121,49,0,0
640,21/05/2021,3,5,121,85,36,60,0,0
50,26/05/2021,3,2,119,75,44,49,0,0
81,20/05/2021,3,1,59,28,31,49,0,0
911,25/05/2021,3,0,158,9,149,49,0,0
196,25/05/2021,3,0,138,26,112,49,0,0
68,16/05/2021,3,0,116,6,110,49,0,0
22,21/05/2021,3,0,64,42,22,55,0,0
244,30/05/2021,3,2,198,198,0,NA,NA,NA
628,29/05/2021,3,1,58,56,2,117,0,0
464,29/05/2021,3,1,265,158,107,100,0,0
213,25/05/2021,3,3,145,110,35,57,0,0
167,28/05/2021,3,0,84,84,0,NA,NA,NA
538,28/05/2021,3,1,43,35,8,67,0,0
727,21/05/2021,3,0,75,74,1,88,0,0
374,27/05/2021,3,1,55,37,18,52,0,0
278,29/05/2021,3,7,98,80,18,57,0,0
348,22/05/2021,3,9,131,111,20,67,0,0
882,28/05/2021,3,0,130,68,62,39,0,0
747,18/05/2021,3,0,64,63,1,59,0,0
6,26/05/2021,3,0,190,33,157,49,0,0
711,23/05/2021,3,0,89,67,22,52,0,0
524,26/05/2021,3,1,109,75,34,67,0,0
57,20/05/2021,3,1,139,91,48,49,0,0
47,21/05/2021,3,2,55,36,19,54,0,0
701,14/05/2021,3,2,60,5,55,49,0,0
731,24/05/2021,3,4,95,75,20,62,0,0
617,22/05/2021,3,1,43,38,5,74,0,0
554,24/05/2021,3,0,42,33,9,62,0,0
677,28/05/2021,3,0,40,38,2,77,0,0
597,30/05/2021,3,2,99,82,17,57,0,0
637,25/05/2021,3,0,74,43,31,147,0,0
686,27/05/2021,3,0,46,26,20,49,0,0
271,21/05/2021,3,0,70,49,21,60,0,0
17,22/05/2021,3,1,93,83,10,74,0,0
102,17/05/2021,3,0,60,38,22,55,0,0
556,24/05/2021,3,2,115,64,51,62,0,0
432,24/05/2021,3,0,165,3,162,85,0,0
174,23/05/2021,3,2,26,6,20,49,0,0
339,26/05/2021,3,15,579,59,520,49,0,0
61,21/05/2021,3,3,97,43,54,55,0,0
863,28/05/2021,3,14,81,37,44,55,0,0
32,28/05/2021,3,1,104,94,10,74,0,0
576,19/05/2021,3,0,58,33,25,57,0,0
676,28/05/2021,3,2,113,91,22,67,0,0
218,24/05/2021,3,3,75,52,23,52,0,0
691,28/05/2021,3,1,31,31,0,NA,NA,NA
480,24/05/2021,3,0,28,17,11,49,0,0
602,18/05/2021,3,0,64,40,24,60,0,0
82,15/05/2021,3,0,96,20,76,49,0,0
493,19/05/2021,3,1,34,18,16,49,0,0
777,27/05/2021,3,3,117,104,13,65,0,0
621,21/05/2021,3,0,60,49,11,56,0,0
460,24/05/2021,3,9,100,45,55,49,0,0
549,20/05/2021,3,0,61,0,61,NA,NA,NA
398,26/05/2021,3,0,171,10,161,49,0,0
402,26/05/2021,3,0,155,96,59,49,0,0
225,27/05/2021,3,13,67,34,33,67,0,0
44,06/05/2021,3,7,101,39,62,49,0,0
635,23/05/2021,3,0,88,36,52,49,0,0
661,25/05/2021,3,18,154,60,94,49,0,0
283,20/05/2021,3,0,76,22,54,55,0,0
801,26/05/2021,3,7,160,47,113,49,0,0
351,20/05/2021,3,2,64,64,0,NA,NA,NA
716,25/05/2021,3,0,104,73,31,90,0,0
196,26/05/2021,3,0,138,19,119,49,0,0
68,15/05/2021,3,0,116,8,108,49,0,0
471,23/05/2021,3,6,114,64,50,49,0,0
473,30/05/2021,3,1,49,49,0,NA,NA,NA
318,28/05/2021,3,0,59,50,9,64,0,0
72,27/05/2021,3,1,59,51,8,63,0,0
128,24/05/2021,3,1,20,11,9,64,0,0
739,29/05/2021,3,2,73,73,0,NA,NA,NA
872,29/05/2021,3,1,64,63,1,147,0,0
302,21/05/2021,3,0,61,56,5,74,0,0
625,27/05/2021,3,0,161,102,59,49,0,0
71,29/05/2021,3,0,62,56,6,74,0,0
768,22/05/2021,3,4,83,77,6,79,0,0
882,29/05/2021,3,0,130,89,41,39,0,0
747,19/05/2021,3,0,64,59,5,59,0,0
539,27/05/2021,3,4,93,68,25,52,0,0
638,22/05/2021,3,1,100,85,15,67,0,0
561,24/05/2021,3,1,59,47,12,62,0,0
152,20/05/2021,3,1,90,70,20,57,0,0
221,22/05/2021,3,1,61,47,14,84,0,0
1,15/05/2021,3,2,98,28,70,49,0,0
748,22/05/2021,3,9,135,106,29,67,0,0
183,23/05/2021,3,0,80,31,49,49,0,0
197,23/05/2021,3,0,118,22,96,49,0,0
119,28/05/2021,3,2,66,39,27,60,0,0
251,29/05/2021,3,1,123,90,33,52,0,0
217,27/05/2021,3,0,41,28,13,49,0,0
686,25/05/2021,3,0,46,29,17,52,0,0
817,21/05/2021,3,0,83,47,36,55,0,0
147,22/05/2021,3,0,80,80,0,NA,NA,NA
743,18/05/2021,3,1,125,64,61,59,0,0
619,21/05/2021,3,1,100,51,49,55,0,0
432,25/05/2021,3,0,165,3,162,90,0,0
174,21/05/2021,3,2,26,12,14,55,0,0
410,25/05/2021,3,0,56,25,31,49,0,0
124,21/05/2021,3,0,54,30,24,55,0,0
918,28/05/2021,3,0,201,17,184,39,0,0
434,27/05/2021,3,3,57,43,14,62,0,0
317,18/05/2021,3,0,80,80,0,NA,NA,NA
224,29/05/2021,3,1,56,49,7,60,0,0
438,24/05/2021,3,9,87,59,28,72,0,0
127,29/05/2021,3,1,59,59,0,NA,NA,NA
860,24/05/2021,3,2,90,47,43,49,0,0
602,21/05/2021,3,0,64,43,21,72,0,0
82,11/05/2021,3,0,96,68,28,82,0,0
117,18/05/2021,3,1,93,93,0,NA,NA,NA
423,27/05/2021,3,6,44,36,8,67,0,0
562,22/05/2021,3,0,68,67,1,77,0,0
738,22/05/2021,3,1,123,122,1,84,0,0
549,21/05/2021,3,0,61,0,61,NA,NA,NA
613,26/05/2021,3,0,56,40,16,85,0,0
688,26/05/2021,3,3,116,93,23,57,0,0
346,28/05/2021,3,4,116,82,34,60,0,0
595,07/05/2021,3,2,48,13,35,49,0,0
655,20/05/2021,3,0,72,52,20,67,0,0
694,25/05/2021,3,4,105,51,54,49,0,0
283,18/05/2021,3,0,76,28,48,64,0,0
847,27/05/2021,3,7,190,75,115,35,0,0
331,18/05/2021,3,29,65,58,7,147,0,0
856,24/05/2021,3,4,116,47,69,49,0,0
298,26/05/2021,3,2,227,75,152,49,0,0
344,15/05/2021,3,1,64,23,41,49,0,0
303,18/05/2021,3,1,64,60,4,87,0,0
95,30/05/2021,3,0,88,84,4,107,0,0
279,28/05/2021,3,1,56,39,17,60,0,0
622,28/05/2021,3,3,41,35,6,92,0,0
427,24/05/2021,3,6,304,33,271,85,0,0
862,30/05/2021,3,0,110,110,0,NA,NA,NA
551,30/05/2021,3,0,115,101,14,62,0,0
302,22/05/2021,3,0,61,52,9,67,0,0
205,29/05/2021,3,0,126,126,0,NA,NA,NA
89,30/05/2021,3,2,58,50,8,57,0,0
853,23/05/2021,3,1,101,34,67,49,0,0
296,23/05/2021,3,3,57,9,48,49,0,0
297,16/05/2021,3,3,73,23,50,49,0,0
873,28/05/2021,3,4,97,53,44,70,0,0
705,24/05/2021,3,10,81,61,20,57,0,0
149,24/05/2021,3,0,88,67,21,56,0,0
211,20/05/2021,3,3,57,44,13,60,0,0
879,23/05/2021,3,3,161,13,148,39,0,0
660,15/05/2021,3,6,180,22,158,49,0,0
233,22/05/2021,3,3,64,62,2,189,0,0
193,23/05/2021,3,1,107,30,77,49,0,0
627,23/05/2021,3,0,41,9,32,49,0,0
904,28/05/2021,3,2,272,35,237,95,0,0
597,29/05/2021,3,3,98,95,3,79,0,0
79,25/05/2021,3,1,45,42,3,95,0,0
714,25/05/2021,3,0,59,26,33,59,0,0
817,22/05/2021,3,0,83,56,27,60,0,0
864,22/05/2021,3,2,83,51,32,55,0,0
199,20/05/2021,3,2,80,48,32,55,0,0
349,23/05/2021,3,1,89,38,51,49,0,0
699,25/05/2021,3,1,61,51,10,94,0,0
174,22/05/2021,3,2,26,14,12,55,0,0
410,26/05/2021,3,0,56,29,27,49,0,0
144,22/05/2021,3,4,95,97,-2,NA,NA,NA
383,18/05/2021,3,3,82,82,0,NA,NA,NA
277,28/05/2021,3,5,67,50,17,77,0,0
317,17/05/2021,3,0,80,69,11,74,0,0
515,29/05/2021,3,5,107,106,1,89,0,0
579,24/05/2021,3,0,44,26,18,64,0,0
612,30/05/2021,3,1,41,41,0,NA,NA,NA
274,22/05/2021,3,2,208,18,190,39,0,0
671,06/05/2021,3,2,63,61,2,95,0,0
454,13/05/2021,3,0,184,4,180,66,0,0
78,18/05/2021,3,0,44,39,5,92,0,0
189,26/05/2021,3,1,164,116,48,64,0,0
562,21/05/2021,3,0,68,68,0,NA,NA,NA
738,23/05/2021,3,1,123,57,66,49,0,0
859,22/05/2021,3,1,84,84,0,NA,NA,NA
558,28/05/2021,3,0,44,14,30,55,0,0
264,27/05/2021,3,1,59,45,14,67,0,0
208,27/05/2021,3,0,60,40,20,55,0,0
44,10/05/2021,3,5,103,40,63,49,0,0
663,20/05/2021,3,0,148,61,87,49,0,0
517,24/05/2021,3,0,58,47,11,62,0,0
273,21/05/2021,3,0,103,103,0,NA,NA,NA
819,23/05/2021,3,1,79,75,4,75,0,0
552,18/05/2021,3,10,174,92,82,49,0,0
808,24/05/2021,3,2,166,104,62,64,0,0
298,25/05/2021,3,2,227,78,149,49,0,0
135,16/05/2021,3,5,61,9,52,49,0,0
546,19/05/2021,3,14,138,37,101,49,0,0
59,30/05/2021,3,7,68,34,34,49,0,0
786,28/05/2021,3,1,61,54,7,96,0,0
813,29/05/2021,3,1,129,125,4,152,0,0
252,23/05/2021,3,1,263,71,192,49,0,0
12,29/05/2021,3,1,42,42,0,NA,NA,NA
551,28/05/2021,3,0,115,88,27,60,0,0
367,26/05/2021,3,0,74,22,52,96,0,0
625,29/05/2021,3,3,158,160,-2,NA,NA,NA
753,28/05/2021,3,5,122,119,3,88,0,0
898,23/05/2021,3,1,99,33,66,86,0,0
707,24/05/2021,3,1,39,35,4,119,0,0
720,16/05/2021,3,0,39,14,25,49,0,0
49,26/05/2021,3,9,139,71,68,49,0,0
711,24/05/2021,3,1,88,85,3,83,0,0
90,26/05/2021,3,0,78,45,33,60,0,0
368,20/05/2021,3,1,84,44,40,49,0,0
879,25/05/2021,3,4,160,19,141,39,0,0
878,14/05/2021,3,0,218,11,207,44,0,0
233,23/05/2021,3,3,64,63,1,65,0,0
594,23/05/2021,3,38,69,63,6,70,0,0
659,24/05/2021,3,3,40,19,21,74,0,0
448,28/05/2021,3,2,151,81,70,100,0,0
436,29/05/2021,3,10,196,120,76,49,0,0
356,26/05/2021,3,1,135,100,35,67,0,0
584,25/05/2021,3,0,97,80,17,123,0,0
342,19/05/2021,3,0,114,36,78,49,0,0
589,23/05/2021,3,4,139,49,90,49,0,0
412,17/05/2021,3,8,93,25,68,49,0,0
564,25/05/2021,3,1,73,57,16,57,0,0
699,24/05/2021,3,1,61,48,13,77,0,0
357,23/05/2021,3,1,82,36,46,49,0,0
203,26/05/2021,3,1,39,9,30,49,0,0
30,18/05/2021,3,1,70,70,0,NA,NA,NA
681,18/05/2021,3,2,69,69,0,NA,NA,NA
709,28/05/2021,3,2,81,78,3,127,0,0
240,17/05/2021,3,1,70,27,43,55,0,0
781,29/05/2021,3,2,81,80,1,149,0,0
715,24/05/2021,3,0,88,85,3,85,0,0
772,30/05/2021,3,0,57,57,0,NA,NA,NA
274,24/05/2021,3,3,207,22,185,39,0,0
41,02/05/2021,3,1,83,11,72,49,0,0
843,11/05/2021,3,3,63,36,27,57,0,0
902,20/05/2021,3,1,125,125,0,NA,NA,NA
187,27/05/2021,3,1,40,25,15,62,0,0
156,22/05/2021,3,1,147,105,42,103,0,0
19,24/05/2021,3,1,93,54,39,57,0,0
733,20/05/2021,3,1,99,37,62,49,0,0
93,28/05/2021,3,2,139,96,43,49,0,0
899,27/05/2021,3,2,103,57,46,113,0,0
664,28/05/2021,3,13,142,139,3,85,0,0
44,13/05/2021,3,5,103,57,46,49,0,0
877,19/05/2021,3,0,158,77,81,35,0,0
580,22/05/2021,3,0,98,91,7,79,0,0
336,19/05/2021,3,1,73,73,0,NA,NA,NA
470,24/05/2021,3,4,76,75,1,80,0,0
552,20/05/2021,3,11,173,101,72,49,0,0
891,25/05/2021,3,1,81,75,6,79,0,0
585,25/05/2021,3,2,58,47,11,109,0,0
542,16/05/2021,3,4,71,22,49,49,0,0
303,22/05/2021,3,1,64,42,22,60,0,0
37,30/05/2021,3,2,79,65,14,57,0,0
54,30/05/2021,3,1,60,59,1,75,0,0
204,27/05/2021,3,0,64,12,52,49,0,0
252,25/05/2021,3,2,262,111,151,49,0,0
390,30/05/2021,3,2,134,134,0,NA,NA,NA
575,30/05/2021,3,1,49,40,9,57,0,0
536,07/05/2021,3,1,80,44,36,49,0,0
91,18/05/2021,3,1,79,79,0,NA,NA,NA
100,28/05/2021,3,76,148,148,0,NA,NA,NA
312,25/05/2021,3,1,96,43,53,60,0,0
239,24/05/2021,3,1,39,30,9,82,0,0
747,16/05/2021,3,0,64,33,31,49,0,0
6,28/05/2021,3,22,168,54,114,55,0,0
717,24/05/2021,3,3,190,100,90,55,0,0
811,26/05/2021,3,2,88,51,37,69,0,0
67,21/05/2021,3,1,51,41,10,67,0,0
488,23/05/2021,3,2,64,62,2,68,0,0
878,17/05/2021,3,0,218,4,214,44,0,0
731,23/05/2021,3,4,95,50,45,49,0,0
451,24/05/2021,3,2,81,44,37,140,0,0
372,24/05/2021,3,19,73,68,5,102,0,0
507,28/05/2021,3,4,196,109,87,55,0,0
251,30/05/2021,3,2,122,79,43,49,0,0
356,27/05/2021,3,1,135,84,51,55,0,0
404,26/05/2021,3,0,67,46,21,150,0,0
271,20/05/2021,3,0,70,51,19,52,0,0
571,22/05/2021,3,2,159,159,0,NA,NA,NA
126,18/05/2021,3,3,117,92,25,57,0,0
887,21/05/2021,3,18,305,17,288,39,0,0
805,24/05/2021,3,2,111,80,31,52,0,0
679,22/05/2021,3,0,89,85,4,105,0,0
490,25/05/2021,3,5,160,33,127,49,0,0
30,20/05/2021,3,1,70,70,0,NA,NA,NA
752,18/05/2021,3,13,31,11,20,55,0,0
103,27/05/2021,3,1,160,130,30,103,0,0
63,18/05/2021,3,8,56,27,29,57,0,0
869,29/05/2021,3,1,59,58,1,148,0,0
764,24/05/2021,3,2,67,27,40,49,0,0
310,29/05/2021,3,1,71,71,0,NA,NA,NA
250,23/05/2021,3,0,115,20,95,59,0,0
602,03/05/2021,3,0,64,13,51,49,0,0
261,15/05/2021,3,2,100,17,83,49,0,0
212,19/05/2021,3,1,77,65,12,89,0,0
238,26/05/2021,3,0,66,51,15,74,0,0
179,21/05/2021,3,1,91,33,58,55,0,0
466,24/05/2021,3,1,139,38,101,49,0,0
355,20/05/2021,3,28,71,49,22,55,0,0
537,28/05/2021,3,3,99,76,23,94,0,0
804,28/05/2021,3,5,140,115,25,52,0,0
845,27/05/2021,3,4,116,74,42,49,0,0
532,08/05/2021,3,0,84,29,55,49,0,0
877,20/05/2021,3,0,158,62,96,35,0,0
578,24/05/2021,3,0,58,39,19,52,0,0
599,21/05/2021,3,1,152,152,0,NA,NA,NA
573,27/05/2021,3,1,56,45,11,52,0,0
645,19/05/2021,3,4,37,35,2,94,0,0
459,24/05/2021,3,2,90,52,38,49,0,0
157,26/05/2021,3,1,82,76,6,85,0,0
129,19/05/2021,3,12,188,90,98,49,0,0
730,23/05/2021,3,1,74,23,51,49,0,0
802,21/05/2021,3,1,64,61,3,93,0,0
735,30/05/2021,3,1,28,27,1,103,0,0
813,27/05/2021,3,1,129,104,25,52,0,0
321,24/05/2021,3,1,39,17,22,49,0,0
496,30/05/2021,3,1,59,59,0,NA,NA,NA
430,30/05/2021,3,3,86,77,9,74,0,0
367,08/05/2021,3,2,72,4,68,49,0,0
572,19/05/2021,3,0,61,42,19,67,0,0
745,30/05/2021,3,2,103,104,-1,NA,NA,NA
397,24/05/2021,3,0,75,66,9,74,0,0
182,23/05/2021,3,2,78,14,64,49,0,0
871,16/05/2021,3,2,76,26,50,49,0,0
6,27/05/2021,3,0,190,29,161,49,0,0
614,23/05/2021,3,2,80,26,54,49,0,0
746,26/05/2021,3,1,59,43,16,77,0,0
211,21/05/2021,3,3,57,28,29,55,0,0
826,23/05/2021,3,2,96,76,20,57,0,0
701,18/05/2021,3,2,60,47,13,84,0,0
583,23/05/2021,3,2,79,16,63,49,0,0
183,24/05/2021,3,0,80,49,31,69,0,0
659,22/05/2021,3,1,42,39,3,148,0,0
591,28/05/2021,3,0,68,40,28,55,0,0
269,30/05/2021,3,0,80,30,50,49,0,0
360,27/05/2021,3,1,43,26,17,55,0,0
352,25/05/2021,3,0,64,42,22,64,0,0
817,20/05/2021,3,0,83,39,44,49,0,0
42,22/05/2021,3,1,98,96,2,79,0,0
102,19/05/2021,3,0,60,37,23,60,0,0
887,22/05/2021,3,19,304,12,292,39,0,0
34,25/05/2021,3,2,86,50,36,64,0,0
407,22/05/2021,3,1,40,35,5,74,0,0
96,24/05/2021,3,14,55,44,11,63,0,0
850,22/05/2021,3,1,82,82,0,NA,NA,NA
383,19/05/2021,3,3,82,80,2,123,0,0
831,29/05/2021,3,1,149,96,53,52,0,0
240,18/05/2021,3,1,70,30,40,55,0,0
282,28/05/2021,3,26,675,307,368,49,0,0
308,26/05/2021,3,2,46,23,23,52,0,0
691,30/05/2021,3,1,31,31,0,NA,NA,NA
854,23/05/2021,3,5,105,23,82,70,0,0
671,04/05/2021,3,2,63,63,0,NA,NA,NA
359,15/05/2021,3,3,101,16,85,49,0,0
902,19/05/2021,3,1,125,107,18,62,0,0
696,28/05/2021,3,0,89,50,39,55,0,0
445,21/05/2021,3,2,167,32,135,49,0,0
88,24/05/2021,3,1,41,28,13,60,0,0
80,21/05/2021,3,2,123,56,67,55,0,0
69,26/05/2021,3,2,58,46,12,62,0,0
688,28/05/2021,3,1,118,118,0,NA,NA,NA
725,21/05/2021,3,0,17,17,0,NA,NA,NA
719,08/05/2021,3,0,41,10,31,49,0,0
877,24/05/2021,3,0,158,52,106,35,0,0
24,22/05/2021,3,0,84,82,2,74,0,0
377,19/05/2021,3,0,149,132,17,82,0,0
819,27/05/2021,3,1,79,78,1,94,0,0
645,20/05/2021,3,2,39,28,11,60,0,0
913,25/05/2021,3,0,105,30,75,115,0,0
774,25/05/2021,3,6,99,51,48,49,0,0
616,15/05/2021,3,1,74,27,47,49,0,0
268,21/05/2021,3,1,77,63,14,82,0,0
161,22/05/2021,3,1,60,60,0,NA,NA,NA
155,29/05/2021,3,0,93,90,3,151,0,0
92,28/05/2021,3,1,121,74,47,55,0,0
51,25/05/2021,3,2,78,67,11,94,0,0
527,30/05/2021,3,4,57,57,0,NA,NA,NA
872,19/05/2021,3,1,64,64,0,NA,NA,NA
693,08/05/2021,3,5,120,11,109,49,0,0
374,19/05/2021,3,0,56,33,23,64,0,0
615,18/05/2021,3,0,71,52,19,62,0,0
851,24/05/2021,3,0,92,33,59,49,0,0
267,23/05/2021,3,2,81,24,57,49,0,0
649,16/05/2021,3,2,62,18,44,49,0,0
325,27/05/2021,3,0,45,35,10,62,0,0
70,24/05/2021,3,1,38,20,18,83,0,0
164,25/05/2021,3,0,62,39,23,62,0,0
498,22/05/2021,3,0,87,33,54,55,0,0
47,24/05/2021,3,0,57,45,12,72,0,0
371,15/05/2021,3,1,35,11,24,49,0,0
748,23/05/2021,3,13,131,51,80,49,0,0
617,24/05/2021,3,1,43,27,16,60,0,0
919,24/05/2021,3,19,104,74,30,55,0,0
652,28/05/2021,3,0,69,43,26,55,0,0
462,23/05/2021,3,9,180,3,177,60,0,0
465,25/05/2021,3,33,234,114,120,55,0,0
728,25/05/2021,3,0,47,41,6,57,0,0
271,22/05/2021,3,0,70,63,7,79,0,0
607,22/05/2021,3,1,74,67,7,74,0,0
743,20/05/2021,3,0,126,68,58,55,0,0
887,24/05/2021,3,19,304,16,288,39,0,0
143,24/05/2021,3,4,116,86,30,74,0,0
559,22/05/2021,3,45,140,140,0,NA,NA,NA
256,24/05/2021,3,1,108,85,23,63,0,0
604,18/05/2021,3,0,82,40,42,55,0,0
681,19/05/2021,3,2,69,62,7,84,0,0
389,27/05/2021,3,2,124,61,63,49,0,0
576,16/05/2021,3,1,57,9,48,49,0,0
282,29/05/2021,3,26,675,272,403,49,0,0
579,27/05/2021,3,0,44,29,15,64,0,0
222,29/05/2021,3,0,77,77,0,NA,NA,NA
177,24/05/2021,3,0,48,16,32,59,0,0
671,05/05/2021,3,2,63,63,0,NA,NA,NA
288,12/05/2021,3,0,60,38,22,67,0,0
212,20/05/2021,3,1,77,61,16,72,0,0
400,28/05/2021,3,3,27,18,9,60,0,0
653,22/05/2021,3,2,113,75,38,55,0,0
99,24/05/2021,3,1,166,93,73,49,0,0
601,21/05/2021,3,2,66,40,26,67,0,0
378,26/05/2021,3,1,83,66,17,67,0,0
899,18/05/2021,3,3,102,101,1,115,0,0
225,19/05/2021,3,11,69,51,18,77,0,0
532,09/05/2021,3,0,84,35,49,49,0,0
463,19/05/2021,3,0,163,99,64,55,0,0
580,25/05/2021,3,0,98,91,7,83,0,0
273,18/05/2021,3,0,103,98,5,90,0,0
819,28/05/2021,3,1,79,77,2,127,0,0
81,21/05/2021,3,1,59,19,40,55,0,0
181,24/05/2021,3,0,34,22,12,55,0,0
497,26/05/2021,3,4,189,123,66,49,0,0
428,16/05/2021,3,5,87,30,57,49,0,0
268,23/05/2021,3,1,77,48,29,49,0,0
161,23/05/2021,3,1,60,37,23,62,0,0
565,28/05/2021,3,0,62,40,22,87,0,0
422,28/05/2021,3,1,78,60,18,67,0,0
213,23/05/2021,3,4,144,83,61,49,0,0
816,30/05/2021,3,0,82,82,0,NA,NA,NA
872,20/05/2021,3,1,64,64,0,NA,NA,NA
367,09/05/2021,3,2,72,3,69,49,0,0
631,19/05/2021,3,1,70,59,11,72,0,0
852,18/05/2021,3,0,80,80,0,NA,NA,NA
557,24/05/2021,3,0,104,56,48,55,0,0
491,23/05/2021,3,5,174,70,104,49,0,0
649,18/05/2021,3,2,62,60,2,147,0,0
873,26/05/2021,3,4,97,89,8,62,0,0
705,25/05/2021,3,1,90,69,21,49,0,0
673,24/05/2021,3,6,117,53,64,49,0,0
806,22/05/2021,3,1,135,134,1,90,0,0
236,24/05/2021,3,2,117,14,103,49,0,0
514,14/05/2021,3,6,228,19,209,49,0,0
233,24/05/2021,3,3,64,39,25,57,0,0
228,24/05/2021,3,2,40,14,26,49,0,0
35,23/05/2021,3,1,109,19,90,49,0,0
133,28/05/2021,3,3,61,61,0,NA,NA,NA
15,23/05/2021,3,0,31,21,10,82,0,0
907,25/05/2021,3,3,77,55,22,74,0,0
136,25/05/2021,3,0,128,94,34,77,0,0
817,19/05/2021,3,0,83,25,58,55,0,0
589,22/05/2021,3,4,139,113,26,74,0,0
39,20/05/2021,3,1,60,48,12,74,0,0
219,21/05/2021,3,4,73,22,51,55,0,0
626,24/05/2021,3,3,99,49,50,55,0,0
668,21/05/2021,3,4,299,38,261,49,0,0
643,25/05/2021,3,2,101,68,33,62,0,0
124,20/05/2021,3,1,53,53,0,NA,NA,NA
918,18/05/2021,3,0,201,41,160,39,0,0
831,28/05/2021,3,2,148,65,83,49,0,0
513,16/05/2021,3,1,76,10,66,49,0,0
347,22/05/2021,3,2,60,60,0,NA,NA,NA
308,24/05/2021,3,2,46,18,28,49,0,0
275,29/05/2021,3,0,117,117,0,NA,NA,NA
854,24/05/2021,3,6,104,19,85,100,0,0
722,02/05/2021,3,1,41,10,31,49,0,0
843,14/05/2021,3,3,63,19,44,49,0,0
212,18/05/2021,3,1,77,64,13,82,0,0
380,26/05/2021,3,1,159,72,87,55,0,0
445,22/05/2021,3,2,167,42,125,49,0,0
803,24/05/2021,3,1,68,59,9,63,0,0
501,22/05/2021,3,26,207,207,0,NA,NA,NA
175,26/05/2021,3,13,107,64,43,49,0,0
104,18/05/2021,3,1,61,59,2,127,0,0
363,19/05/2021,3,3,96,76,20,64,0,0
577,10/05/2021,3,0,78,19,59,49,0,0
463,20/05/2021,3,0,163,125,38,55,0,0
694,23/05/2021,3,4,105,21,84,49,0,0
395,19/05/2021,3,1,71,46,25,57,0,0
847,23/05/2021,3,5,192,49,143,35,0,0
351,21/05/2021,3,1,65,51,14,127,0,0
508,24/05/2021,3,2,78,64,14,57,0,0
7,25/05/2021,3,3,100,28,72,55,0,0
344,17/05/2021,3,1,64,30,34,49,0,0
761,21/05/2021,3,2,81,44,37,55,0,0
802,22/05/2021,3,1,64,64,0,NA,NA,NA
528,30/05/2021,3,0,119,117,2,75,0,0
813,28/05/2021,3,1,129,115,14,67,0,0
163,23/05/2021,3,1,61,49,12,68,0,0
142,28/05/2021,3,1,61,61,0,NA,NA,NA
650,18/05/2021,3,2,126,61,65,60,0,0
536,09/05/2021,3,1,80,28,52,49,0,0
737,18/05/2021,3,2,40,15,25,52,0,0
852,19/05/2021,3,0,80,80,0,NA,NA,NA
300,25/05/2021,3,0,210,101,109,55,0,0
666,23/05/2021,3,2,64,34,30,49,0,0
871,19/05/2021,3,2,76,68,8,62,0,0
49,27/05/2021,3,9,139,102,37,49,0,0
409,21/05/2021,3,1,106,60,46,55,0,0
673,25/05/2021,3,5,118,74,44,52,0,0
915,22/05/2021,3,5,184,16,168,35,0,0
704,24/05/2021,3,1,31,21,10,49,0,0
823,14/05/2021,3,1,60,48,12,52,0,0
86,22/05/2021,3,1,47,42,5,74,0,0
594,24/05/2021,3,16,102,86,16,82,0,0
35,22/05/2021,3,1,109,89,20,67,0,0
46,28/05/2021,3,1,59,39,20,54,0,0
15,25/05/2021,3,0,31,31,0,NA,NA,NA
907,27/05/2021,3,3,77,60,17,74,0,0
598,25/05/2021,3,0,146,113,33,107,0,0
342,20/05/2021,3,0,114,39,75,49,0,0
413,23/05/2021,3,3,113,59,54,49,0,0
706,20/05/2021,3,1,73,66,7,62,0,0
219,24/05/2021,3,5,72,26,46,49,0,0
750,24/05/2021,3,3,109,80,29,79,0,0
290,22/05/2021,3,2,105,66,39,55,0,0
531,25/05/2021,3,1,58,36,22,52,0,0
850,18/05/2021,3,2,81,55,26,49,0,0
534,19/05/2021,3,0,85,42,43,49,0,0
176,27/05/2021,3,1,99,50,49,49,0,0
513,17/05/2021,3,1,76,38,38,49,0,0
207,22/05/2021,3,2,61,53,8,74,0,0
322,24/05/2021,3,3,97,27,70,49,0,0
275,30/05/2021,3,0,117,117,0,NA,NA,NA
429,22/05/2021,3,3,122,39,83,55,0,0
722,04/05/2021,3,1,41,39,2,115,0,0
495,16/05/2021,3,1,84,9,75,49,0,0
304,18/05/2021,3,2,58,50,8,77,0,0
785,26/05/2021,3,1,109,81,28,102,0,0
828,21/05/2021,3,0,75,72,3,108,0,0
19,22/05/2021,3,1,93,60,33,92,0,0
355,22/05/2021,3,3,96,96,0,NA,NA,NA
504,26/05/2021,3,0,83,19,64,49,0,0
479,18/05/2021,3,1,54,33,21,52,0,0
21,19/05/2021,3,1,59,28,31,49,0,0
44,08/05/2021,3,6,102,82,20,52,0,0
692,20/05/2021,3,0,87,46,41,49,0,0
680,25/05/2021,3,3,77,30,47,49,0,0
599,19/05/2021,3,1,152,144,8,65,0,0
847,24/05/2021,3,6,191,44,147,35,0,0
291,19/05/2021,3,1,60,31,29,52,0,0
313,24/05/2021,3,0,31,22,9,52,0,0
105,25/05/2021,3,5,70,48,22,82,0,0
662,17/05/2021,3,2,105,52,53,49,0,0
800,22/05/2021,3,2,55,54,1,85,0,0
59,21/05/2021,3,4,71,35,36,55,0,0
788,22/05/2021,3,2,89,89,0,NA,NA,NA
622,27/05/2021,3,8,36,21,15,84,0,0
417,25/05/2021,3,0,103,81,22,62,0,0
390,29/05/2021,3,2,134,134,0,NA,NA,NA
758,20/05/2021,3,2,71,55,16,67,0,0
693,10/05/2021,3,5,120,4,116,49,0,0
737,19/05/2021,3,2,40,18,22,49,0,0
89,18/05/2021,3,2,58,36,22,49,0,0
768,24/05/2021,3,1,86,51,35,60,0,0
281,23/05/2021,3,2,81,18,63,49,0,0
649,20/05/2021,3,2,62,61,1,90,0,0
787,27/05/2021,3,21,87,85,2,89,0,0
780,21/05/2021,3,1,59,46,13,55,0,0
673,26/05/2021,3,5,118,74,44,52,0,0
67,20/05/2021,3,1,51,35,16,64,0,0
488,24/05/2021,3,1,65,47,18,74,0,0
111,17/05/2021,3,0,60,54,6,94,0,0
511,22/05/2021,3,1,75,58,17,67,0,0
594,22/05/2021,3,39,68,64,4,139,0,0
376,24/05/2021,3,1,63,60,3,79,0,0
809,28/05/2021,3,4,97,81,16,57,0,0
251,23/05/2021,3,2,122,25,97,49,0,0
114,27/05/2021,3,0,75,52,23,121,0,0
404,27/05/2021,3,0,67,34,33,114,0,0
259,21/05/2021,3,0,60,54,6,169,0,0
198,23/05/2021,3,0,135,54,81,49,0,0
199,18/05/2021,3,1,81,69,12,74,0,0
349,24/05/2021,3,2,88,56,32,60,0,0
76,25/05/2021,3,1,92,88,4,87,0,0
107,23/05/2021,3,2,87,56,31,62,0,0
256,25/05/2021,3,1,108,80,28,65,0,0
842,19/05/2021,3,2,89,51,38,49,0,0
632,18/05/2021,3,0,82,38,44,59,0,0
855,27/05/2021,3,6,170,98,72,49,0,0
812,17/05/2021,3,2,135,62,73,49,0,0
515,22/05/2021,3,7,105,103,2,84,0,0
403,27/05/2021,3,3,95,64,31,77,0,0
861,29/05/2021,3,0,61,61,0,NA,NA,NA
232,22/05/2021,3,1,64,63,1,131,0,0
775,03/05/2021,3,2,107,13,94,49,0,0
328,16/05/2021,3,4,94,21,73,49,0,0
210,20/05/2021,3,2,100,80,20,57,0,0
423,28/05/2021,3,1,49,39,10,67,0,0
621,22/05/2021,3,0,60,53,7,87,0,0
19,23/05/2021,3,1,93,21,72,49,0,0
610,22/05/2021,3,2,65,65,0,NA,NA,NA
795,28/05/2021,3,7,98,78,20,60,0,0
264,18/05/2021,3,0,60,40,20,55,0,0
827,19/05/2021,3,1,69,63,6,74,0,0
595,10/05/2021,3,2,48,20,28,57,0,0
663,21/05/2021,3,0,148,73,75,55,0,0
651,23/05/2021,3,1,77,23,54,49,0,0
395,20/05/2021,3,1,71,49,22,52,0,0
847,26/05/2021,3,6,191,70,121,35,0,0
606,20/05/2021,3,1,45,29,16,57,0,0
550,24/05/2021,3,1,111,54,57,49,0,0
585,26/05/2021,3,2,58,53,5,107,0,0
115,19/05/2021,3,0,115,23,92,49,0,0
471,22/05/2021,3,6,114,95,19,74,0,0
59,22/05/2021,3,4,71,52,19,67,0,0
478,21/05/2021,3,0,20,20,0,NA,NA,NA
3,28/05/2021,3,8,105,35,70,55,0,0
266,23/05/2021,3,0,61,37,24,49,0,0
816,29/05/2021,3,0,82,82,0,NA,NA,NA
113,18/05/2021,3,1,31,14,17,49,0,0
367,07/05/2021,3,2,72,11,61,49,0,0
246,16/05/2021,3,1,111,18,93,49,0,0
89,20/05/2021,3,2,58,37,21,49,0,0
853,24/05/2021,3,1,101,73,28,60,0,0
296,24/05/2021,3,3,57,22,35,49,0,0
548,16/05/2021,3,1,90,35,55,49,0,0
118,21/05/2021,3,2,57,18,39,55,0,0
70,22/05/2021,3,1,38,28,10,139,0,0
713,24/05/2021,3,2,59,57,2,141,0,0
669,20/05/2021,3,0,87,63,24,52,0,0
154,25/05/2021,3,2,102,81,21,57,0,0
514,13/05/2021,3,6,228,27,201,49,0,0
583,22/05/2021,3,1,80,35,45,55,0,0
262,22/05/2021,3,1,50,43,7,67,0,0
674,24/05/2021,3,1,97,37,60,49,0,0
444,28/05/2021,3,4,115,82,33,49,0,0
350,23/05/2021,3,2,58,36,22,52,0,0
311,27/05/2021,3,0,97,55,42,60,0,0
714,27/05/2021,3,0,59,26,33,60,0,0
184,22/05/2021,3,0,51,43,8,85,0,0
864,23/05/2021,3,2,83,26,57,49,0,0
134,19/05/2021,3,1,47,40,7,77,0,0
349,21/05/2021,3,1,89,74,15,67,0,0
805,25/05/2021,3,0,113,98,15,84,0,0
5,22/05/2021,3,5,84,43,41,55,0,0
441,24/05/2021,3,0,168,30,138,75,0,0
61,19/05/2021,3,3,97,57,40,64,0,0
418,19/05/2021,3,0,116,30,86,49,0,0
505,27/05/2021,3,0,84,25,59,49,0,0
513,18/05/2021,3,1,76,42,34,49,0,0
781,22/05/2021,3,3,80,79,1,118,0,0
472,27/05/2021,3,2,232,94,138,85,0,0
861,30/05/2021,3,0,61,61,0,NA,NA,NA
854,22/05/2021,3,5,105,48,57,130,0,0
775,04/05/2021,3,2,107,46,61,49,0,0
495,11/05/2021,3,2,83,16,67,49,0,0
330,19/05/2021,3,3,116,40,76,55,0,0
189,27/05/2021,3,0,165,115,50,64,0,0
741,22/05/2021,3,0,70,41,29,55,0,0
334,24/05/2021,3,1,57,29,28,57,0,0
870,22/05/2021,3,2,44,41,3,74,0,0
175,27/05/2021,3,14,106,65,41,49,0,0
264,19/05/2021,3,0,60,38,22,60,0,0
725,19/05/2021,3,0,17,13,4,80,0,0
532,13/05/2021,3,0,84,51,33,64,0,0
140,23/05/2021,3,0,170,71,99,49,0,0
680,24/05/2021,3,3,77,42,35,49,0,0
599,20/05/2021,3,1,152,127,25,62,0,0
847,25/05/2021,3,6,191,85,106,35,0,0
606,21/05/2021,3,1,45,30,15,95,0,0
698,24/05/2021,3,3,113,50,63,49,0,0
798,25/05/2021,3,1,80,77,3,135,0,0
135,17/05/2021,3,5,61,57,4,85,0,0
268,22/05/2021,3,1,77,67,10,111,0,0
59,23/05/2021,3,5,70,14,56,49,0,0
478,22/05/2021,3,0,20,20,0,NA,NA,NA
292,28/05/2021,3,0,239,104,135,55,0,0
321,25/05/2021,3,1,39,27,12,59,0,0
167,30/05/2021,3,0,84,84,0,NA,NA,NA
113,19/05/2021,3,1,31,18,13,52,0,0
693,07/05/2021,3,5,120,7,113,49,0,0
533,16/05/2021,3,1,90,3,87,49,0,0
171,18/05/2021,3,2,47,20,27,49,0,0
48,22/05/2021,3,2,177,34,143,55,0,0
450,24/05/2021,3,3,181,101,80,49,0,0
548,18/05/2021,3,1,90,61,29,60,0,0
234,21/05/2021,3,3,59,31,28,49,0,0
717,25/05/2021,3,2,191,103,88,55,0,0
587,24/05/2021,3,2,79,49,30,62,0,0
498,21/05/2021,3,0,87,34,53,55,0,0
759,22/05/2021,3,3,84,54,30,60,0,0
660,13/05/2021,3,6,180,30,150,49,0,0
703,22/05/2021,3,1,90,79,11,67,0,0
262,24/05/2021,3,1,50,36,14,60,0,0
197,22/05/2021,3,0,118,88,30,67,0,0
353,28/05/2021,3,1,51,44,7,77,0,0
462,24/05/2021,3,9,180,3,177,75,0,0
293,26/05/2021,3,1,59,28,31,52,0,0
136,27/05/2021,3,0,128,112,16,77,0,0
689,22/05/2021,3,0,130,129,1,130,0,0
332,23/05/2021,3,0,40,18,22,49,0,0
39,17/05/2021,3,1,60,47,13,74,0,0
215,23/05/2021,3,1,45,26,19,49,0,0
886,25/05/2021,3,2,150,84,66,49,0,0
316,22/05/2021,3,1,38,35,3,67,0,0
820,24/05/2021,3,0,127,120,7,80,0,0
604,22/05/2021,3,0,82,57,25,110,0,0
60,18/05/2021,3,0,57,26,31,72,0,0
837,29/05/2021,3,4,322,96,226,100,0,0
63,19/05/2021,3,8,56,25,31,49,0,0
347,23/05/2021,3,11,51,45,6,76,0,0
764,27/05/2021,3,2,67,25,42,49,0,0
691,21/05/2021,3,1,31,30,1,92,0,0
33,23/05/2021,3,2,78,35,43,53,0,0
775,05/05/2021,3,2,107,29,78,49,0,0
359,11/05/2021,3,3,101,52,49,59,0,0
210,18/05/2021,3,2,100,96,4,71,0,0
895,26/05/2021,3,0,69,46,23,60,0,0
201,21/05/2021,3,10,128,56,72,55,0,0
803,22/05/2021,3,0,69,65,4,125,0,0
97,22/05/2021,3,4,103,84,19,85,0,0
378,27/05/2021,3,1,83,71,12,57,0,0
408,19/05/2021,3,4,161,55,106,49,0,0
214,20/05/2021,3,3,83,76,7,62,0,0
719,10/05/2021,3,0,41,17,24,59,0,0
140,24/05/2021,3,0,170,83,87,49,0,0
461,24/05/2021,3,2,120,17,103,90,0,0
336,21/05/2021,3,1,73,71,2,146,0,0
847,28/05/2021,3,6,191,53,138,35,0,0
773,18/05/2021,3,1,73,65,8,59,0,0
814,24/05/2021,3,1,67,65,2,68,0,0
798,26/05/2021,3,1,80,70,10,105,0,0
129,15/05/2021,3,11,189,152,37,64,0,0
22,20/05/2021,3,0,64,52,12,80,0,0
473,23/05/2021,3,2,48,32,16,52,0,0
788,21/05/2021,3,2,89,89,0,NA,NA,NA
3,29/05/2021,3,8,105,50,55,55,0,0
427,25/05/2021,3,6,304,33,271,90,0,0
467,21/05/2021,3,3,109,23,86,90,0,0
538,19/05/2021,3,1,43,29,14,57,0,0
693,09/05/2021,3,5,120,3,117,49,0,0
533,17/05/2021,3,1,90,17,73,49,0,0
122,19/05/2021,3,5,116,103,13,85,0,0
48,23/05/2021,3,2,177,7,170,49,0,0
882,24/05/2021,3,0,130,29,101,39,0,0
548,19/05/2021,3,1,90,59,31,55,0,0
734,20/05/2021,3,1,60,61,-1,NA,NA,NA
11,22/05/2021,3,2,82,70,12,74,0,0
561,25/05/2021,3,2,58,48,10,77,0,0
669,21/05/2021,3,0,87,66,21,67,0,0
765,22/05/2021,3,0,101,98,3,119,0,0
660,14/05/2021,3,6,180,18,162,49,0,0
216,23/05/2021,3,1,57,11,46,49,0,0
519,24/05/2021,3,0,64,55,9,77,0,0
919,23/05/2021,3,0,123,46,77,49,0,0
442,28/05/2021,3,8,150,106,44,49,0,0
247,25/05/2021,3,2,91,37,54,55,0,0
43,26/05/2021,3,2,71,37,34,64,0,0
431,26/05/2021,3,3,127,71,56,64,0,0
342,21/05/2021,3,0,114,45,69,55,0,0
607,23/05/2021,3,1,74,27,47,49,0,0
543,17/05/2021,3,1,64,61,3,62,0,0
564,24/05/2021,3,1,73,54,19,52,0,0
220,25/05/2021,3,6,97,64,33,57,0,0
38,23/05/2021,3,1,49,28,21,49,0,0
830,24/05/2021,3,0,66,50,16,113,0,0
61,18/05/2021,3,1,99,64,35,64,0,0
632,20/05/2021,3,0,82,45,37,55,0,0
257,19/05/2021,3,2,42,42,0,NA,NA,NA
812,19/05/2021,3,2,135,82,53,49,0,0
207,23/05/2021,3,1,62,25,37,49,0,0
472,24/05/2021,3,5,229,48,181,85,0,0
612,20/05/2021,3,1,41,40,1,90,0,0
429,23/05/2021,3,3,122,18,104,49,0,0
722,05/05/2021,3,0,42,42,0,NA,NA,NA
261,12/05/2021,3,2,100,14,86,49,0,0
210,19/05/2021,3,2,100,91,9,65,0,0
28,18/05/2021,3,1,127,127,0,NA,NA,NA
358,21/05/2021,3,2,91,76,15,67,0,0
868,22/05/2021,3,0,83,59,24,72,0,0
97,20/05/2021,3,5,102,83,19,72,0,0
858,27/05/2021,3,0,81,78,3,85,0,0
408,20/05/2021,3,4,161,62,99,49,0,0
363,20/05/2021,3,3,96,75,21,64,0,0
44,11/05/2021,3,5,103,54,49,59,0,0
635,24/05/2021,3,0,88,47,41,49,0,0
580,21/05/2021,3,0,98,83,15,74,0,0
605,21/05/2021,3,1,159,117,42,80,0,0
379,23/05/2021,3,7,280,111,169,70,0,0
552,21/05/2021,3,10,174,171,3,79,0,0
55,24/05/2021,3,2,31,19,12,57,0,0
157,25/05/2021,3,1,82,52,30,72,0,0
933,15/05/2021,3,116,31,14,17,35,0,0
447,18/05/2021,3,0,143,115,28,72,0,0
802,23/05/2021,3,1,64,53,11,67,0,0
54,22/05/2021,3,1,60,60,0,NA,NA,NA
292,29/05/2021,3,0,239,141,98,67,0,0
684,25/05/2021,3,3,95,75,20,57,0,0
527,21/05/2021,3,8,53,43,10,67,0,0
569,19/05/2021,3,0,120,40,80,49,0,0
536,08/05/2021,3,1,80,35,45,49,0,0
533,18/05/2021,3,1,90,11,79,49,0,0
171,20/05/2021,3,3,46,13,33,49,0,0
312,24/05/2021,3,2,95,42,53,49,0,0
416,24/05/2021,3,0,34,7,27,49,0,0
169,20/05/2021,3,1,19,18,1,146,0,0
734,21/05/2021,3,1,60,60,0,NA,NA,NA
614,22/05/2021,3,2,80,53,27,52,0,0
736,26/05/2021,3,2,103,56,47,52,0,0
915,21/05/2021,3,5,184,18,166,35,0,0
759,23/05/2021,3,3,84,18,66,49,0,0
111,16/05/2021,3,0,60,30,30,49,0,0
624,23/05/2021,3,1,78,32,46,49,0,0
475,24/05/2021,3,1,98,96,2,63,0,0
35,24/05/2021,3,0,110,17,93,49,0,0
608,28/05/2021,3,12,128,83,45,55,0,0
654,24/05/2021,3,6,53,18,35,90,0,0
311,26/05/2021,3,0,97,61,36,74,0,0
431,27/05/2021,3,3,127,86,41,64,0,0
131,19/05/2021,3,3,46,22,24,52,0,0
648,23/05/2021,3,1,63,21,42,49,0,0
706,19/05/2021,3,1,73,57,16,57,0,0
633,24/05/2021,3,1,49,43,6,65,0,0
180,25/05/2021,3,1,40,25,15,57,0,0
5,23/05/2021,3,5,84,38,46,49,0,0
820,25/05/2021,3,0,127,122,5,80,0,0
61,20/05/2021,3,3,97,52,45,49,0,0
752,19/05/2021,3,13,31,16,15,74,0,0
835,21/05/2021,3,5,99,99,0,NA,NA,NA
576,17/05/2021,3,1,57,21,36,49,0,0
254,23/05/2021,3,1,77,33,44,49,0,0
438,27/05/2021,3,9,87,54,33,64,0,0
52,21/05/2021,3,9,133,114,19,84,0,0
33,24/05/2021,3,2,78,40,38,52,0,0
722,06/05/2021,3,0,42,27,15,67,0,0
359,13/05/2021,3,3,101,46,55,49,0,0
304,19/05/2021,3,2,58,48,10,71,0,0
423,18/05/2021,3,1,49,40,9,90,0,0
828,22/05/2021,3,0,75,71,4,138,0,0
890,23/05/2021,3,0,150,26,124,71,0,0
636,20/05/2021,3,1,119,100,19,62,0,0
175,28/05/2021,3,14,106,65,41,55,0,0
248,18/05/2021,3,0,82,48,34,60,0,0
725,20/05/2021,3,0,17,16,1,94,0,0
44,07/05/2021,3,7,101,63,38,49,0,0
655,24/05/2021,3,0,72,41,31,55,0,0
24,24/05/2021,3,0,84,68,16,60,0,0
640,20/05/2021,3,4,122,52,70,49,0,0
379,24/05/2021,3,18,269,149,120,85,0,0
771,21/05/2021,3,2,28,26,2,79,0,0
98,24/05/2021,3,2,93,70,23,85,0,0
646,25/05/2021,3,18,118,117,1,65,0,0
428,17/05/2021,3,4,88,69,19,67,0,0
447,21/05/2021,3,0,143,91,52,55,0,0
309,22/05/2021,3,0,16,15,1,84,0,0
178,22/05/2021,3,0,38,38,0,NA,NA,NA
3,27/05/2021,3,8,105,34,71,49,0,0
51,23/05/2021,3,2,78,64,14,62,0,0
529,21/05/2021,3,3,38,34,4,74,0,0
872,18/05/2021,3,1,64,64,0,NA,NA,NA
536,10/05/2021,3,1,80,48,32,72,0,0
533,19/05/2021,3,1,90,14,76,49,0,0
710,19/05/2021,3,0,20,14,6,64,0,0
540,24/05/2021,3,2,80,38,42,49,0,0
239,23/05/2021,3,1,39,22,17,52,0,0
297,18/05/2021,3,1,75,44,31,55,0,0
49,21/05/2021,3,2,146,31,115,55,0,0
705,22/05/2021,3,3,88,79,9,74,0,0
547,24/05/2021,3,1,73,45,28,127,0,0
368,22/05/2021,3,1,84,63,21,103,0,0
704,23/05/2021,3,1,31,8,23,49,0,0
265,17/05/2021,3,1,56,31,25,49,0,0
86,24/05/2021,3,1,47,28,19,52,0,0
262,23/05/2021,3,1,50,28,22,49,0,0
85,23/05/2021,3,7,113,71,42,65,0,0
555,28/05/2021,3,0,117,106,11,70,0,0
654,25/05/2021,3,6,53,17,36,95,0,0
783,26/05/2021,3,1,79,61,18,85,0,0
584,27/05/2021,3,1,96,84,12,99,0,0
131,20/05/2021,3,4,45,24,21,49,0,0
413,22/05/2021,3,3,113,112,1,77,0,0
341,17/05/2021,3,2,112,98,14,67,0,0
633,25/05/2021,3,1,49,37,12,67,0,0
285,25/05/2021,3,0,80,48,32,59,0,0
530,21/05/2021,3,1,59,57,2,72,0,0
820,26/05/2021,3,0,127,106,21,72,0,0
144,21/05/2021,3,2,97,85,12,77,0,0
675,20/05/2021,3,1,55,44,11,74,0,0
257,20/05/2021,3,1,43,41,2,112,0,0
345,15/05/2021,3,0,101,24,77,49,0,0
867,22/05/2021,3,1,59,58,1,165,0,0
715,27/05/2021,3,0,88,67,21,82,0,0
222,22/05/2021,3,0,77,51,26,81,0,0
767,24/05/2021,3,2,65,52,13,77,0,0
722,03/05/2021,3,1,41,14,27,55,0,0
261,14/05/2021,3,2,100,19,81,49,0,0
117,20/05/2021,3,1,93,76,17,74,0,0
423,19/05/2021,3,1,49,40,9,145,0,0
414,21/05/2021,3,21,165,162,3,111,0,0
334,22/05/2021,3,0,58,35,23,110,0,0
870,20/05/2021,3,3,43,35,8,67,0,0
586,27/05/2021,3,4,79,50,29,59,0,0
535,18/05/2021,3,1,82,39,43,52,0,0
346,21/05/2021,3,5,115,94,21,60,0,0
577,06/05/2021,3,0,78,15,63,49,0,0
655,23/05/2021,3,0,72,41,31,53,0,0
469,25/05/2021,3,4,192,40,152,95,0,0
605,18/05/2021,3,1,159,59,100,49,0,0
379,26/05/2021,3,20,267,146,121,90,0,0
388,20/05/2021,3,1,59,38,21,52,0,0
319,24/05/2021,3,6,108,63,45,49,0,0
105,26/05/2021,3,5,70,53,17,85,0,0
616,17/05/2021,3,3,72,50,22,52,0,0
682,20/05/2021,3,2,78,38,40,49,0,0
309,23/05/2021,3,0,16,13,3,65,0,0
178,21/05/2021,3,0,38,29,9,67,0,0
642,27/05/2021,3,2,93,65,28,49,0,0
875,23/05/2021,3,0,92,41,51,49,0,0
467,22/05/2021,3,3,109,30,79,100,0,0
839,19/05/2021,3,3,152,116,36,57,0,0
727,07/05/2021,3,1,74,30,44,49,0,0
374,16/05/2021,3,0,56,10,46,49,0,0
370,19/05/2021,3,0,40,30,10,82,0,0
768,23/05/2021,3,6,81,35,46,49,0,0
790,23/05/2021,3,1,98,32,66,75,0,0
297,19/05/2021,3,1,75,35,40,55,0,0
258,20/05/2021,3,1,142,122,20,74,0,0
705,23/05/2021,3,3,88,41,47,49,0,0
229,26/05/2021,3,1,55,54,1,142,0,0
560,22/05/2021,3,0,80,55,25,116,0,0
18,24/05/2021,3,2,90,78,12,57,0,0
391,17/05/2021,3,0,76,47,29,49,0,0
216,24/05/2021,3,1,57,47,10,52,0,0
848,23/05/2021,3,6,132,15,117,35,0,0
665,23/05/2021,3,2,104,54,50,52,0,0
581,28/05/2021,3,49,176,156,20,75,0,0
393,25/05/2021,3,1,59,37,22,52,0,0
846,25/05/2021,3,1,188,62,126,45,0,0
832,26/05/2021,3,1,99,52,47,49,0,0
243,20/05/2021,3,1,126,59,67,49,0,0
287,23/05/2021,3,1,122,27,95,49,0,0
126,20/05/2021,3,3,117,96,21,57,0,0
556,23/05/2021,3,2,115,67,48,65,0,0
385,24/05/2021,3,2,61,40,21,72,0,0
407,21/05/2021,3,1,40,37,3,77,0,0
643,24/05/2021,3,2,101,57,44,49,0,0
289,22/05/2021,3,3,65,14,51,55,0,0
235,18/05/2021,3,6,151,35,116,49,0,0
434,21/05/2021,3,2,58,12,46,55,0,0
345,16/05/2021,3,0,101,35,66,49,0,0
869,22/05/2021,3,1,59,55,4,146,0,0
579,19/05/2021,3,0,44,37,7,62,0,0
481,21/05/2021,3,0,56,56,0,NA,NA,NA
274,23/05/2021,3,2,208,12,196,39,0,0
671,02/05/2021,3,2,63,62,1,85,0,0
328,14/05/2021,3,5,93,13,80,49,0,0
330,18/05/2021,3,3,116,39,77,60,0,0
400,18/05/2021,3,2,28,8,20,49,0,0
358,22/05/2021,3,2,91,90,1,88,0,0
890,24/05/2021,3,0,150,27,123,77,0,0
656,22/05/2021,3,0,115,96,19,157,0,0
795,27/05/2021,3,6,99,67,32,55,0,0
104,20/05/2021,3,1,61,50,11,85,0,0
664,19/05/2021,3,3,152,121,31,67,0,0
577,13/05/2021,3,0,78,17,61,49,0,0
457,19/05/2021,3,1,62,36,26,52,0,0
651,25/05/2021,3,1,77,31,46,52,0,0
605,19/05/2021,3,1,159,81,78,49,0,0
23,24/05/2021,3,0,64,46,18,55,0,0
291,21/05/2021,3,1,60,40,20,55,0,0
301,24/05/2021,3,1,100,29,71,49,0,0
166,26/05/2021,3,1,65,57,8,63,0,0
428,19/05/2021,3,4,88,60,28,72,0,0
800,21/05/2021,3,2,55,32,23,55,0,0
473,22/05/2021,3,2,48,48,0,NA,NA,NA
155,21/05/2021,3,0,93,72,21,85,0,0
292,19/05/2021,3,0,239,33,206,49,0,0
138,24/05/2021,3,0,98,49,49,49,0,0
142,22/05/2021,3,2,60,40,20,102,0,0
373,19/05/2021,3,1,102,66,36,60,0,0
727,10/05/2021,3,1,74,31,43,55,0,0
435,19/05/2021,3,62,58,28,30,52,0,0
710,20/05/2021,3,0,20,15,5,67,0,0
348,23/05/2021,3,9,131,48,83,49,0,0
707,23/05/2021,3,1,39,32,7,61,0,0
315,16/05/2021,3,0,62,44,18,60,0,0
521,20/05/2021,3,1,54,41,13,52,0,0
409,23/05/2021,3,7,100,28,72,49,0,0
27,26/05/2021,3,0,78,61,17,113,0,0
669,22/05/2021,3,0,87,85,2,74,0,0
759,24/05/2021,3,3,84,38,46,49,0,0
514,18/05/2021,3,6,228,54,174,49,0,0
624,22/05/2021,3,1,78,67,11,74,0,0
193,24/05/2021,3,1,107,46,61,49,0,0
85,24/05/2021,3,7,113,85,28,82,0,0
231,23/05/2021,3,0,41,12,29,49,0,0
399,23/05/2021,3,1,60,48,12,100,0,0
333,27/05/2021,3,1,56,48,8,106,0,0
439,27/05/2021,3,3,88,31,57,49,0,0
190,21/05/2021,3,5,75,60,15,60,0,0
42,23/05/2021,3,1,98,52,46,49,0,0
341,20/05/2021,3,2,112,108,4,79,0,0
633,21/05/2021,3,1,49,30,19,55,0,0
180,24/05/2021,3,1,40,21,19,49,0,0
476,23/05/2021,3,0,173,15,158,49,0,0
531,24/05/2021,3,1,58,36,22,49,0,0
604,19/05/2021,3,0,82,43,39,55,0,0
681,20/05/2021,3,2,69,49,20,74,0,0
389,19/05/2021,3,2,124,69,55,49,0,0
810,17/05/2021,3,0,389,33,356,55,0,0
592,23/05/2021,3,1,83,68,15,68,0,0
308,18/05/2021,3,1,47,16,31,52,0,0
275,22/05/2021,3,2,115,115,0,NA,NA,NA
108,22/05/2021,3,0,78,50,28,60,0,0
671,03/05/2021,3,2,63,61,2,82,0,0
843,16/05/2021,3,3,63,16,47,49,0,0
117,19/05/2021,3,1,93,87,6,77,0,0
400,19/05/2021,3,2,28,12,16,52,0,0
494,21/05/2021,3,3,136,44,92,55,0,0
485,23/05/2021,3,0,65,18,47,49,0,0
697,22/05/2021,3,2,107,78,29,93,0,0
889,28/05/2021,3,1,123,4,119,45,0,0
408,18/05/2021,3,4,161,37,124,49,0,0
225,20/05/2021,3,11,69,48,21,67,0,0
876,13/05/2021,3,2,180,51,129,45,0,0
140,20/05/2021,3,1,169,119,50,52,0,0
680,23/05/2021,3,3,77,45,32,49,0,0
640,19/05/2021,3,4,122,46,76,49,0,0
23,27/05/2021,3,1,63,39,24,55,0,0
388,21/05/2021,3,1,59,28,31,55,0,0
724,24/05/2021,3,1,85,72,13,163,0,0
774,26/05/2021,3,9,96,61,35,52,0,0
756,15/05/2021,3,0,106,57,49,55,0,0
730,21/05/2021,3,1,74,41,33,55,0,0
802,20/05/2021,3,1,64,64,0,NA,NA,NA
54,21/05/2021,3,1,60,49,11,67,0,0
202,19/05/2021,3,0,76,76,0,NA,NA,NA
417,24/05/2021,3,0,103,91,12,62,0,0
173,22/05/2021,3,2,69,67,2,77,0,0
650,20/05/2021,3,2,126,95,31,60,0,0
727,08/05/2021,3,1,74,45,29,49,0,0
631,18/05/2021,3,1,70,56,14,72,0,0
852,20/05/2021,3,0,80,75,5,75,0,0
851,23/05/2021,3,0,92,26,66,49,0,0
401,23/05/2021,3,0,79,29,50,49,0,0
726,17/05/2021,3,0,39,30,9,89,0,0
787,20/05/2021,3,4,104,98,6,62,0,0
70,23/05/2021,3,1,38,16,22,74,0,0
27,24/05/2021,3,0,78,66,12,97,0,0
4,21/05/2021,3,1,63,57,6,107,0,0
47,25/05/2021,3,0,57,41,16,90,0,0
701,17/05/2021,3,2,60,41,19,60,0,0
703,24/05/2021,3,1,90,83,7,77,0,0
848,22/05/2021,3,6,132,53,79,35,0,0
307,22/05/2021,3,1,78,72,6,84,0,0
677,23/05/2021,3,0,40,15,25,49,0,0
56,25/05/2021,3,1,64,46,18,90,0,0
500,27/05/2021,3,6,73,30,43,49,0,0
506,27/05/2021,3,1,194,58,136,49,0,0
778,21/05/2021,3,2,79,61,18,109,0,0
648,22/05/2021,3,1,63,56,7,77,0,0
134,17/05/2021,3,2,46,31,15,55,0,0
215,25/05/2021,3,1,45,38,7,82,0,0
857,24/05/2021,3,1,209,59,150,49,0,0
821,21/05/2021,3,0,79,70,9,101,0,0
791,24/05/2021,3,49,79,44,35,49,0,0
842,20/05/2021,3,1,90,60,30,49,0,0
675,18/05/2021,3,1,55,41,14,89,0,0
314,19/05/2021,3,2,67,52,15,74,0,0
240,19/05/2021,3,1,70,23,47,55,0,0
65,23/05/2021,3,1,77,19,58,49,0,0
715,18/05/2021,3,1,87,85,2,95,0,0
612,22/05/2021,3,1,41,41,0,NA,NA,NA
250,22/05/2021,3,0,115,31,84,59,0,0
41,05/05/2021,3,1,83,43,40,64,0,0
843,12/05/2021,3,3,63,44,19,52,0,0
78,19/05/2021,3,0,44,43,1,89,0,0
305,18/05/2021,3,12,47,22,25,52,0,0
494,22/05/2021,3,4,135,57,78,55,0,0
890,22/05/2021,3,0,150,53,97,149,0,0
355,21/05/2021,3,3,96,60,36,55,0,0
477,27/05/2021,3,5,115,38,77,49,0,0
112,18/05/2021,3,0,84,84,0,NA,NA,NA
346,20/05/2021,3,5,115,94,21,67,0,0
876,07/05/2021,3,1,181,47,134,45,0,0
140,21/05/2021,3,1,169,122,47,60,0,0
580,23/05/2021,3,0,98,59,39,49,0,0
36,20/05/2021,3,2,61,32,29,49,0,0
23,23/05/2021,3,0,64,21,43,49,0,0
291,18/05/2021,3,1,60,31,29,49,0,0
891,24/05/2021,3,1,81,71,10,68,0,0
497,25/05/2021,3,4,189,100,89,49,0,0
129,18/05/2021,3,12,188,71,117,49,0,0
22,22/05/2021,3,0,64,63,1,85,0,0
443,21/05/2021,3,7,83,81,2,63,0,0
735,22/05/2021,3,1,28,23,5,67,0,0
518,19/05/2021,3,1,16,16,0,NA,NA,NA
875,25/05/2021,3,0,92,76,16,85,0,0
496,21/05/2021,3,1,59,37,22,55,0,0
113,20/05/2021,3,1,31,22,9,49,0,0
727,09/05/2021,3,1,74,23,51,49,0,0
91,19/05/2021,3,1,79,44,35,60,0,0
278,19/05/2021,3,0,105,21,84,49,0,0
557,23/05/2021,3,0,104,41,63,49,0,0
416,23/05/2021,3,0,34,16,18,49,0,0
720,18/05/2021,3,0,39,33,6,77,0,0
873,21/05/2021,3,3,98,57,41,70,0,0
70,25/05/2021,3,1,38,16,22,92,0,0
456,24/05/2021,3,6,84,43,41,49,0,0
226,22/05/2021,3,0,47,47,0,131,0,0
242,21/05/2021,3,5,133,82,51,67,0,0
371,17/05/2021,3,1,35,31,4,84,0,0
703,23/05/2021,3,1,90,39,51,49,0,0
848,24/05/2021,3,35,103,17,86,35,0,0
376,22/05/2021,3,0,64,40,24,60,0,0
25,23/05/2021,3,1,51,24,27,49,0,0
186,23/05/2021,3,1,57,21,36,49,0,0
500,26/05/2021,3,6,73,31,42,49,0,0
832,27/05/2021,3,3,97,52,45,49,0,0
243,22/05/2021,3,1,126,118,8,82,0,0
198,22/05/2021,3,0,135,97,38,64,0,0
743,19/05/2021,3,1,125,64,61,59,0,0
349,22/05/2021,3,1,89,83,6,74,0,0
206,24/05/2021,3,16,197,130,67,59,0,0
821,22/05/2021,3,0,79,69,10,136,0,0
486,25/05/2021,3,0,124,52,72,49,0,0
289,20/05/2021,3,3,65,15,50,49,0,0
658,19/05/2021,3,1,80,56,24,67,0,0
32,19/05/2021,3,1,104,104,0,NA,NA,NA
63,17/05/2021,3,8,56,28,28,49,0,0
396,23/05/2021,3,1,29,14,15,49,0,0
715,19/05/2021,3,1,87,82,5,95,0,0
612,21/05/2021,3,1,41,41,0,NA,NA,NA
623,22/05/2021,3,0,78,70,8,67,0,0
449,03/05/2021,3,6,89,7,82,66,0,0
288,15/05/2021,3,0,60,43,17,52,0,0
902,18/05/2021,3,2,124,91,33,52,0,0
895,18/05/2021,3,0,69,67,2,79,0,0
179,22/05/2021,3,1,91,44,47,55,0,0
485,24/05/2021,3,0,65,30,35,49,0,0
870,21/05/2021,3,3,43,34,9,67,0,0
504,27/05/2021,3,1,82,28,54,49,0,0
899,19/05/2021,3,3,102,102,0,NA,NA,NA
827,20/05/2021,3,1,69,54,15,67,0,0
876,08/05/2021,3,1,181,24,157,45,0,0
453,19/05/2021,3,3,135,100,35,60,0,0
260,22/05/2021,3,1,119,118,1,112,0,0
405,20/05/2021,3,2,88,43,45,49,0,0
50,24/05/2021,3,2,119,50,69,49,0,0
606,19/05/2021,3,1,45,21,24,49,0,0
814,25/05/2021,3,1,67,61,6,88,0,0
123,25/05/2021,3,0,95,22,73,49,0,0
756,16/05/2021,3,1,105,52,53,49,0,0
730,18/05/2021,3,2,73,37,36,52,0,0
244,20/05/2021,3,0,200,124,76,49,0,0
786,21/05/2021,3,1,61,46,15,91,0,0
782,19/05/2021,3,0,20,20,0,NA,NA,NA
875,24/05/2021,3,1,91,68,23,64,0,0
394,21/05/2021,3,0,68,25,43,55,0,0
373,20/05/2021,3,1,102,74,28,55,0,0
367,10/05/2021,3,0,74,13,61,55,0,0
374,18/05/2021,3,0,56,36,20,64,0,0
710,18/05/2021,3,0,20,16,4,72,0,0
670,23/05/2021,3,0,108,76,32,75,0,0
784,23/05/2021,3,2,47,45,2,80,0,0
720,20/05/2021,3,0,39,33,6,67,0,0
325,20/05/2021,3,0,45,20,25,49,0,0
424,25/05/2021,3,1,27,24,3,95,0,0
561,26/05/2021,3,2,58,45,13,74,0,0
437,20/05/2021,3,2,163,97,66,49,0,0
879,21/05/2021,3,3,161,11,150,39,0,0
1,18/05/2021,3,1,99,75,24,67,0,0
624,24/05/2021,3,1,78,42,36,49,0,0
451,23/05/2021,3,2,81,48,33,100,0,0
295,24/05/2021,3,2,103,28,75,49,0,0
448,23/05/2021,3,1,152,48,104,80,0,0
269,23/05/2021,3,0,80,5,75,49,0,0
783,25/05/2021,3,1,79,69,10,82,0,0
832,25/05/2021,3,1,99,47,52,52,0,0
190,20/05/2021,3,5,75,48,27,52,0,0
332,22/05/2021,3,0,40,36,4,74,0,0
743,17/05/2021,3,1,125,48,77,55,0,0
564,23/05/2021,3,1,73,50,23,49,0,0
143,25/05/2021,3,2,118,78,40,74,0,0
821,23/05/2021,3,0,79,62,17,79,0,0
486,26/05/2021,3,0,124,48,76,49,0,0
30,21/05/2021,3,1,70,47,23,120,0,0
675,19/05/2021,3,1,55,36,19,77,0,0
103,21/05/2021,3,1,160,160,0,NA,NA,NA
26,17/05/2021,3,3,63,14,49,55,0,0
224,22/05/2021,3,1,56,15,41,55,0,0
438,18/05/2021,3,21,75,52,23,80,0,0
691,22/05/2021,3,1,31,30,1,NA,NA,NA
392,23/05/2021,3,0,176,46,130,49,0,0
41,04/05/2021,3,1,83,45,38,64,0,0
82,16/05/2021,3,0,96,28,68,49,0,0
807,19/05/2021,3,1,99,73,26,64,0,0
570,19/05/2021,3,0,149,65,84,49,0,0
343,22/05/2021,3,1,61,35,26,55,0,0
520,24/05/2021,3,0,58,34,24,87,0,0
188,22/05/2021,3,7,114,70,44,55,0,0
378,21/05/2021,3,2,82,55,27,55,0,0
83,19/05/2021,3,7,161,141,20,62,0,0
346,19/05/2021,3,4,116,82,34,55,0,0
876,10/05/2021,3,2,180,50,130,45,0,0
457,24/05/2021,3,3,60,33,27,52,0,0
694,21/05/2021,3,4,105,96,9,57,0,0
468,21/05/2021,3,1,95,53,42,49,0,0
801,24/05/2021,3,7,160,43,117,49,0,0
773,19/05/2021,3,2,72,72,0,NA,NA,NA
337,24/05/2021,3,0,60,32,28,49,0,0
7,26/05/2021,3,3,100,37,63,55,0,0
9,16/05/2021,3,0,27,15,12,49,0,0
682,21/05/2021,3,2,78,65,13,67,0,0
95,22/05/2021,3,2,86,61,25,79,0,0
279,21/05/2021,3,0,57,26,31,55,0,0
518,20/05/2021,3,1,16,16,0,NA,NA,NA
684,23/05/2021,3,3,95,29,66,49,0,0
390,22/05/2021,3,3,133,133,0,NA,NA,NA
430,19/05/2021,3,2,87,51,36,55,0,0
302,08/05/2021,3,0,61,31,30,49,0,0
572,18/05/2021,3,0,61,43,18,67,0,0
615,19/05/2021,3,0,71,50,21,57,0,0
833,24/05/2021,3,0,83,57,26,62,0,0
267,24/05/2021,3,2,81,54,27,52,0,0
315,18/05/2021,3,0,62,60,2,89,0,0
325,21/05/2021,3,0,45,22,23,74,0,0
170,23/05/2021,3,1,104,50,54,49,0,0
794,25/05/2021,3,0,137,47,90,85,0,0
915,20/05/2021,3,5,184,16,168,35,0,0
221,21/05/2021,3,1,61,38,23,66,0,0
823,17/05/2021,3,1,60,47,13,62,0,0
263,22/05/2021,3,0,66,30,36,55,0,0
475,23/05/2021,3,1,98,86,12,74,0,0
376,23/05/2021,3,0,64,51,13,52,0,0
904,23/05/2021,3,4,270,12,258,75,0,0
350,25/05/2021,3,2,58,52,6,85,0,0
79,26/05/2021,3,1,45,30,15,82,0,0
431,25/05/2021,3,3,127,75,52,64,0,0
243,21/05/2021,3,1,126,82,44,72,0,0
287,22/05/2021,3,1,122,43,79,55,0,0
102,20/05/2021,3,0,60,43,17,55,0,0
215,18/05/2021,3,0,46,39,7,59,0,0
294,25/05/2021,3,1,116,68,48,57,0,0
679,23/05/2021,3,0,89,75,14,65,0,0
2,24/05/2021,3,3,56,55,1,89,0,0
842,18/05/2021,3,2,89,49,40,49,0,0
632,25/05/2021,3,1,81,37,44,59,0,0
121,21/05/2021,3,1,109,109,0,NA,NA,NA
513,19/05/2021,3,1,76,44,32,52,0,0
65,22/05/2021,3,1,77,77,0,NA,NA,NA
472,18/05/2021,3,6,228,30,198,66,0,0
861,21/05/2021,3,0,61,61,0,NA,NA,NA
623,24/05/2021,3,0,78,35,43,49,0,0
41,06/05/2021,3,1,83,35,48,55,0,0
359,24/05/2021,3,2,102,66,36,52,0,0
411,20/05/2021,3,0,185,125,60,52,0,0
696,19/05/2021,3,1,88,57,31,57,0,0
414,22/05/2021,3,21,165,161,4,158,0,0
868,24/05/2021,3,0,83,32,51,49,0,0
859,20/05/2021,3,1,84,12,72,49,0,0
586,21/05/2021,3,4,79,63,16,72,0,0
804,20/05/2021,3,3,142,51,91,49,0,0
618,19/05/2021,3,11,140,69,71,49,0,0
595,09/05/2021,3,2,48,11,37,49,0,0
457,21/05/2021,3,3,60,46,14,57,0,0
661,22/05/2021,3,5,167,120,47,117,0,0
283,21/05/2021,3,1,75,42,33,55,0,0
50,25/05/2021,3,2,119,73,46,49,0,0
771,19/05/2021,3,2,28,28,0,NA,NA,NA
716,24/05/2021,3,0,104,70,34,67,0,0
123,26/05/2021,3,5,90,29,61,49,0,0
662,16/05/2021,3,2,105,22,83,49,0,0
546,26/05/2021,3,7,145,37,108,49,0,0
244,22/05/2021,3,2,198,102,96,55,0,0
565,22/05/2021,3,0,62,53,9,125,0,0
72,21/05/2021,3,2,58,49,9,74,0,0
213,24/05/2021,3,3,145,113,32,57,0,0
816,22/05/2021,3,0,82,82,0,NA,NA,NA
650,19/05/2021,3,4,124,58,66,55,0,0
302,10/05/2021,3,0,61,30,31,49,0,0
572,16/05/2021,3,0,61,13,48,49,0,0
700,19/05/2021,3,5,127,69,58,49,0,0
557,25/05/2021,3,0,104,78,26,55,0,0
522,23/05/2021,3,5,57,33,24,63,0,0
315,20/05/2021,3,0,62,53,9,80,0,0
284,20/05/2021,3,1,25,20,5,57,0,0
11,21/05/2021,3,1,83,82,1,83,0,0
524,25/05/2021,3,2,108,78,30,67,0,0
57,21/05/2021,3,3,137,110,27,67,0,0
704,19/05/2021,3,1,31,25,6,71,0,0
823,21/05/2021,3,1,60,60,0,NA,NA,NA
440,27/05/2021,3,0,265,41,224,85,0,0
865,22/05/2021,3,1,84,17,67,49,0,0
665,28/05/2021,3,1,105,103,2,85,0,0
231,25/05/2021,3,0,41,22,19,67,0,0
399,24/05/2021,3,1,60,38,22,82,0,0
79,27/05/2021,3,1,45,28,17,72,0,0
110,27/05/2021,3,1,86,75,11,57,0,0
593,21/05/2021,3,7,74,56,18,77,0,0
287,27/05/2021,3,1,122,58,64,49,0,0
412,21/05/2021,3,9,92,39,53,55,0,0
323,18/05/2021,3,0,31,24,7,94,0,0
626,25/05/2021,3,3,99,61,38,67,0,0
407,27/05/2021,3,1,40,19,21,49,0,0
386,24/05/2021,3,3,82,66,16,57,0,0
842,23/05/2021,3,2,89,38,51,49,0,0
418,23/05/2021,3,0,116,13,103,49,0,0
709,20/05/2021,3,0,83,79,4,83,0,0
513,15/05/2021,3,1,76,23,53,49,0,0
867,23/05/2021,3,1,59,59,0,NA,NA,NA
58,19/05/2021,3,2,65,32,33,55,0,0
227,21/05/2021,3,2,42,25,17,55,0,0
274,27/05/2021,3,2,208,45,163,39,0,0
671,24/05/2021,3,0,65,62,3,111,0,0
261,24/05/2021,3,2,100,66,34,62,0,0
902,23/05/2021,3,1,125,35,90,49,0,0
238,20/05/2021,3,0,66,40,26,55,0,0
343,26/05/2021,3,3,59,56,3,88,0,0
890,28/05/2021,3,1,149,104,45,113,0,0
340,20/05/2021,3,16,118,22,96,49,0,0
69,24/05/2021,3,2,58,48,10,63,0,0
104,24/05/2021,3,1,61,59,2,85,0,0
214,25/05/2021,3,2,84,65,19,63,0,0
874,18/05/2021,3,2,87,6,81,49,0,0
692,13/05/2021,3,0,87,0,87,49,0,0
461,18/05/2021,3,2,120,19,101,66,0,0
377,20/05/2021,3,0,149,147,2,79,0,0
801,14/05/2021,3,7,160,30,130,49,0,0
771,24/05/2021,3,2,28,19,9,79,0,0
301,25/05/2021,3,1,100,36,64,49,0,0
798,18/05/2021,3,1,80,80,0,NA,NA,NA
933,21/05/2021,3,117,30,0,30,35,0,0
730,15/05/2021,3,3,72,6,66,49,0,0
244,23/05/2021,3,2,198,81,117,49,0,0
528,22/05/2021,3,0,119,119,0,NA,NA,NA
464,19/05/2021,3,1,265,38,227,66,0,0
684,24/05/2021,3,3,95,60,35,52,0,0
167,27/05/2021,3,0,84,78,6,83,0,0
430,26/05/2021,3,3,86,62,24,55,0,0
367,18/05/2021,3,0,74,30,44,55,0,0
374,17/05/2021,3,0,56,30,26,49,0,0
700,26/05/2021,3,6,126,64,62,57,0,0
348,18/05/2021,3,7,133,123,10,76,0,0
281,24/05/2021,3,3,80,65,15,63,0,0
548,30/05/2021,3,1,90,87,3,63,0,0
234,18/05/2021,3,4,58,29,29,49,0,0
424,18/05/2021,3,1,27,25,2,55,0,0
547,29/05/2021,3,0,74,74,0,NA,NA,NA
368,23/05/2021,3,1,84,29,55,49,0,0
704,20/05/2021,3,1,31,29,2,123,0,0
391,22/05/2021,3,1,75,75,0,NA,NA,NA
487,27/05/2021,3,0,39,15,24,52,0,0
183,28/05/2021,3,0,80,48,32,59,0,0
376,30/05/2021,3,2,62,57,5,62,0,0
555,25/05/2021,3,0,117,92,25,82,0,0
597,25/05/2021,3,5,96,58,38,52,0,0
783,22/05/2021,3,1,79,79,0,NA,NA,NA
598,28/05/2021,3,0,146,136,10,109,0,0
151,22/05/2021,3,6,70,65,5,74,0,0
42,28/05/2021,3,0,99,99,0,NA,NA,NA
341,29/05/2021,3,38,76,75,1,134,0,0
323,19/05/2021,3,0,31,26,5,85,0,0
206,25/05/2021,3,16,197,126,71,59,0,0
357,28/05/2021,3,1,82,73,9,67,0,0
791,25/05/2021,3,49,79,62,17,57,0,0
185,25/05/2021,3,2,166,75,91,49,0,0
60,24/05/2021,3,0,57,39,18,72,0,0
505,21/05/2021,3,0,84,45,39,55,0,0
576,15/05/2021,3,2,56,9,47,49,0,0
869,24/05/2021,3,9,51,52,-1,NA,NA,NA
579,18/05/2021,3,0,44,44,0,NA,NA,NA
310,21/05/2021,3,1,71,52,19,60,0,0
623,27/05/2021,3,0,78,34,44,49,0,0
602,25/05/2021,3,0,64,37,27,67,0,0
843,25/05/2021,3,2,64,52,12,55,0,0
210,21/05/2021,3,2,100,85,15,77,0,0
28,19/05/2021,3,1,127,86,41,72,0,0
358,26/05/2021,3,1,92,71,21,67,0,0
19,29/05/2021,3,1,93,79,14,102,0,0
501,20/05/2021,3,26,207,65,142,49,0,0
175,25/05/2021,3,13,107,53,54,49,0,0
688,24/05/2021,3,2,117,99,18,57,0,0
225,25/05/2021,3,11,69,48,21,85,0,0
577,14/05/2021,3,0,78,3,75,49,0,0
457,13/05/2021,3,2,61,22,39,49,0,0
580,19/05/2021,3,0,98,90,8,79,0,0
377,26/05/2021,3,0,149,112,37,82,0,0
50,15/05/2021,3,2,119,30,89,49,0,0
81,22/05/2021,3,1,59,32,27,55,0,0
55,25/05/2021,3,1,32,22,10,67,0,0
125,17/05/2021,3,2,34,34,0,NA,NA,NA
933,22/05/2021,3,97,50,0,50,35,0,0
268,13/05/2021,3,1,77,55,22,72,0,0
37,25/05/2021,3,2,79,54,25,49,0,0
628,21/05/2021,3,2,57,48,9,81,0,0
760,21/05/2021,3,1,35,24,11,60,0,0
163,21/05/2021,3,1,61,61,0,NA,NA,NA
394,27/05/2021,3,0,68,36,32,49,0,0
137,26/05/2021,3,24,122,36,86,49,0,0
367,16/05/2021,3,0,74,4,70,49,0,0
435,17/05/2021,3,81,39,38,1,49,0,0
71,27/05/2021,3,1,61,53,8,57,0,0
898,18/05/2021,3,1,99,89,10,62,0,0
401,24/05/2021,3,0,79,51,28,60,0,0
297,30/05/2021,3,1,75,41,34,49,0,0
49,19/05/2021,3,9,139,29,110,49,0,0
424,20/05/2021,3,1,27,22,5,74,0,0
168,30/05/2021,3,0,48,48,0,NA,NA,NA
152,23/05/2021,3,1,90,25,65,49,0,0
47,18/05/2021,3,2,55,45,10,85,0,0
265,21/05/2021,3,1,56,26,30,67,0,0
511,27/05/2021,3,0,76,45,31,49,0,0
228,29/05/2021,3,2,40,31,9,60,0,0
35,28/05/2021,3,17,93,55,38,55,0,0
591,25/05/2021,3,0,68,50,18,80,0,0
56,24/05/2021,3,1,64,40,24,80,0,0
637,22/05/2021,3,0,74,74,0,NA,NA,NA
728,28/05/2021,3,0,47,39,8,67,0,0
131,23/05/2021,3,3,46,15,31,49,0,0
153,28/05/2021,3,4,60,60,0,NA,NA,NA
743,29/05/2021,3,2,124,103,21,74,0,0
544,19/05/2021,3,0,53,20,33,49,0,0
76,27/05/2021,3,1,92,78,14,74,0,0
407,28/05/2021,3,1,40,26,14,60,0,0
327,26/05/2021,3,18,50,44,6,85,0,0
604,27/05/2021,3,4,78,44,34,49,0,0
418,24/05/2021,3,0,116,56,60,49,0,0
121,20/05/2021,3,1,109,104,5,123,0,0
678,20/05/2021,3,0,44,0,44,NA,NA,NA
347,24/05/2021,3,11,51,41,10,83,0,0
322,17/05/2021,3,0,100,17,83,49,0,0
52,22/05/2021,3,27,115,115,0,NA,NA,NA
108,27/05/2021,3,0,78,38,40,49,0,0
602,26/05/2021,3,0,64,42,22,74,0,0
261,27/05/2021,3,2,100,93,7,65,0,0
411,24/05/2021,3,1,184,82,102,55,0,0
305,20/05/2021,3,12,47,39,8,57,0,0
179,27/05/2021,3,1,91,42,49,55,0,0
99,28/05/2021,3,1,166,165,1,85,0,0
601,20/05/2021,3,3,65,35,30,49,0,0
537,24/05/2021,3,3,99,72,27,89,0,0
83,24/05/2021,3,8,160,126,34,86,0,0
214,26/05/2021,3,2,84,57,27,57,0,0
719,14/05/2021,3,0,41,2,39,49,0,0
453,15/05/2021,3,1,137,30,107,55,0,0
421,17/05/2021,3,0,19,19,0,NA,NA,NA
273,27/05/2021,3,0,103,101,2,129,0,0
23,12/05/2021,3,2,62,33,29,49,0,0
331,23/05/2021,3,28,66,48,18,70,0,0
550,28/05/2021,3,1,111,107,4,83,0,0
585,17/05/2021,3,2,58,58,0,NA,NA,NA
933,23/05/2021,3,96,51,0,51,35,0,0
303,14/05/2021,3,1,64,43,21,52,0,0
443,25/05/2021,3,5,85,42,43,59,0,0
178,27/05/2021,3,0,38,22,16,59,0,0
813,20/05/2021,3,1,129,76,53,49,0,0
836,21/05/2021,3,0,101,98,3,101,0,0
527,26/05/2021,3,5,56,46,10,85,0,0
839,26/05/2021,3,3,152,114,38,67,0,0
693,18/05/2021,3,0,125,36,89,49,0,0
749,17/05/2021,3,4,150,25,125,49,0,0
100,27/05/2021,3,77,147,144,3,65,0,0
48,19/05/2021,3,1,178,11,167,49,0,0
522,24/05/2021,3,5,57,45,12,63,0,0
747,30/05/2021,3,1,63,59,4,62,0,0
118,19/05/2021,3,3,56,11,45,49,0,0
424,17/05/2021,3,1,27,27,0,NA,NA,NA
567,29/05/2021,3,0,61,61,0,NA,NA,NA
152,24/05/2021,3,1,90,35,55,49,0,0
47,19/05/2021,3,2,55,54,1,131,0,0
111,19/05/2021,3,1,59,47,12,80,0,0
440,28/05/2021,3,0,265,90,175,90,0,0
932,29/05/2021,3,24,83,19,64,45,0,0
554,28/05/2021,3,0,42,32,10,60,0,0
353,24/05/2021,3,1,51,40,11,80,0,0
162,24/05/2021,3,1,121,87,34,80,0,0
293,22/05/2021,3,3,57,30,27,55,0,0
728,29/05/2021,3,0,47,46,1,84,0,0
151,23/05/2021,3,6,70,41,29,49,0,0
332,21/05/2021,3,0,40,26,14,60,0,0
199,28/05/2021,3,3,79,53,26,55,0,0
323,20/05/2021,3,0,31,22,9,72,0,0
857,26/05/2021,3,2,208,67,141,49,0,0
38,27/05/2021,3,2,48,43,5,67,0,0
203,27/05/2021,3,1,39,20,19,52,0,0
842,27/05/2021,3,2,89,42,47,78,0,0
60,23/05/2021,3,0,57,25,32,49,0,0
389,20/05/2021,3,2,124,100,24,52,0,0
678,22/05/2021,3,0,44,0,44,NA,NA,NA
419,25/05/2021,3,4,106,48,58,90,0,0
438,17/05/2021,3,19,77,39,38,89,0,0
452,22/05/2021,3,4,56,56,0,NA,NA,NA
250,28/05/2021,3,0,115,66,49,72,0,0
722,24/05/2021,3,0,42,38,4,94,0,0
261,23/05/2021,3,2,100,51,49,52,0,0
304,24/05/2021,3,2,58,35,23,64,0,0
570,18/05/2021,3,0,149,71,78,49,0,0
414,27/05/2021,3,20,166,93,73,59,0,0
99,27/05/2021,3,1,166,161,5,62,0,0
29,25/05/2021,3,0,54,0,54,NA,NA,NA
702,24/05/2021,3,1,49,48,1,77,0,0
479,25/05/2021,3,2,53,35,18,60,0,0
21,26/05/2021,3,1,59,36,23,62,0,0
874,16/05/2021,3,2,87,1,86,49,0,0
457,15/05/2021,3,1,62,14,48,49,0,0
421,18/05/2021,3,0,19,19,0,NA,NA,NA
503,28/05/2021,3,0,184,113,71,55,0,0
847,12/05/2021,3,4,193,37,156,35,0,0
552,23/05/2021,3,10,174,72,102,49,0,0
856,28/05/2021,3,0,120,119,1,85,0,0
125,18/05/2021,3,2,34,34,0,NA,NA,NA
9,21/05/2021,3,0,27,23,4,78,0,0
546,14/05/2021,3,11,141,6,135,49,0,0
161,26/05/2021,3,1,60,39,21,91,0,0
478,18/05/2021,3,0,20,16,4,85,0,0
622,19/05/2021,3,1,43,39,4,79,0,0
266,21/05/2021,3,0,61,60,1,119,0,0
142,15/05/2021,3,1,61,9,52,49,0,0
551,25/05/2021,3,0,115,78,37,57,0,0
367,02/05/2021,3,2,72,2,70,49,0,0
625,18/05/2021,3,0,161,77,84,49,0,0
278,27/05/2021,3,0,105,24,81,49,0,0
249,21/05/2021,3,1,126,96,30,80,0,0
882,23/05/2021,3,0,130,41,89,39,0,0
315,30/05/2021,3,0,62,51,11,67,0,0
734,19/05/2021,3,2,59,59,0,NA,NA,NA
780,18/05/2021,3,1,59,51,8,62,0,0
721,29/05/2021,3,2,138,138,0,NA,NA,NA
437,25/05/2021,3,3,162,91,71,49,0,0
236,19/05/2021,3,2,117,15,102,49,0,0
391,21/05/2021,3,1,75,50,25,67,0,0
703,28/05/2021,3,0,91,76,15,67,0,0
755,27/05/2021,3,0,87,70,17,98,0,0
919,28/05/2021,3,9,114,93,21,74,0,0
25,25/05/2021,3,1,51,41,10,87,0,0
186,24/05/2021,3,1,57,40,17,57,0,0
824,23/05/2021,3,0,339,25,314,65,0,0
362,28/05/2021,3,2,118,90,28,107,0,0
243,23/05/2021,3,1,126,53,73,49,0,0
589,20/05/2021,3,6,137,139,-2,NA,NA,NA
510,28/05/2021,3,2,141,72,69,55,0,0
633,18/05/2021,3,1,49,34,15,67,0,0
805,27/05/2021,3,0,113,71,42,49,0,0
679,26/05/2021,3,0,89,51,38,80,0,0
791,28/05/2021,3,27,101,85,16,62,0,0
30,24/05/2021,3,1,70,69,1,105,0,0
918,23/05/2021,3,0,201,16,185,39,0,0
103,20/05/2021,3,1,160,152,8,74,0,0
678,23/05/2021,3,0,44,0,44,NA,NA,NA
347,25/05/2021,3,22,40,32,8,133,0,0
308,20/05/2021,3,2,46,26,20,52,0,0
772,21/05/2021,3,0,57,57,0,NA,NA,NA
480,28/05/2021,3,0,28,27,1,77,0,0
793,23/05/2021,3,2,129,27,102,49,0,0
261,25/05/2021,3,2,100,82,18,65,0,0
807,21/05/2021,3,2,98,62,36,55,0,0
276,20/05/2021,3,1,203,76,127,49,0,0
179,28/05/2021,3,1,91,35,56,55,0,0
19,27/05/2021,3,1,93,49,44,57,0,0
29,24/05/2021,3,0,54,0,54,NA,NA,NA
93,24/05/2021,3,3,138,60,78,49,0,0
688,25/05/2021,3,2,117,91,26,62,0,0
363,24/05/2021,3,2,97,68,29,80,0,0
577,16/05/2021,3,0,78,3,75,49,0,0
457,16/05/2021,3,1,62,17,45,49,0,0
421,19/05/2021,3,0,19,18,1,NA,NA,NA
13,27/05/2021,3,0,81,55,26,63,0,0
573,12/05/2021,3,1,56,13,43,55,0,0
388,24/05/2021,3,1,59,38,21,62,0,0
698,29/05/2021,3,3,113,112,1,110,0,0
157,16/05/2021,3,2,81,15,66,49,0,0
115,21/05/2021,3,0,115,55,60,55,0,0
730,14/05/2021,3,2,73,4,69,49,0,0
59,13/05/2021,3,0,75,4,71,49,0,0
478,20/05/2021,3,0,20,20,0,NA,NA,NA
754,21/05/2021,3,0,62,27,35,55,0,0
321,21/05/2021,3,1,39,26,13,60,0,0
12,15/05/2021,3,1,42,6,36,49,0,0
758,25/05/2021,3,1,72,51,21,77,0,0
727,03/05/2021,3,1,74,15,59,55,0,0
246,19/05/2021,3,1,111,38,73,49,0,0
745,27/05/2021,3,1,104,85,19,60,0,0
670,21/05/2021,3,4,104,89,15,123,0,0
491,24/05/2021,3,6,173,38,135,49,0,0
726,30/05/2021,3,0,39,34,5,57,0,0
787,19/05/2021,3,3,105,105,0,NA,NA,NA
780,20/05/2021,3,1,59,38,21,52,0,0
561,29/05/2021,3,2,58,59,-1,NA,NA,NA
915,23/05/2021,3,5,184,6,178,35,0,0
879,18/05/2021,3,3,161,14,147,39,0,0
111,21/05/2021,3,0,60,50,10,82,0,0
841,28/05/2021,3,0,182,43,139,49,0,0
848,27/05/2021,3,7,131,28,103,35,0,0
639,30/05/2021,3,1,58,29,29,57,0,0
353,25/05/2021,3,1,51,48,3,59,0,0
683,24/05/2021,3,1,65,45,20,52,0,0
907,22/05/2021,3,3,77,77,0,NA,NA,NA
838,28/05/2021,3,4,61,56,5,88,0,0
526,23/05/2021,3,1,37,16,21,49,0,0
42,21/05/2021,3,1,98,77,21,67,0,0
582,28/05/2021,3,0,53,52,1,142,0,0
564,19/05/2021,3,1,73,63,10,62,0,0
34,26/05/2021,3,2,86,56,30,80,0,0
476,27/05/2021,3,0,173,53,120,49,0,0
490,28/05/2021,3,5,160,52,108,49,0,0
185,26/05/2021,3,1,167,64,103,49,0,0
918,24/05/2021,3,0,201,20,181,39,0,0
32,21/05/2021,3,1,104,72,32,69,0,0
678,21/05/2021,3,0,44,0,44,NA,NA,NA
20,25/05/2021,3,1,81,60,21,92,0,0
509,18/05/2021,3,1,111,59,52,49,0,0
481,22/05/2021,3,0,56,56,0,NA,NA,NA
108,29/05/2021,3,0,78,74,4,77,0,0
793,25/05/2021,3,2,129,26,103,86,0,0
359,25/05/2021,3,2,102,71,31,80,0,0
807,22/05/2021,3,2,98,71,27,72,0,0
777,20/05/2021,3,2,118,84,34,49,0,0
494,28/05/2021,3,5,134,66,68,55,0,0
101,27/05/2021,3,1,59,47,12,64,0,0
29,23/05/2021,3,0,54,0,54,NA,NA,NA
477,24/05/2021,3,3,117,30,87,49,0,0
804,24/05/2021,3,3,142,43,99,49,0,0
483,25/05/2021,3,3,96,44,52,49,0,0
719,16/05/2021,3,0,41,5,36,49,0,0
457,18/05/2021,3,1,62,44,18,57,0,0
24,20/05/2021,3,1,83,68,15,57,0,0
283,27/05/2021,3,0,76,27,49,55,0,0
573,17/05/2021,3,0,57,44,13,62,0,0
351,22/05/2021,3,3,63,53,10,121,0,0
814,28/05/2021,3,1,67,62,5,81,0,0
105,18/05/2021,3,3,72,60,12,85,0,0
616,20/05/2021,3,3,72,61,11,65,0,0
800,14/05/2021,3,2,55,5,50,49,0,0
59,15/05/2021,3,0,75,15,60,49,0,0
788,18/05/2021,3,2,89,84,5,63,0,0
204,20/05/2021,3,0,64,14,50,49,0,0
128,21/05/2021,3,1,20,10,10,55,0,0
394,15/05/2021,3,3,65,13,52,49,0,0
758,27/05/2021,3,7,66,48,18,74,0,0
536,03/05/2021,3,2,79,12,67,55,0,0
435,16/05/2021,3,81,39,14,25,49,0,0
71,26/05/2021,3,0,62,38,24,52,0,0
397,20/05/2021,3,0,75,51,24,60,0,0
790,24/05/2021,3,1,98,39,59,90,0,0
871,30/05/2021,3,2,76,76,0,NA,NA,NA
539,18/05/2021,3,2,95,63,32,57,0,0
70,18/05/2021,3,1,38,37,1,115,0,0
736,29/05/2021,3,3,102,103,-1,NA,NA,NA
211,24/05/2021,3,3,57,54,3,74,0,0
879,19/05/2021,3,3,161,13,148,39,0,0
111,23/05/2021,3,0,60,37,23,74,0,0
841,29/05/2021,3,0,182,49,133,49,0,0
193,28/05/2021,3,1,107,47,60,55,0,0
372,28/05/2021,3,18,74,71,3,153,0,0
904,24/05/2021,3,4,270,8,262,90,0,0
162,25/05/2021,3,1,121,80,41,91,0,0
43,23/05/2021,3,2,71,29,42,49,0,0
110,29/05/2021,3,1,86,82,4,89,0,0
243,25/05/2021,3,1,126,64,62,60,0,0
287,21/05/2021,3,1,122,32,90,55,0,0
582,27/05/2021,3,1,52,48,4,129,0,0
323,17/05/2021,3,0,31,30,1,115,0,0
180,26/05/2021,3,1,40,29,11,57,0,0
821,28/05/2021,3,0,79,62,17,99,0,0
53,27/05/2021,3,0,70,61,9,99,0,0
289,24/05/2021,3,2,66,41,25,52,0,0
632,23/05/2021,3,0,82,11,71,49,0,0
837,20/05/2021,3,4,322,53,269,66,0,0
810,20/05/2021,3,0,389,38,351,55,0,0
65,25/05/2021,3,1,77,41,36,49,0,0
403,18/05/2021,3,2,96,45,51,55,0,0
222,20/05/2021,3,0,77,46,31,49,0,0
429,28/05/2021,3,3,122,29,93,55,0,0
602,22/05/2021,3,0,64,38,26,119,0,0
261,26/05/2021,3,2,100,64,36,62,0,0
902,24/05/2021,3,2,124,89,35,52,0,0
570,20/05/2021,3,0,149,79,70,49,0,0
445,26/05/2021,3,2,167,62,105,49,0,0
723,27/05/2021,3,1,80,44,36,57,0,0
549,23/05/2021,3,0,61,0,61,NA,NA,NA
795,24/05/2021,3,6,99,66,33,55,0,0
272,23/05/2021,3,2,125,34,91,49,0,0
664,25/05/2021,3,10,145,73,72,60,0,0
874,14/05/2021,3,2,87,3,84,49,0,0
692,16/05/2021,3,0,87,0,87,49,0,0
260,19/05/2021,3,1,119,93,26,57,0,0
273,26/05/2021,3,0,103,91,12,136,0,0
573,14/05/2021,3,0,57,10,47,49,0,0
552,22/05/2021,3,12,172,166,6,116,0,0
913,28/05/2021,3,2,103,91,12,111,0,0
166,18/05/2021,3,4,62,60,2,77,0,0
344,21/05/2021,3,1,64,60,4,106,0,0
761,15/05/2021,3,0,83,13,70,49,0,0
244,14/05/2021,3,1,199,49,150,49,0,0
178,18/05/2021,3,1,37,35,2,80,0,0
422,20/05/2021,3,1,78,23,55,49,0,0
128,22/05/2021,3,1,20,18,2,84,0,0
739,15/05/2021,3,3,72,8,64,49,0,0
113,25/05/2021,3,1,31,19,12,52,0,0
367,05/05/2021,3,1,73,19,54,55,0,0
737,16/05/2021,3,2,40,9,31,49,0,0
753,26/05/2021,3,7,120,89,31,63,0,0
768,19/05/2021,3,1,86,68,18,57,0,0
784,24/05/2021,3,2,47,36,11,71,0,0
720,30/05/2021,3,0,39,39,0,NA,NA,NA
734,18/05/2021,3,2,59,58,1,95,0,0
424,19/05/2021,3,1,27,18,9,77,0,0
770,29/05/2021,3,2,33,34,-1,NA,NA,NA
226,24/05/2021,3,0,47,45,2,135,0,0
704,18/05/2021,3,1,31,23,8,71,0,0
371,23/05/2021,3,0,36,19,17,56,0,0
841,27/05/2021,3,0,182,39,143,55,0,0
193,29/05/2021,3,1,107,96,11,67,0,0
295,29/05/2021,3,0,105,55,50,55,0,0
145,25/05/2021,3,3,55,24,31,73,0,0
683,25/05/2021,3,1,65,49,16,62,0,0
712,23/05/2021,3,7,78,24,54,49,0,0
439,28/05/2021,3,2,89,53,36,49,0,0
190,25/05/2021,3,4,76,48,28,62,0,0
153,19/05/2021,3,1,63,32,31,67,0,0
341,27/05/2021,3,42,72,66,6,127,0,0
564,20/05/2021,3,1,73,49,24,52,0,0
206,26/05/2021,3,16,197,149,48,64,0,0
290,26/05/2021,3,2,105,56,49,55,0,0
732,27/05/2021,3,0,60,38,22,49,0,0
850,24/05/2021,3,1,82,59,23,72,0,0
418,25/05/2021,3,0,116,53,63,49,0,0
176,21/05/2021,3,1,99,42,57,55,0,0
240,23/05/2021,3,1,70,24,46,49,0,0
629,25/05/2021,3,1,61,54,7,63,0,0
472,19/05/2021,3,6,228,43,185,66,0,0
227,20/05/2021,3,2,42,25,17,49,0,0
366,29/05/2021,3,3,77,76,1,150,0,0
602,23/05/2021,3,0,64,38,26,64,0,0
328,27/05/2021,3,2,96,53,43,72,0,0
212,21/05/2021,3,1,77,66,11,90,0,0
777,19/05/2021,3,3,117,96,21,74,0,0
653,26/05/2021,3,3,112,37,75,49,0,0
88,27/05/2021,3,1,41,25,16,55,0,0
549,24/05/2021,3,0,61,0,61,NA,NA,NA
858,24/05/2021,3,0,81,81,0,NA,NA,NA
688,23/05/2021,3,2,117,67,50,49,0,0
225,26/05/2021,3,13,67,40,27,77,0,0
595,18/05/2021,3,2,48,17,31,57,0,0
663,16/05/2021,3,0,148,12,136,49,0,0
260,20/05/2021,3,1,119,107,12,62,0,0
599,30/05/2021,3,0,153,153,0,89,0,0
573,16/05/2021,3,0,57,21,36,49,0,0
771,22/05/2021,3,2,28,27,1,79,0,0
724,28/05/2021,3,1,85,80,5,131,0,0
125,16/05/2021,3,3,33,6,27,49,0,0
542,21/05/2021,3,4,71,58,13,67,0,0
800,15/05/2021,3,2,55,7,48,49,0,0
95,14/05/2021,3,1,87,19,68,49,0,0
54,18/05/2021,3,3,58,54,4,123,0,0
760,19/05/2021,3,1,35,23,12,57,0,0
51,21/05/2021,3,2,78,71,7,84,0,0
527,15/05/2021,3,10,51,7,44,49,0,0
538,25/05/2021,3,1,43,29,14,62,0,0
536,04/05/2021,3,2,79,37,42,60,0,0
737,17/05/2021,3,2,40,22,18,49,0,0
89,27/05/2021,3,2,58,27,31,49,0,0
249,20/05/2021,3,1,126,98,28,52,0,0
666,24/05/2021,3,2,64,44,20,52,0,0
649,30/05/2021,3,2,62,63,-1,NA,NA,NA
364,19/05/2021,3,2,128,111,17,80,0,0
829,19/05/2021,3,0,150,31,119,49,0,0
721,30/05/2021,3,2,138,138,0,NA,NA,NA
657,23/05/2021,3,0,48,36,12,79,0,0
221,18/05/2021,3,1,61,45,16,55,0,0
371,21/05/2021,3,0,36,19,17,75,0,0
216,27/05/2021,3,1,57,43,14,52,0,0
475,27/05/2021,3,1,98,86,12,63,0,0
627,28/05/2021,3,0,41,35,6,62,0,0
200,25/05/2021,3,6,113,107,6,77,0,0
825,23/05/2021,3,4,142,41,101,49,0,0
500,22/05/2021,3,5,74,48,26,89,0,0
832,29/05/2021,3,3,97,81,16,77,0,0
593,25/05/2021,3,25,56,47,9,147,0,0
776,21/05/2021,3,0,104,37,67,55,0,0
412,28/05/2021,3,11,90,64,26,55,0,0
219,17/05/2021,3,4,73,27,46,49,0,0
294,26/05/2021,3,1,116,74,42,57,0,0
107,26/05/2021,3,1,88,57,31,82,0,0
486,28/05/2021,3,0,124,94,30,67,0,0
30,26/05/2021,3,1,70,65,5,119,0,0
752,15/05/2021,3,37,7,4,3,52,0,0
176,19/05/2021,3,2,98,29,69,49,0,0
576,21/05/2021,3,1,57,37,20,60,0,0
224,25/05/2021,3,1,56,23,33,49,0,0
509,19/05/2021,3,1,111,37,74,49,0,0
127,22/05/2021,3,1,59,53,6,67,0,0
854,29/05/2021,3,5,105,77,28,140,0,0
671,13/05/2021,3,1,64,61,3,95,0,0
843,27/05/2021,3,2,64,45,19,57,0,0
902,21/05/2021,3,1,125,73,52,55,0,0
187,19/05/2021,3,1,40,16,24,49,0,0
201,27/05/2021,3,6,132,91,41,49,0,0
334,27/05/2021,3,1,57,31,26,52,0,0
549,25/05/2021,3,0,61,0,61,NA,NA,NA
537,19/05/2021,3,3,99,99,0,NA,NA,NA
804,25/05/2021,3,3,142,36,106,49,0,0
363,26/05/2021,3,2,97,74,23,59,0,0
595,19/05/2021,3,2,48,12,36,52,0,0
692,14/05/2021,3,0,87,1,86,49,0,0
651,20/05/2021,3,1,77,43,34,49,0,0
503,26/05/2021,3,0,184,59,125,49,0,0
23,15/05/2021,3,3,61,24,37,49,0,0
116,24/05/2021,3,0,61,60,1,93,0,0
301,29/05/2021,3,1,100,53,47,60,0,0
646,18/05/2021,3,16,120,94,26,57,0,0
662,21/05/2021,3,2,105,78,27,93,0,0
268,16/05/2021,3,1,77,27,50,49,0,0
195,14/05/2021,3,1,50,8,42,49,0,0
54,19/05/2021,3,3,58,57,1,119,0,0
202,20/05/2021,3,0,76,76,0,NA,NA,NA
51,22/05/2021,3,2,78,78,0,NA,NA,NA
529,15/05/2021,3,3,38,9,29,49,0,0
575,25/05/2021,3,1,49,41,8,59,0,0
536,05/05/2021,3,2,79,38,41,60,0,0
435,18/05/2021,3,81,39,36,3,49,0,0
615,26/05/2021,3,0,71,65,6,65,0,0
898,20/05/2021,3,1,99,85,14,57,0,0
450,23/05/2021,3,3,181,80,101,49,0,0
169,30/05/2021,3,1,19,19,0,NA,NA,NA
284,18/05/2021,3,1,25,22,3,79,0,0
638,19/05/2021,3,0,101,66,35,72,0,0
149,29/05/2021,3,0,88,88,0,NA,NA,NA
669,24/05/2021,3,0,87,56,31,52,0,0
47,17/05/2021,3,2,55,40,15,64,0,0
391,19/05/2021,3,0,76,74,2,65,0,0
583,27/05/2021,3,1,80,59,21,57,0,0
594,27/05/2021,3,1,106,79,27,80,0,0
35,29/05/2021,3,17,93,88,5,77,0,0
448,25/05/2021,3,2,151,60,91,100,0,0
247,23/05/2021,3,2,91,46,45,49,0,0
907,23/05/2021,3,3,77,40,37,64,0,0
484,22/05/2021,3,0,40,40,0,NA,NA,NA
184,25/05/2021,3,0,51,35,16,85,0,0
571,19/05/2021,3,0,161,23,138,49,0,0
39,27/05/2021,3,1,60,43,17,60,0,0
219,18/05/2021,3,5,72,33,39,49,0,0
805,26/05/2021,3,0,113,82,31,67,0,0
530,27/05/2021,3,1,59,41,18,63,0,0
830,27/05/2021,3,0,66,53,13,136,0,0
850,27/05/2021,3,3,80,59,21,72,0,0
752,16/05/2021,3,24,20,6,14,49,0,0
855,19/05/2021,3,1,175,104,71,49,0,0
146,22/05/2021,3,1,40,35,5,143,0,0
254,25/05/2021,3,1,77,39,38,80,0,0
764,19/05/2021,3,2,67,34,33,55,0,0
310,20/05/2021,3,1,71,62,9,67,0,0
108,28/05/2021,3,0,78,56,22,60,0,0
671,15/05/2021,3,1,64,64,0,NA,NA,NA
82,24/05/2021,3,0,96,79,17,85,0,0
902,22/05/2021,3,1,125,83,42,55,0,0
785,18/05/2021,3,1,109,83,26,52,0,0
445,27/05/2021,3,2,167,72,95,49,0,0
520,27/05/2021,3,1,57,37,20,87,0,0
499,23/05/2021,3,0,31,12,19,49,0,0
883,18/05/2021,3,6,98,13,85,45,0,0
112,23/05/2021,3,0,84,42,42,49,0,0
483,26/05/2021,3,3,96,47,49,49,0,0
595,14/05/2021,3,2,48,9,39,49,0,0
692,15/05/2021,3,0,87,2,85,49,0,0
461,17/05/2021,3,2,120,17,103,66,0,0
377,28/05/2021,3,0,149,145,4,79,0,0
819,17/05/2021,3,0,80,80,0,NA,NA,NA
331,24/05/2021,3,28,66,38,28,94,0,0
716,29/05/2021,3,1,103,93,10,74,0,0
157,18/05/2021,3,2,81,78,3,82,0,0
344,23/05/2021,3,1,64,49,15,77,0,0
800,16/05/2021,3,2,55,3,52,49,0,0
309,14/05/2021,3,1,15,8,7,49,0,0
279,18/05/2021,3,0,57,46,11,84,0,0
72,19/05/2021,3,2,58,37,21,60,0,0
213,22/05/2021,3,4,144,144,0,NA,NA,NA
167,16/05/2021,3,1,83,15,68,49,0,0
113,26/05/2021,3,1,31,20,11,57,0,0
302,02/05/2021,3,0,61,38,23,49,0,0
749,19/05/2021,3,4,150,23,127,49,0,0
71,25/05/2021,3,0,62,28,34,49,0,0
540,18/05/2021,3,2,80,51,29,57,0,0
66,24/05/2021,3,0,152,34,118,49,0,0
169,14/05/2021,3,0,20,6,14,49,0,0
230,18/05/2021,3,0,80,30,50,52,0,0
866,19/05/2021,3,0,100,41,59,55,0,0
168,29/05/2021,3,0,48,48,0,NA,NA,NA
806,25/05/2021,3,2,134,117,17,74,0,0
488,18/05/2021,3,3,63,54,9,85,0,0
391,23/05/2021,3,0,76,42,34,49,0,0
624,27/05/2021,3,1,78,42,36,49,0,0
865,27/05/2021,3,1,84,62,22,56,0,0
295,30/05/2021,3,0,105,33,72,49,0,0
904,25/05/2021,3,4,270,5,265,95,0,0
436,23/05/2021,3,2,204,51,153,49,0,0
333,22/05/2021,3,1,56,38,18,142,0,0
574,22/05/2021,3,11,76,76,0,NA,NA,NA
526,25/05/2021,3,0,38,34,4,90,0,0
589,21/05/2021,3,2,141,137,4,83,0,0
102,27/05/2021,3,0,60,54,6,80,0,0
219,19/05/2021,3,5,72,35,37,49,0,0
294,27/05/2021,3,1,116,86,30,62,0,0
476,28/05/2021,3,0,173,24,149,55,0,0
53,28/05/2021,3,0,70,64,6,117,0,0
604,24/05/2021,3,0,82,49,33,62,0,0
918,15/05/2021,3,0,201,17,184,39,0,0
505,20/05/2021,3,0,84,45,39,49,0,0
146,23/05/2021,3,1,40,29,11,67,0,0
396,25/05/2021,3,1,29,16,13,52,0,0
472,20/05/2021,3,6,228,44,184,66,0,0
426,20/05/2021,3,9,154,98,56,55,0,0
623,28/05/2021,3,0,78,57,21,60,0,0
671,12/05/2021,3,1,64,61,3,90,0,0
288,24/05/2021,3,0,60,45,15,67,0,0
212,24/05/2021,3,1,77,60,17,64,0,0
785,19/05/2021,3,1,109,91,18,57,0,0
343,27/05/2021,3,3,59,45,14,57,0,0
738,27/05/2021,3,1,123,104,19,67,0,0
340,23/05/2021,3,16,118,7,111,49,0,0
492,18/05/2021,3,3,34,24,10,62,0,0
402,25/05/2021,3,0,155,121,34,57,0,0
827,26/05/2021,3,1,69,47,22,82,0,0
719,18/05/2021,3,0,41,28,13,59,0,0
692,18/05/2021,3,0,87,26,61,49,0,0
661,17/05/2021,3,2,170,21,149,49,0,0
273,15/05/2021,3,0,103,103,0,NA,NA,NA
379,12/05/2021,3,3,284,92,192,66,0,0
552,24/05/2021,3,11,173,83,90,49,0,0
844,28/05/2021,3,0,61,14,47,80,0,0
298,16/05/2021,3,2,227,89,138,49,0,0
344,24/05/2021,3,1,64,36,28,57,0,0
761,16/05/2021,3,0,83,10,73,49,0,0
195,15/05/2021,3,2,49,6,43,49,0,0
318,19/05/2021,3,0,59,50,9,90,0,0
139,20/05/2021,3,2,57,36,21,52,0,0
138,22/05/2021,3,0,98,98,0,NA,NA,NA
739,16/05/2021,3,3,72,7,65,49,0,0
538,26/05/2021,3,1,43,39,4,65,0,0
302,04/05/2021,3,0,61,31,30,49,0,0
205,18/05/2021,3,0,126,69,57,49,0,0
89,24/05/2021,3,2,58,46,12,57,0,0
48,20/05/2021,3,2,177,15,162,49,0,0
182,24/05/2021,3,2,78,34,44,49,0,0
726,15/05/2021,3,0,39,8,31,49,0,0
118,17/05/2021,3,2,57,16,41,49,0,0
711,18/05/2021,3,0,89,65,24,72,0,0
27,30/05/2021,3,0,78,78,0,NA,NA,NA
67,24/05/2021,3,1,51,29,22,64,0,0
759,18/05/2021,3,3,84,58,26,62,0,0
878,19/05/2021,3,0,218,7,211,44,0,0
703,27/05/2021,3,1,90,72,18,67,0,0
594,28/05/2021,3,2,105,104,1,80,0,0
665,30/05/2021,3,1,105,105,0,NA,NA,NA
46,25/05/2021,3,1,59,57,2,95,0,0
192,23/05/2021,3,0,86,31,55,49,0,0
797,23/05/2021,3,0,67,49,18,87,0,0
574,21/05/2021,3,11,76,49,27,55,0,0
689,25/05/2021,3,0,130,85,45,63,0,0
198,19/05/2021,3,1,134,113,21,72,0,0
510,27/05/2021,3,2,141,48,93,49,0,0
219,20/05/2021,3,5,72,31,41,49,0,0
750,27/05/2021,3,4,108,89,19,83,0,0
174,27/05/2021,3,4,24,9,15,55,0,0
643,27/05/2021,3,2,101,75,26,52,0,0
842,24/05/2021,3,2,89,40,49,85,0,0
534,15/05/2021,3,0,85,32,53,49,0,0
831,20/05/2021,3,1,149,72,77,49,0,0
513,23/05/2021,3,1,76,35,41,49,0,0
335,25/05/2021,3,5,81,34,47,55,0,0
603,18/05/2021,3,2,82,23,59,55,0,0
861,20/05/2021,3,0,61,60,1,95,0,0
588,29/05/2021,3,0,59,56,3,77,0,0
671,14/05/2021,3,1,64,63,1,90,0,0
454,27/05/2021,3,0,184,30,154,85,0,0
330,24/05/2021,3,2,117,59,58,55,0,0
187,20/05/2021,3,1,40,18,22,49,0,0
343,28/05/2021,3,3,59,31,28,55,0,0
815,29/05/2021,3,11,118,122,-4,NA,NA,NA
499,25/05/2021,3,0,31,13,18,49,0,0
586,19/05/2021,3,3,80,41,39,64,0,0
402,24/05/2021,3,0,155,95,60,49,0,0
208,26/05/2021,3,0,60,37,23,59,0,0
532,14/05/2021,3,0,84,24,60,49,0,0
635,13/05/2021,3,1,87,40,47,49,0,0
680,18/05/2021,3,3,77,35,42,49,0,0
640,16/05/2021,3,4,122,17,105,49,0,0
379,14/05/2021,3,3,284,47,237,66,0,0
388,22/05/2021,3,1,59,55,4,74,0,0
98,28/05/2021,3,2,93,88,5,85,0,0
123,17/05/2021,3,0,95,30,65,49,0,0
616,23/05/2021,3,2,73,36,37,49,0,0
682,16/05/2021,3,2,78,11,67,49,0,0
37,16/05/2021,3,2,79,11,68,49,0,0
735,19/05/2021,3,0,29,18,11,52,0,0
139,21/05/2021,3,2,57,32,25,60,0,0
836,22/05/2021,3,0,101,90,11,146,0,0
816,17/05/2021,3,1,81,81,0,NA,NA,NA
758,26/05/2021,3,0,73,49,24,74,0,0
302,06/05/2021,3,0,61,34,27,49,0,0
749,16/05/2021,3,5,149,10,139,49,0,0
171,24/05/2021,3,2,47,32,15,74,0,0
670,18/05/2021,3,6,102,102,0,NA,NA,NA
66,23/05/2021,3,0,152,26,126,49,0,0
169,12/05/2021,3,0,20,10,10,64,0,0
234,17/05/2021,3,3,59,33,26,49,0,0
11,19/05/2021,3,2,82,66,16,74,0,0
164,30/05/2021,3,0,62,62,0,NA,NA,NA
525,24/05/2021,3,1,74,59,15,57,0,0
765,18/05/2021,3,1,100,69,31,80,0,0
1,20/05/2021,3,3,97,56,41,55,0,0
624,28/05/2021,3,1,78,58,20,60,0,0
865,28/05/2021,3,1,84,82,2,71,0,0
919,30/05/2021,3,0,123,123,0,NA,NA,NA
652,25/05/2021,3,0,69,50,19,64,0,0
474,23/05/2021,3,0,112,35,77,49,0,0
114,22/05/2021,3,0,75,66,9,151,0,0
110,22/05/2021,3,1,86,64,22,60,0,0
817,25/05/2021,3,0,83,34,49,55,0,0
147,20/05/2021,3,1,79,55,24,49,0,0
412,27/05/2021,3,9,92,34,58,49,0,0
349,18/05/2021,3,1,89,70,19,72,0,0
626,27/05/2021,3,4,98,76,22,67,0,0
407,26/05/2021,3,1,40,14,26,49,0,0
386,28/05/2021,3,2,83,75,8,74,0,0
61,26/05/2021,3,1,99,51,48,59,0,0
632,15/05/2021,3,0,82,11,71,49,0,0
831,21/05/2021,3,2,148,53,95,49,0,0
576,23/05/2021,3,0,58,16,42,49,0,0
781,24/05/2021,3,3,80,81,-1,NA,NA,NA
308,19/05/2021,3,2,46,22,24,57,0,0
127,21/05/2021,3,1,59,36,23,55,0,0
177,29/05/2021,3,0,48,33,15,67,0,0
602,14/05/2021,3,0,64,10,54,49,0,0
454,24/05/2021,3,0,184,23,161,85,0,0
210,24/05/2021,3,2,100,85,15,77,0,0
189,20/05/2021,3,0,165,159,6,82,0,0
414,26/05/2021,3,20,166,73,93,59,0,0
485,29/05/2021,3,0,65,65,0,NA,NA,NA
340,25/05/2021,3,18,116,13,103,49,0,0
477,19/05/2021,3,3,117,32,85,49,0,0
934,16/05/2021,3,75,24,0,24,35,0,0
208,16/05/2021,3,0,60,5,55,49,0,0
532,19/05/2021,3,0,84,83,1,127,0,0
457,14/05/2021,3,1,62,17,45,49,0,0
680,17/05/2021,3,3,77,28,49,49,0,0
405,15/05/2021,3,1,89,24,65,49,0,0
23,13/05/2021,3,4,60,34,26,49,0,0
291,23/05/2021,3,1,60,30,30,49,0,0
550,29/05/2021,3,2,110,106,4,88,0,0
196,17/05/2021,3,0,138,15,123,49,0,0
756,20/05/2021,3,2,104,105,-1,NA,NA,NA
22,17/05/2021,3,0,64,64,0,NA,NA,NA
473,16/05/2021,3,2,48,14,34,49,0,0
318,18/05/2021,3,0,59,59,0,NA,NA,NA
642,21/05/2021,3,2,93,70,23,60,0,0
875,22/05/2021,3,0,92,82,10,74,0,0
12,16/05/2021,3,1,42,6,36,49,0,0
872,17/05/2021,3,1,64,64,0,NA,NA,NA
302,05/05/2021,3,0,61,26,35,49,0,0
87,17/05/2021,3,1,117,33,84,49,0,0
89,26/05/2021,3,2,58,45,13,57,0,0
670,19/05/2021,3,2,106,106,0,NA,NA,NA
446,23/05/2021,3,7,126,47,79,49,0,0
169,13/05/2021,3,0,20,12,8,64,0,0
539,17/05/2021,3,2,95,52,43,49,0,0
614,18/05/2021,3,2,80,59,21,74,0,0
713,29/05/2021,3,1,60,60,0,NA,NA,NA
368,25/05/2021,3,1,84,30,54,141,0,0
765,20/05/2021,3,1,100,92,8,72,0,0
1,24/05/2021,3,4,96,64,32,67,0,0
583,29/05/2021,3,1,80,72,8,67,0,0
193,27/05/2021,3,1,107,44,63,49,0,0
307,29/05/2021,3,1,78,78,0,NA,NA,NA
200,24/05/2021,3,6,113,109,4,77,0,0
251,25/05/2021,3,2,122,59,63,49,0,0
217,22/05/2021,3,0,41,28,13,60,0,0
838,21/05/2021,3,3,62,62,0,NA,NA,NA
342,25/05/2021,3,0,114,43,71,49,0,0
648,21/05/2021,3,1,63,52,11,67,0,0
706,27/05/2021,3,2,72,70,2,62,0,0
349,17/05/2021,3,1,89,67,22,60,0,0
206,28/05/2021,3,16,197,60,137,59,0,0
530,26/05/2021,3,1,59,32,27,80,0,0
643,28/05/2021,3,2,101,75,26,60,0,0
185,24/05/2021,3,1,167,95,72,49,0,0
60,16/05/2021,3,0,57,20,37,49,0,0
831,19/05/2021,3,0,150,64,86,49,0,0
148,21/05/2021,3,0,25,23,2,85,0,0
779,24/05/2021,3,0,104,47,57,55,0,0
218,18/05/2021,3,3,75,35,40,49,0,0
222,21/05/2021,3,0,77,56,21,77,0,0
588,28/05/2021,3,0,59,52,7,77,0,0
602,15/05/2021,3,0,64,9,55,49,0,0
82,23/05/2021,3,0,96,45,51,53,0,0
338,21/05/2021,3,0,400,132,268,49,0,0
189,18/05/2021,3,0,165,132,33,80,0,0
358,28/05/2021,3,1,92,69,23,60,0,0
723,29/05/2021,3,3,78,78,0,NA,NA,NA
610,25/05/2021,3,1,66,50,16,74,0,0
702,18/05/2021,3,1,49,45,4,79,0,0
248,16/05/2021,3,0,82,13,69,49,0,0
725,17/05/2021,3,0,17,17,0,NA,NA,NA
876,19/05/2021,3,1,181,58,123,45,0,0
457,17/05/2021,3,1,62,30,32,49,0,0
580,18/05/2021,3,0,98,80,18,74,0,0
36,15/05/2021,3,1,62,7,55,49,0,0
23,14/05/2021,3,3,61,22,39,49,0,0
291,24/05/2021,3,1,60,31,29,49,0,0
301,28/05/2021,3,1,100,48,52,55,0,0
497,18/05/2021,3,4,189,106,83,49,0,0
542,22/05/2021,3,4,71,73,-2,NA,NA,NA
303,13/05/2021,3,1,64,41,23,64,0,0
95,15/05/2021,3,1,87,12,75,49,0,0
237,18/05/2021,3,4,117,28,89,49,0,0
518,21/05/2021,3,1,16,12,4,86,0,0
600,21/05/2021,3,1,49,41,8,91,0,0
390,15/05/2021,3,2,134,22,112,49,0,0
563,16/05/2021,3,2,68,7,61,49,0,0
367,03/05/2021,3,2,72,3,69,55,0,0
91,17/05/2021,3,1,79,33,46,49,0,0
171,27/05/2021,3,2,47,44,3,77,0,0
670,20/05/2021,3,4,104,104,0,NA,NA,NA
446,24/05/2021,3,7,126,63,63,49,0,0
747,14/05/2021,3,0,64,23,41,49,0,0
49,18/05/2021,3,9,139,30,109,49,0,0
614,19/05/2021,3,2,80,60,20,67,0,0
713,30/05/2021,3,1,60,60,0,NA,NA,NA
525,25/05/2021,3,1,74,72,2,84,0,0
242,17/05/2021,3,1,137,65,72,49,0,0
701,20/05/2021,3,2,60,55,5,77,0,0
583,28/05/2021,3,1,80,56,24,60,0,0
848,28/05/2021,3,7,131,73,58,35,0,0
665,29/05/2021,3,1,105,105,0,NA,NA,NA
809,24/05/2021,3,3,98,70,28,57,0,0
269,25/05/2021,3,2,78,47,31,49,0,0
566,23/05/2021,3,0,75,6,69,49,0,0
431,22/05/2021,3,4,126,127,-1,NA,NA,NA
365,23/05/2021,3,0,68,56,12,74,0,0
17,19/05/2021,3,1,93,89,4,84,0,0
126,28/05/2021,3,2,118,105,13,97,0,0
633,17/05/2021,3,1,49,31,18,52,0,0
285,26/05/2021,3,0,80,52,28,59,0,0
679,27/05/2021,3,0,89,50,39,72,0,0
531,27/05/2021,3,1,58,45,13,52,0,0
289,23/05/2021,3,3,65,9,56,49,0,0
632,16/05/2021,3,0,82,10,72,49,0,0
434,20/05/2021,3,2,58,13,45,49,0,0
345,22/05/2021,3,0,101,83,18,106,0,0
789,24/05/2021,3,0,72,60,12,77,0,0
579,20/05/2021,3,0,44,38,6,62,0,0
275,21/05/2021,3,2,115,109,6,79,0,0
767,29/05/2021,3,0,67,68,-1,NA,NA,NA
449,14/05/2021,3,3,92,6,86,66,0,0
288,23/05/2021,3,0,60,26,34,49,0,0
338,22/05/2021,3,3,397,107,290,49,0,0
238,18/05/2021,3,0,66,33,33,55,0,0
562,28/05/2021,3,1,67,52,15,67,0,0
738,29/05/2021,3,1,123,123,0,NA,NA,NA
656,23/05/2021,3,0,115,76,39,85,0,0
69,18/05/2021,3,1,59,57,2,103,0,0
804,16/05/2021,3,3,142,17,125,49,0,0
845,16/05/2021,3,1,119,23,96,49,0,0
876,20/05/2021,3,2,180,69,111,45,0,0
453,14/05/2021,3,4,134,32,102,55,0,0
425,20/05/2021,3,5,245,43,202,66,0,0
640,15/05/2021,3,0,126,28,98,49,0,0
849,14/05/2021,3,1,83,16,67,49,0,0
606,24/05/2021,3,1,45,26,19,52,0,0
337,28/05/2021,3,1,59,53,6,74,0,0
123,16/05/2021,3,0,95,6,89,49,0,0
344,22/05/2021,3,1,64,64,0,NA,NA,NA
8,15/05/2021,3,1,39,32,7,57,0,0
244,15/05/2021,3,1,199,60,139,49,0,0
178,19/05/2021,3,1,37,37,0,NA,NA,NA
782,20/05/2021,3,0,20,18,2,85,0,0
417,22/05/2021,3,0,103,103,0,NA,NA,NA
390,16/05/2021,3,2,134,13,121,49,0,0
113,15/05/2021,3,1,31,3,28,49,0,0
367,04/05/2021,3,2,72,22,50,55,0,0
205,17/05/2021,3,0,126,66,60,49,0,0
700,24/05/2021,3,6,126,78,48,57,0,0
768,18/05/2021,3,1,86,57,29,52,0,0
182,18/05/2021,3,2,78,60,18,57,0,0
720,12/05/2021,3,0,39,19,20,55,0,0
234,19/05/2021,3,4,58,34,24,52,0,0
717,19/05/2021,3,2,191,93,98,60,0,0
746,22/05/2021,3,2,58,57,1,79,0,0
152,25/05/2021,3,1,90,36,54,55,0,0
759,17/05/2021,3,0,87,53,34,49,0,0
701,21/05/2021,3,2,60,45,15,57,0,0
748,27/05/2021,3,10,134,75,59,49,0,0
262,29/05/2021,3,1,50,50,0,NA,NA,NA
554,21/05/2021,3,0,42,41,1,88,0,0
581,25/05/2021,3,37,188,167,21,80,0,0
597,23/05/2021,3,4,97,29,68,49,0,0
637,23/05/2021,3,0,74,52,22,97,0,0
728,22/05/2021,3,0,47,47,0,NA,NA,NA
259,25/05/2021,3,0,60,41,19,162,0,0
287,20/05/2021,3,1,122,53,69,49,0,0
743,28/05/2021,3,3,123,78,45,49,0,0
564,18/05/2021,3,1,73,67,6,63,0,0
385,26/05/2021,3,2,61,40,21,80,0,0
679,18/05/2021,3,2,87,81,6,85,0,0
818,27/05/2021,3,1,80,77,3,134,0,0
61,24/05/2021,3,1,99,58,41,49,0,0
658,16/05/2021,3,0,81,25,56,49,0,0
32,20/05/2021,3,1,104,91,13,80,0,0
345,20/05/2021,3,0,101,101,0,NA,NA,NA
592,24/05/2021,3,1,83,75,8,85,0,0
58,18/05/2021,3,2,65,38,27,55,0,0
326,21/05/2021,3,3,78,46,32,55,0,0
120,29/05/2021,3,2,152,152,0,NA,NA,NA
793,14/05/2021,3,1,130,18,112,49,0,0
288,27/05/2021,3,0,60,35,25,55,0,0
338,23/05/2021,3,0,400,104,296,49,0,0
305,19/05/2021,3,12,47,26,21,52,0,0
828,27/05/2021,3,0,75,69,6,100,0,0
334,29/05/2021,3,1,57,57,0,NA,NA,NA
80,25/05/2021,3,0,125,56,69,52,0,0
406,19/05/2021,3,1,38,29,9,85,0,0
104,17/05/2021,3,1,61,61,0,NA,NA,NA
214,18/05/2021,3,4,82,49,33,57,0,0
532,20/05/2021,3,0,84,76,8,82,0,0
655,18/05/2021,3,0,72,60,12,89,0,0
578,18/05/2021,3,1,57,37,20,49,0,0
503,16/05/2021,3,0,184,2,182,49,0,0
23,16/05/2021,3,3,61,12,49,49,0,0
116,22/05/2021,3,0,61,60,1,135,0,0
313,23/05/2021,3,0,31,7,24,49,0,0
196,16/05/2021,3,0,138,3,135,49,0,0
9,22/05/2021,3,0,27,27,0,NA,NA,NA
800,13/05/2021,3,2,55,14,41,49,0,0
309,16/05/2021,3,1,15,11,4,62,0,0
788,19/05/2021,3,2,89,88,1,70,0,0
3,21/05/2021,3,8,105,28,77,55,0,0
252,22/05/2021,3,1,263,134,129,49,0,0
816,16/05/2021,3,2,80,31,49,49,0,0
113,16/05/2021,3,1,31,1,30,49,0,0
693,04/05/2021,3,5,120,11,109,49,0,0
246,17/05/2021,3,1,111,34,77,49,0,0
745,25/05/2021,3,1,104,69,35,67,0,0
833,21/05/2021,3,1,82,69,13,77,0,0
281,18/05/2021,3,3,80,55,25,107,0,0
720,15/05/2021,3,0,39,10,29,49,0,0
521,18/05/2021,3,1,54,33,21,55,0,0
11,20/05/2021,3,2,82,77,5,63,0,0
567,22/05/2021,3,0,61,61,0,NA,NA,NA
915,25/05/2021,3,6,183,8,175,35,0,0
154,20/05/2021,3,5,99,68,31,49,0,0
701,22/05/2021,3,2,60,48,12,87,0,0
369,29/05/2021,3,3,87,57,30,104,0,0
475,29/05/2021,3,1,98,98,0,NA,NA,NA
659,20/05/2021,3,2,41,31,10,60,0,0
687,25/05/2021,3,2,85,53,32,52,0,0
462,25/05/2021,3,9,180,8,172,80,0,0
712,22/05/2021,3,7,78,78,0,NA,NA,NA
352,22/05/2021,3,0,64,56,8,72,0,0
259,23/05/2021,3,0,60,51,9,138,0,0
42,19/05/2021,3,2,97,69,28,67,0,0
45,29/05/2021,3,60,96,59,37,49,0,0
349,20/05/2021,3,1,89,83,6,83,0,0
143,27/05/2021,3,2,118,83,35,74,0,0
38,18/05/2021,3,1,49,46,3,49,0,0
490,27/05/2021,3,5,160,25,135,49,0,0
185,27/05/2021,3,1,167,61,106,49,0,0
863,16/05/2021,3,8,87,8,79,49,0,0
835,20/05/2021,3,5,99,88,11,74,0,0
240,21/05/2021,3,1,70,49,21,67,0,0
224,24/05/2021,3,1,56,23,33,49,0,0
403,19/05/2021,3,2,96,77,19,77,0,0
742,21/05/2021,3,1,73,51,22,60,0,0
623,29/05/2021,3,0,78,78,0,NA,NA,NA
793,16/05/2021,3,2,129,18,111,49,0,0
288,28/05/2021,3,0,60,44,16,60,0,0
338,24/05/2021,3,0,400,95,305,49,0,0
28,20/05/2021,3,2,126,100,26,72,0,0
621,26/05/2021,3,0,60,48,12,89,0,0
172,27/05/2021,3,2,83,83,0,NA,NA,NA
80,24/05/2021,3,1,124,53,71,49,0,0
175,19/05/2021,3,1,119,49,70,49,0,0
479,17/05/2021,3,1,54,37,17,52,0,0
664,18/05/2021,3,3,152,67,85,55,0,0
532,21/05/2021,3,0,84,64,20,125,0,0
463,13/05/2021,3,0,163,37,126,55,0,0
651,18/05/2021,3,1,77,34,43,49,0,0
13,16/05/2021,3,4,77,20,57,49,0,0
801,16/05/2021,3,7,160,22,138,49,0,0
331,22/05/2021,3,28,66,56,10,124,0,0
844,22/05/2021,3,0,61,13,48,90,0,0
123,18/05/2021,3,0,95,42,53,49,0,0
756,22/05/2021,3,0,106,104,2,182,0,0
22,14/05/2021,3,0,64,21,43,49,0,0
802,14/05/2021,3,1,64,11,53,49,0,0
628,18/05/2021,3,4,55,49,6,80,0,0
139,19/05/2021,3,2,57,38,19,57,0,0
684,21/05/2021,3,2,96,48,48,55,0,0
433,16/05/2021,3,2,316,24,292,66,0,0
538,16/05/2021,3,1,43,6,37,49,0,0
536,06/05/2021,3,1,80,33,47,55,0,0
205,19/05/2021,3,0,126,78,48,49,0,0
71,24/05/2021,3,0,62,29,33,49,0,0
853,21/05/2021,3,1,101,67,34,55,0,0
296,18/05/2021,3,3,57,33,24,74,0,0
726,14/05/2021,3,0,39,4,35,49,0,0
230,19/05/2021,3,0,80,31,49,52,0,0
614,20/05/2021,3,2,80,52,28,60,0,0
561,22/05/2021,3,1,59,54,5,77,0,0
657,24/05/2021,3,0,48,24,24,86,0,0
879,17/05/2021,3,3,161,17,144,39,0,0
701,24/05/2021,3,2,60,47,13,67,0,0
748,29/05/2021,3,8,136,111,25,67,0,0
865,29/05/2021,3,1,84,84,0,NA,NA,NA
372,20/05/2021,3,17,75,72,3,90,0,0
25,24/05/2021,3,1,51,50,1,65,0,0
654,23/05/2021,3,6,53,19,34,75,0,0
356,22/05/2021,3,2,134,132,2,79,0,0
584,22/05/2021,3,0,97,95,2,136,0,0
420,25/05/2021,3,0,69,69,0,NA,NA,NA
413,21/05/2021,3,2,114,68,46,55,0,0
45,26/05/2021,3,1,155,52,103,49,0,0
349,19/05/2021,3,1,89,69,20,72,0,0
626,26/05/2021,3,3,99,70,29,67,0,0
407,19/05/2021,3,1,40,15,25,49,0,0
339,28/05/2021,3,15,579,140,439,49,0,0
289,27/05/2021,3,1,67,34,33,49,0,0
752,17/05/2021,3,27,17,17,0,NA,NA,NA
314,20/05/2021,3,1,68,61,7,62,0,0
345,21/05/2021,3,0,101,77,24,77,0,0
515,25/05/2021,3,5,107,47,60,52,0,0
438,19/05/2021,3,10,86,51,35,80,0,0
52,20/05/2021,3,7,135,134,1,75,0,0
33,29/05/2021,3,4,76,76,0,NA,NA,NA
41,16/05/2021,3,1,83,27,56,49,0,0
288,25/05/2021,3,0,60,32,28,55,0,0
493,16/05/2021,3,1,34,7,27,55,0,0
400,20/05/2021,3,2,28,15,13,49,0,0
828,26/05/2021,3,0,75,60,15,118,0,0
172,29/05/2021,3,2,83,83,0,NA,NA,NA
859,24/05/2021,3,1,84,22,62,49,0,0
858,18/05/2021,3,0,81,81,0,NA,NA,NA
264,16/05/2021,3,1,59,16,43,49,0,0
725,18/05/2021,3,0,17,14,3,80,0,0
44,15/05/2021,3,4,104,85,19,52,0,0
877,17/05/2021,3,0,158,35,123,35,0,0
461,19/05/2021,3,2,120,15,105,66,0,0
273,14/05/2021,3,0,103,103,0,NA,NA,NA
896,16/05/2021,3,0,82,14,68,49,0,0
645,22/05/2021,3,4,37,20,17,115,0,0
913,23/05/2021,3,0,105,16,89,70,0,0
7,16/05/2021,3,5,98,15,83,49,0,0
428,22/05/2021,3,4,88,88,0,NA,NA,NA
22,15/05/2021,3,0,64,17,47,49,0,0
161,14/05/2021,3,0,61,12,49,49,0,0
54,20/05/2021,3,1,60,50,10,77,0,0
3,19/05/2021,3,8,105,47,58,49,0,0
427,21/05/2021,3,5,305,68,237,90,0,0
209,16/05/2021,3,1,113,46,67,55,0,0
575,16/05/2021,3,1,49,6,43,49,0,0
693,06/05/2021,3,5,120,6,114,49,0,0
625,19/05/2021,3,0,161,77,84,49,0,0
122,26/05/2021,3,3,118,87,31,82,0,0
898,21/05/2021,3,1,99,55,44,117,0,0
491,18/05/2021,3,5,174,48,126,49,0,0
726,12/05/2021,3,0,39,34,5,82,0,0
118,18/05/2021,3,3,56,12,44,49,0,0
705,20/05/2021,3,2,89,66,23,52,0,0
673,22/05/2021,3,8,115,115,0,NA,NA,NA
498,23/05/2021,3,0,87,33,54,49,0,0
242,18/05/2021,3,2,136,90,46,52,0,0
265,22/05/2021,3,1,56,28,28,55,0,0
86,28/05/2021,3,2,46,36,10,60,0,0
594,20/05/2021,3,41,66,63,3,115,0,0
627,19/05/2021,3,0,41,19,22,59,0,0
555,24/05/2021,3,0,117,87,30,77,0,0
162,23/05/2021,3,1,121,85,36,71,0,0
79,23/05/2021,3,1,45,28,17,69,0,0
484,21/05/2021,3,0,40,38,2,79,0,0
271,23/05/2021,3,0,70,35,35,49,0,0
361,20/05/2021,3,38,27,15,12,80,0,0
743,26/05/2021,3,1,125,80,45,60,0,0
633,19/05/2021,3,1,49,37,12,74,0,0
285,27/05/2021,3,1,79,64,15,60,0,0
357,18/05/2021,3,1,82,67,15,74,0,0
339,27/05/2021,3,15,579,53,526,49,0,0
124,09/05/2021,3,1,53,6,47,49,0,0
235,15/05/2021,3,4,153,25,128,49,0,0
855,20/05/2021,3,7,169,126,43,52,0,0
513,22/05/2021,3,1,76,63,13,67,0,0
789,25/05/2021,3,0,72,59,13,85,0,0
438,20/05/2021,3,8,88,48,40,64,0,0
127,20/05/2021,3,1,59,48,11,74,0,0
232,29/05/2021,3,2,63,63,0,NA,NA,NA
41,12/05/2021,3,1,83,56,27,72,0,0
288,26/05/2021,3,0,60,33,27,60,0,0
493,14/05/2021,3,1,34,8,26,49,0,0
423,20/05/2021,3,1,49,34,15,67,0,0
828,18/05/2021,3,0,75,75,0,NA,NA,NA
803,27/05/2021,3,1,68,68,0,NA,NA,NA
340,24/05/2021,3,18,116,11,105,49,0,0
558,19/05/2021,3,0,44,27,17,67,0,0
899,16/05/2021,3,5,100,44,56,49,0,0
725,16/05/2021,3,0,17,10,7,55,0,0
44,17/05/2021,3,5,103,93,10,62,0,0
877,15/05/2021,3,0,158,22,136,35,0,0
24,18/05/2021,3,1,83,77,6,71,0,0
336,13/05/2021,3,1,73,36,37,59,0,0
50,13/05/2021,3,2,119,28,91,49,0,0
351,23/05/2021,3,3,63,47,16,68,0,0
313,22/05/2021,3,0,31,30,1,77,0,0
105,16/05/2021,3,1,74,17,57,49,0,0
9,24/05/2021,3,0,27,27,0,NA,NA,NA
546,15/05/2021,3,10,142,6,136,49,0,0
161,15/05/2021,3,0,61,17,44,49,0,0
628,20/05/2021,3,4,55,48,7,74,0,0
422,19/05/2021,3,1,78,39,39,49,0,0
427,22/05/2021,3,5,305,62,243,100,0,0
862,15/05/2021,3,1,109,24,85,49,0,0
551,15/05/2021,3,0,115,9,106,49,0,0
727,06/05/2021,3,1,74,31,43,55,0,0
87,16/05/2021,3,1,117,14,103,49,0,0
745,26/05/2021,3,1,104,63,41,55,0,0
853,19/05/2021,3,1,101,61,40,55,0,0
784,19/05/2021,3,3,46,43,3,70,0,0
315,14/05/2021,3,0,62,42,20,60,0,0
284,19/05/2021,3,1,25,18,7,79,0,0
409,17/05/2021,3,9,98,72,26,52,0,0
168,23/05/2021,3,0,48,29,19,49,0,0
657,16/05/2021,3,0,48,5,43,49,0,0
47,20/05/2021,3,2,55,40,15,80,0,0
391,20/05/2021,3,1,75,56,19,57,0,0
216,29/05/2021,3,2,56,42,14,55,0,0
451,20/05/2021,3,2,81,81,0,NA,NA,NA
665,19/05/2021,3,0,106,64,42,60,0,0
792,25/05/2021,3,0,102,81,21,106,0,0
186,25/05/2021,3,1,57,36,21,65,0,0
79,24/05/2021,3,1,45,33,12,85,0,0
598,21/05/2021,3,0,146,146,0,NA,NA,NA
243,24/05/2021,3,1,126,48,78,55,0,0
361,21/05/2021,3,38,27,17,10,107,0,0
134,27/05/2021,3,1,47,44,3,79,0,0
633,20/05/2021,3,1,49,31,18,52,0,0
886,28/05/2021,3,1,151,97,54,49,0,0
38,19/05/2021,3,1,49,45,4,134,0,0
486,27/05/2021,3,0,124,67,57,49,0,0
30,11/05/2021,3,1,70,52,18,80,0,0
235,16/05/2021,3,4,153,22,131,49,0,0
835,19/05/2021,3,5,99,71,28,72,0,0
148,23/05/2021,3,0,25,20,5,62,0,0
130,25/05/2021,3,1,80,50,30,77,0,0
764,18/05/2021,3,2,67,36,31,55,0,0
275,20/05/2021,3,2,115,82,33,60,0,0
480,29/05/2021,3,0,28,28,0,NA,NA,NA
671,16/05/2021,3,1,64,58,6,72,0,0
82,26/05/2021,3,0,96,76,20,90,0,0
807,16/05/2021,3,1,99,7,92,49,0,0
785,20/05/2021,3,1,109,100,9,62,0,0
562,18/05/2021,3,1,67,67,0,NA,NA,NA
101,29/05/2021,3,1,59,59,0,NA,NA,NA
656,24/05/2021,3,0,115,92,23,76,0,0
504,18/05/2021,3,0,83,25,58,49,0,0
688,17/05/2021,3,6,113,53,60,49,0,0
664,16/05/2021,3,5,150,27,123,49,0,0
44,18/05/2021,3,4,104,91,13,80,0,0
635,14/05/2021,3,0,88,16,72,49,0,0
517,18/05/2021,3,1,57,54,3,134,0,0
405,13/05/2021,3,1,89,58,31,52,0,0
470,16/05/2021,3,2,78,33,45,49,0,0
388,23/05/2021,3,1,59,16,43,49,0,0
508,23/05/2021,3,0,80,33,47,49,0,0
166,16/05/2021,3,4,62,13,49,49,0,0
68,23/05/2021,3,1,115,14,101,49,0,0
546,16/05/2021,3,12,140,7,133,49,0,0
59,16/05/2021,3,0,75,5,70,49,0,0
786,20/05/2021,3,1,61,42,19,52,0,0
204,19/05/2021,3,0,64,11,53,49,0,0
138,21/05/2021,3,0,98,58,40,55,0,0
394,16/05/2021,3,2,66,8,58,49,0,0
569,16/05/2021,3,0,120,15,105,49,0,0
302,03/05/2021,3,0,61,14,47,49,0,0
91,16/05/2021,3,1,79,11,68,49,0,0
710,27/05/2021,3,0,20,18,2,67,0,0
540,20/05/2021,3,1,81,56,25,52,0,0
239,18/05/2021,3,0,40,34,6,80,0,0
169,15/05/2021,3,0,20,12,8,49,0,0
787,17/05/2021,3,2,106,40,66,49,0,0
409,19/05/2021,3,7,100,65,35,52,0,0
456,22/05/2021,3,5,85,84,1,62,0,0
368,16/05/2021,3,1,84,14,70,49,0,0
154,18/05/2021,3,3,101,42,59,49,0,0
823,24/05/2021,3,1,60,38,22,65,0,0
440,21/05/2021,3,0,265,50,215,90,0,0
228,19/05/2021,3,2,40,25,15,52,0,0
197,21/05/2021,3,0,118,67,51,55,0,0
809,25/05/2021,3,3,98,73,25,55,0,0
512,25/05/2021,3,1,61,25,36,49,0,0
333,24/05/2021,3,1,56,55,1,140,0,0
439,22/05/2021,3,5,86,88,-2,NA,NA,NA
593,23/05/2021,3,30,51,45,6,70,0,0
332,19/05/2021,3,0,40,19,21,55,0,0
543,28/05/2021,3,1,64,62,2,166,0,0
564,17/05/2021,3,1,73,47,26,49,0,0
886,26/05/2021,3,1,151,84,67,49,0,0
38,20/05/2021,3,1,49,45,4,79,0,0
441,27/05/2021,3,0,168,65,103,75,0,0
61,11/05/2021,3,1,99,41,58,64,0,0
383,16/05/2021,3,3,82,37,45,49,0,0
837,19/05/2021,3,4,322,64,258,66,0,0
576,22/05/2021,3,0,58,52,6,74,0,0
396,24/05/2021,3,1,29,20,9,52,0,0
58,17/05/2021,3,1,66,45,21,55,0,0
452,20/05/2021,3,2,58,44,14,67,0,0
860,29/05/2021,3,0,92,92,0,NA,NA,NA
793,13/05/2021,3,1,130,32,98,49,0,0
328,05/05/2021,3,1,97,61,36,64,0,0
304,14/05/2021,3,2,58,6,52,49,0,0
276,18/05/2021,3,1,203,66,137,49,0,0
621,18/05/2021,3,0,60,44,16,80,0,0
868,28/05/2021,3,0,83,83,0,NA,NA,NA
601,25/05/2021,3,5,63,44,19,63,0,0
889,17/05/2021,3,1,123,13,110,45,0,0
83,16/05/2021,3,24,144,31,113,49,0,0
483,17/05/2021,3,2,97,27,70,49,0,0
532,17/05/2021,3,0,84,61,23,72,0,0
655,16/05/2021,3,0,72,14,58,49,0,0
517,20/05/2021,3,1,57,51,6,63,0,0
395,17/05/2021,3,1,71,45,26,52,0,0
379,15/05/2021,3,2,285,59,226,66,0,0
81,24/05/2021,3,1,59,16,43,49,0,0
55,22/05/2021,3,2,31,24,7,67,0,0
497,16/05/2021,3,2,191,26,165,49,0,0
344,20/05/2021,3,1,64,60,4,62,0,0
730,13/05/2021,3,2,73,9,64,49,0,0
802,13/05/2021,3,1,64,44,20,64,0,0
155,18/05/2021,3,0,93,68,25,67,0,0
642,19/05/2021,3,2,93,44,49,49,0,0
266,22/05/2021,3,0,61,59,2,79,0,0
467,16/05/2021,3,2,110,5,105,55,0,0
538,17/05/2021,3,1,43,43,0,NA,NA,NA
536,02/05/2021,3,2,79,28,51,49,0,0
205,16/05/2021,3,0,126,39,87,49,0,0
278,26/05/2021,3,0,105,17,88,49,0,0
540,19/05/2021,3,2,80,50,30,57,0,0
401,18/05/2021,3,0,79,69,10,77,0,0
871,13/05/2021,3,3,75,68,7,65,0,0
325,19/05/2021,3,0,45,34,11,67,0,0
70,17/05/2021,3,3,36,31,5,57,0,0
456,23/05/2021,3,6,84,26,58,49,0,0
806,16/05/2021,3,1,135,25,110,49,0,0
236,17/05/2021,3,2,117,12,105,49,0,0
660,23/05/2021,3,6,180,30,150,49,0,0
86,21/05/2021,3,1,47,34,13,60,0,0
451,19/05/2021,3,2,81,82,-1,NA,NA,NA
627,21/05/2021,3,0,41,29,12,57,0,0
133,24/05/2021,3,2,62,24,38,49,0,0
253,23/05/2021,3,1,57,32,25,49,0,0
783,24/05/2021,3,1,79,75,4,82,0,0
110,21/05/2021,3,1,86,28,58,55,0,0
420,24/05/2021,3,1,68,66,2,90,0,0
648,19/05/2021,3,0,64,29,35,72,0,0
45,27/05/2021,3,14,142,48,94,49,0,0
887,19/05/2021,3,18,305,29,276,39,0,0
432,28/05/2021,3,0,165,48,117,90,0,0
316,18/05/2021,3,1,38,36,2,147,0,0
921,21/05/2021,3,5,170,8,162,39,0,0
289,11/05/2021,3,1,67,28,39,55,0,0
681,15/05/2021,3,2,69,11,58,49,0,0
837,21/05/2021,3,4,322,42,280,90,0,0
240,20/05/2021,3,1,70,35,35,55,0,0
867,25/05/2021,3,1,59,57,2,142,0,0
218,17/05/2021,3,3,75,37,38,49,0,0
326,22/05/2021,3,3,78,67,11,67,0,0
366,21/05/2021,3,2,78,58,20,85,0,0
775,12/05/2021,3,2,107,43,64,49,0,0
359,07/05/2021,3,3,101,41,60,49,0,0
304,15/05/2021,3,2,58,6,52,49,0,0
276,19/05/2021,3,1,203,80,123,49,0,0
641,18/05/2021,3,0,160,25,135,49,0,0
99,29/05/2021,3,1,166,166,0,NA,NA,NA
97,23/05/2021,3,22,85,58,27,62,0,0
69,17/05/2021,3,1,59,59,0,NA,NA,NA
104,16/05/2021,3,1,61,37,24,49,0,0
664,17/05/2021,3,4,151,69,82,49,0,0
719,17/05/2021,3,0,41,24,17,59,0,0
655,14/05/2021,3,0,72,10,62,49,0,0
694,19/05/2021,3,1,108,52,56,49,0,0
599,17/05/2021,3,1,152,121,31,57,0,0
470,17/05/2021,3,2,78,66,12,72,0,0
773,24/05/2021,3,1,73,58,15,80,0,0
698,23/05/2021,3,3,113,35,78,49,0,0
646,16/05/2021,3,15,121,14,107,49,0,0
756,21/05/2021,3,1,105,100,5,151,0,0
447,14/05/2021,3,0,143,41,102,49,0,0
95,13/05/2021,3,1,87,30,57,49,0,0
528,18/05/2021,3,0,119,96,23,85,0,0
3,20/05/2021,3,8,105,59,46,49,0,0
321,22/05/2021,3,1,39,35,4,74,0,0
467,17/05/2021,3,2,110,6,104,55,0,0
575,17/05/2021,3,1,49,47,2,67,0,0
693,02/05/2021,3,5,120,3,117,49,0,0
625,16/05/2021,3,1,160,23,137,49,0,0
100,25/05/2021,3,77,147,73,74,62,0,0
48,21/05/2021,3,2,177,13,164,55,0,0
66,18/05/2021,3,0,152,25,127,49,0,0
649,13/05/2021,3,3,61,40,21,59,0,0
284,17/05/2021,3,1,25,16,9,57,0,0
409,18/05/2021,3,9,98,81,17,63,0,0
736,23/05/2021,3,2,103,27,76,49,0,0
4,16/05/2021,3,1,63,48,15,57,0,0
488,17/05/2021,3,3,63,49,14,67,0,0
514,23/05/2021,3,2,232,45,187,49,0,0
511,21/05/2021,3,1,75,48,27,55,0,0
755,20/05/2021,3,0,87,88,-1,NA,NA,NA
639,21/05/2021,3,0,59,55,4,85,0,0
119,25/05/2021,3,2,66,30,36,49,0,0
56,23/05/2021,3,3,62,40,22,49,0,0
356,24/05/2021,3,2,134,97,37,60,0,0
431,21/05/2021,3,3,127,107,20,72,0,0
778,24/05/2021,3,2,79,77,2,85,0,0
776,19/05/2021,3,0,104,42,62,49,0,0
743,27/05/2021,3,3,123,90,33,55,0,0
887,18/05/2021,3,18,305,29,276,39,0,0
76,26/05/2021,3,1,92,76,16,81,0,0
316,19/05/2021,3,1,38,36,2,147,0,0
158,20/05/2021,3,1,23,22,1,87,0,0
289,12/05/2021,3,1,67,27,40,55,0,0
863,15/05/2021,3,5,90,15,75,49,0,0
277,21/05/2021,3,7,65,41,24,60,0,0
812,20/05/2021,3,2,135,64,71,49,0,0
207,25/05/2021,3,2,61,39,22,64,0,0
308,17/05/2021,3,1,47,22,25,49,0,0
452,21/05/2021,3,1,59,46,13,67,0,0
480,21/05/2021,3,0,28,22,6,67,0,0
775,13/05/2021,3,2,107,54,53,49,0,0
843,09/05/2021,3,4,62,19,43,49,0,0
330,15/05/2021,3,2,117,24,93,49,0,0
380,19/05/2021,3,1,159,82,77,49,0,0
741,18/05/2021,3,0,70,40,30,49,0,0
88,29/05/2021,3,1,41,41,0,NA,NA,NA
610,23/05/2021,3,2,65,31,34,49,0,0
69,19/05/2021,3,1,59,52,7,75,0,0
272,16/05/2021,3,1,126,9,117,49,0,0
827,17/05/2021,3,1,69,64,5,74,0,0
719,19/05/2021,3,0,41,33,8,59,0,0
635,15/05/2021,3,0,88,13,75,49,0,0
661,19/05/2021,3,2,170,40,130,49,0,0
13,13/05/2021,3,3,78,71,7,70,0,0
849,12/05/2021,3,1,83,29,54,49,0,0
351,24/05/2021,3,1,65,41,24,80,0,0
319,22/05/2021,3,6,108,108,0,NA,NA,NA
298,18/05/2021,3,2,227,69,158,49,0,0
68,24/05/2021,3,1,115,26,89,49,0,0
8,16/05/2021,3,3,37,17,20,49,0,0
443,13/05/2021,3,7,83,37,46,49,0,0
528,19/05/2021,3,0,119,104,15,82,0,0
92,20/05/2021,3,1,121,55,66,49,0,0
684,22/05/2021,3,3,95,59,36,60,0,0
142,17/05/2021,3,1,61,41,20,64,0,0
551,17/05/2021,3,0,115,88,27,52,0,0
727,02/05/2021,3,1,74,35,39,49,0,0
631,16/05/2021,3,1,70,9,61,49,0,0
700,25/05/2021,3,5,127,63,64,57,0,0
249,18/05/2021,3,2,125,115,10,49,0,0
66,19/05/2021,3,0,152,25,127,49,0,0
297,14/05/2021,3,1,75,26,49,49,0,0
364,18/05/2021,3,2,128,121,7,82,0,0
717,17/05/2021,3,3,190,91,99,55,0,0
811,23/05/2021,3,2,88,30,58,49,0,0
915,15/05/2021,3,3,186,2,184,35,0,0
879,20/05/2021,3,3,161,9,152,39,0,0
514,24/05/2021,3,2,232,47,185,49,0,0
634,20/05/2021,3,0,20,17,3,72,0,0
475,19/05/2021,3,1,98,98,0,NA,NA,NA
307,19/05/2021,3,1,78,50,28,52,0,0
231,24/05/2021,3,0,41,17,24,49,0,0
192,25/05/2021,3,1,85,53,32,57,0,0
824,22/05/2021,3,0,339,64,275,95,0,0
362,22/05/2021,3,4,116,72,44,129,0,0
131,25/05/2021,3,3,46,29,17,49,0,0
413,20/05/2021,3,3,113,100,13,62,0,0
341,28/05/2021,3,41,73,65,8,181,0,0
887,20/05/2021,3,18,305,15,290,39,0,0
886,27/05/2021,3,1,151,94,57,49,0,0
821,18/05/2021,3,1,78,72,6,127,0,0
818,19/05/2021,3,1,80,80,0,NA,NA,NA
842,11/05/2021,3,1,90,70,20,52,0,0
383,15/05/2021,3,3,82,28,54,49,0,0
277,19/05/2021,3,6,66,36,30,70,0,0
63,23/05/2021,3,7,57,19,38,49,0,0
779,25/05/2021,3,0,104,45,59,60,0,0
603,17/05/2021,3,2,82,24,58,55,0,0
326,20/05/2021,3,3,78,47,31,55,0,0
588,20/05/2021,3,0,59,59,0,NA,NA,NA
775,14/05/2021,3,2,107,27,80,49,0,0
454,10/05/2021,3,0,184,8,176,66,0,0
304,16/05/2021,3,2,58,10,48,49,0,0
696,20/05/2021,3,1,88,50,38,49,0,0
828,19/05/2021,3,0,75,75,0,NA,NA,NA
803,29/05/2021,3,0,69,69,0,NA,NA,NA
733,23/05/2021,3,1,99,14,85,49,0,0
175,17/05/2021,3,1,119,56,63,49,0,0
479,16/05/2021,3,1,54,22,32,49,0,0
363,18/05/2021,3,3,96,80,16,72,0,0
577,21/05/2021,3,0,78,34,44,55,0,0
635,16/05/2021,3,0,88,28,60,49,0,0
680,19/05/2021,3,3,77,28,49,49,0,0
13,17/05/2021,3,4,77,75,2,123,0,0
847,15/05/2021,3,5,192,36,156,35,0,0
645,23/05/2021,3,4,37,19,18,52,0,0
508,22/05/2021,3,0,80,71,9,74,0,0
585,18/05/2021,3,2,58,57,1,82,0,0
616,22/05/2021,3,2,73,70,3,83,0,0
471,16/05/2021,3,3,117,54,63,49,0,0
443,14/05/2021,3,9,81,33,48,49,0,0
155,20/05/2021,3,0,93,82,11,62,0,0
642,20/05/2021,3,2,93,49,44,49,0,0
213,21/05/2021,3,4,144,128,16,74,0,0
142,16/05/2021,3,1,61,20,41,49,0,0
430,16/05/2021,3,3,86,19,67,55,0,0
693,03/05/2021,3,5,120,1,119,49,0,0
625,17/05/2021,3,0,161,74,87,49,0,0
370,24/05/2021,3,0,40,16,24,93,0,0
249,19/05/2021,3,2,125,106,19,49,0,0
239,20/05/2021,3,0,40,35,5,72,0,0
548,14/05/2021,3,1,90,23,67,49,0,0
787,18/05/2021,3,2,106,79,27,52,0,0
717,18/05/2021,3,3,190,88,102,55,0,0
746,23/05/2021,3,3,57,27,30,49,0,0
915,16/05/2021,3,3,186,5,181,35,0,0
488,19/05/2021,3,2,64,62,2,95,0,0
265,24/05/2021,3,1,56,19,37,49,0,0
487,20/05/2021,3,0,39,17,22,52,0,0
594,19/05/2021,3,43,64,64,0,NA,NA,NA
919,19/05/2021,3,1,122,92,30,52,0,0
507,25/05/2021,3,4,196,66,130,49,0,0
436,25/05/2021,3,2,204,73,131,55,0,0
356,23/05/2021,3,2,134,62,72,49,0,0
506,22/05/2021,3,2,193,191,2,74,0,0
151,25/05/2021,3,6,70,49,21,80,0,0
198,21/05/2021,3,0,135,103,32,65,0,0
510,29/05/2021,3,3,140,140,0,NA,NA,NA
887,17/05/2021,3,19,304,26,278,39,0,0
180,28/05/2021,3,1,40,16,24,49,0,0
530,18/05/2021,3,1,59,47,12,80,0,0
327,20/05/2021,3,16,52,52,0,NA,NA,NA
850,10/05/2021,3,5,78,49,29,52,0,0
675,15/05/2021,3,1,55,15,40,49,0,0
505,19/05/2021,3,0,84,37,47,49,0,0
26,20/05/2021,3,3,63,25,38,55,0,0
20,24/05/2021,3,1,81,68,13,77,0,0
764,17/05/2021,3,2,67,40,27,49,0,0
426,21/05/2021,3,5,158,106,52,59,0,0
232,20/05/2021,3,2,63,59,4,79,0,0
602,16/05/2021,3,0,64,16,48,49,0,0
288,10/05/2021,3,0,60,34,26,74,0,0
807,14/05/2021,3,4,96,12,84,49,0,0
238,19/05/2021,3,0,66,41,25,60,0,0
828,20/05/2021,3,0,75,75,0,NA,NA,NA
99,21/05/2021,3,1,166,163,3,80,0,0
636,25/05/2021,3,0,120,86,34,77,0,0
702,19/05/2021,3,1,49,43,6,88,0,0
688,16/05/2021,3,5,114,25,89,49,0,0
363,17/05/2021,3,3,96,67,29,59,0,0
44,14/05/2021,3,5,103,73,30,49,0,0
877,13/05/2021,3,0,158,28,130,35,0,0
425,18/05/2021,3,3,247,36,211,66,0,0
377,17/05/2021,3,0,149,118,31,67,0,0
50,12/05/2021,3,2,119,31,88,49,0,0
645,24/05/2021,3,4,37,26,11,77,0,0
329,23/05/2021,3,9,98,68,30,74,0,0
7,18/05/2021,3,2,101,51,50,55,0,0
542,24/05/2021,3,2,73,53,20,63,0,0
730,17/05/2021,3,2,73,32,41,49,0,0
443,15/05/2021,3,10,80,29,51,49,0,0
279,20/05/2021,3,0,57,34,23,55,0,0
754,20/05/2021,3,0,62,17,45,49,0,0
417,21/05/2021,3,0,103,82,21,67,0,0
496,16/05/2021,3,1,59,6,53,49,0,0
650,17/05/2021,3,2,126,54,72,55,0,0
693,05/05/2021,3,5,120,7,113,49,0,0
87,18/05/2021,3,1,117,33,84,49,0,0
615,25/05/2021,3,0,71,69,2,71,0,0
557,19/05/2021,3,0,104,84,20,67,0,0
707,18/05/2021,3,1,39,39,0,NA,NA,NA
297,15/05/2021,3,3,73,25,48,49,0,0
539,19/05/2021,3,2,95,63,32,57,0,0
11,18/05/2021,3,2,82,57,25,55,0,0
168,22/05/2021,3,0,48,48,0,NA,NA,NA
226,15/05/2021,3,0,47,18,29,49,0,0
704,17/05/2021,3,1,31,28,3,65,0,0
371,20/05/2021,3,0,36,21,15,60,0,0
233,20/05/2021,3,3,64,36,28,52,0,0
475,21/05/2021,3,1,98,98,0,NA,NA,NA
376,19/05/2021,3,1,63,48,15,67,0,0
677,25/05/2021,3,0,40,14,26,49,0,0
192,24/05/2021,3,1,85,51,34,52,0,0
43,24/05/2021,3,2,71,43,28,55,0,0
647,22/05/2021,3,5,88,85,3,91,0,0
271,24/05/2021,3,0,70,67,3,65,0,0
864,20/05/2021,3,1,84,58,26,55,0,0
341,14/05/2021,3,2,112,26,86,49,0,0
384,17/05/2021,3,0,101,91,10,67,0,0
84,21/05/2021,3,0,20,20,0,NA,NA,NA
107,19/05/2021,3,29,60,36,24,85,0,0
667,19/05/2021,3,0,10,0,10,NA,NA,NA
850,13/05/2021,3,6,77,46,31,52,0,0
675,16/05/2021,3,1,55,20,35,49,0,0
103,19/05/2021,3,1,160,146,14,85,0,0
63,21/05/2021,3,7,57,36,21,55,0,0
130,24/05/2021,3,1,80,41,39,67,0,0
603,19/05/2021,3,2,82,29,53,55,0,0
426,22/05/2021,3,6,157,137,20,72,0,0
33,21/05/2021,3,3,77,73,4,76,0,0
449,15/05/2021,3,4,91,8,83,66,0,0
82,06/05/2021,3,0,96,64,32,67,0,0
807,15/05/2021,3,4,96,15,81,49,0,0
380,20/05/2021,3,0,160,108,52,52,0,0
455,18/05/2021,3,6,245,34,211,66,0,0
64,21/05/2021,3,4,243,31,212,55,0,0
859,23/05/2021,3,1,84,15,69,49,0,0
492,17/05/2021,3,3,34,19,15,52,0,0
408,17/05/2021,3,5,160,23,137,49,0,0
214,17/05/2021,3,4,82,49,33,52,0,0
532,15/05/2021,3,0,84,12,72,49,0,0
877,14/05/2021,3,0,158,32,126,35,0,0
694,18/05/2021,3,1,108,51,57,49,0,0
273,17/05/2021,3,0,103,102,1,90,0,0
801,15/05/2021,3,7,160,33,127,49,0,0
606,22/05/2021,3,1,45,35,10,113,0,0
814,22/05/2021,3,1,67,67,0,NA,NA,NA
7,17/05/2021,3,2,101,47,54,55,0,0
129,21/05/2021,3,13,187,140,47,64,0,0
761,17/05/2021,3,0,83,30,53,49,0,0
95,16/05/2021,3,1,87,10,77,49,0,0
528,20/05/2021,3,0,119,106,13,62,0,0
782,21/05/2021,3,0,20,15,5,49,0,0
252,21/05/2021,3,1,263,103,160,49,0,0
529,16/05/2021,3,3,38,6,32,49,0,0
758,17/05/2021,3,1,72,37,35,55,0,0
367,06/05/2021,3,1,73,15,58,55,0,0
246,18/05/2021,3,1,111,39,72,49,0,0
171,16/05/2021,3,2,47,7,40,49,0,0
557,20/05/2021,3,0,104,73,31,60,0,0
416,19/05/2021,3,0,34,13,21,49,0,0
649,15/05/2021,3,3,61,21,40,49,0,0
258,19/05/2021,3,1,142,121,21,74,0,0
717,20/05/2021,3,2,191,122,69,55,0,0
713,22/05/2021,3,1,60,60,0,NA,NA,NA
152,15/05/2021,3,1,90,22,68,49,0,0
221,19/05/2021,3,1,61,43,18,74,0,0
111,24/05/2021,3,0,60,55,5,85,0,0
624,20/05/2021,3,2,77,56,21,52,0,0
519,19/05/2021,3,0,64,54,10,74,0,0
35,21/05/2021,3,1,109,52,57,55,0,0
133,25/05/2021,3,2,62,34,28,57,0,0
253,25/05/2021,3,1,57,40,17,67,0,0
566,24/05/2021,3,0,75,26,49,49,0,0
136,21/05/2021,3,0,128,119,9,86,0,0
817,24/05/2021,3,0,83,43,40,49,0,0
147,19/05/2021,3,1,79,63,16,65,0,0
510,14/05/2021,3,2,141,8,133,49,0,0
77,30/05/2021,3,0,103,103,0,NA,NA,NA
432,21/05/2021,3,0,165,37,128,90,0,0
290,19/05/2021,3,2,105,73,32,55,0,0
667,21/05/2021,3,0,10,0,10,NA,NA,NA
604,12/05/2021,3,1,81,30,51,55,0,0
863,22/05/2021,3,3,92,72,20,67,0,0
121,19/05/2021,3,1,109,106,3,147,0,0
812,21/05/2021,3,2,135,68,67,49,0,0
592,25/05/2021,3,1,83,77,6,95,0,0
603,20/05/2021,3,2,82,50,32,55,0,0
742,20/05/2021,3,1,73,44,29,49,0,0
120,21/05/2021,3,2,152,106,46,60,0,0
449,16/05/2021,3,7,88,4,84,66,0,0
328,06/05/2021,3,1,97,56,41,55,0,0
493,15/05/2021,3,1,34,12,22,55,0,0
189,19/05/2021,3,0,165,140,25,80,0,0
455,20/05/2021,3,6,245,21,224,66,0,0
88,21/05/2021,3,1,41,39,2,74,0,0
610,24/05/2021,3,1,66,52,14,67,0,0
586,17/05/2021,3,4,79,44,35,59,0,0
804,17/05/2021,3,3,142,36,106,49,0,0
208,17/05/2021,3,0,60,33,27,55,0,0
577,19/05/2021,3,0,78,24,54,49,0,0
877,18/05/2021,3,0,158,41,117,35,0,0
578,17/05/2021,3,1,57,29,28,49,0,0
273,13/05/2021,3,0,103,102,1,90,0,0
849,15/05/2021,3,1,83,22,61,49,0,0
773,22/05/2021,3,1,73,71,2,84,0,0
891,22/05/2021,3,1,81,81,0,NA,NA,NA
166,17/05/2021,3,5,61,60,1,71,0,0
933,20/05/2021,3,116,31,16,15,46,0,0
471,13/05/2021,3,9,111,74,37,60,0,0
37,13/05/2021,3,0,81,26,55,49,0,0
565,19/05/2021,3,0,62,54,8,90,0,0
204,21/05/2021,3,0,64,19,45,58,0,0
875,21/05/2021,3,0,92,74,18,60,0,0
173,15/05/2021,3,1,70,23,47,49,0,0
137,17/05/2021,3,24,122,26,96,49,0,0
727,04/05/2021,3,1,74,33,41,55,0,0
749,18/05/2021,3,4,150,28,122,49,0,0
71,15/05/2021,3,2,60,8,52,49,0,0
397,21/05/2021,3,0,75,58,17,67,0,0
267,20/05/2021,3,3,80,65,15,57,0,0
649,14/05/2021,3,3,61,23,38,49,0,0
873,19/05/2021,3,5,96,68,28,52,0,0
11,17/05/2021,3,3,81,49,32,49,0,0
547,23/05/2021,3,0,74,43,31,103,0,0
437,15/05/2021,3,2,163,32,131,49,0,0
47,23/05/2021,3,1,56,25,31,49,0,0
878,21/05/2021,3,0,218,13,205,44,0,0
511,26/05/2021,3,0,76,46,30,52,0,0
755,19/05/2021,3,0,87,84,3,147,0,0
307,20/05/2021,3,1,78,73,5,62,0,0
200,26/05/2021,3,6,113,99,14,74,0,0
399,21/05/2021,3,1,60,60,0,NA,NA,NA
712,24/05/2021,3,7,78,43,35,49,0,0
136,22/05/2021,3,0,128,101,27,92,0,0
817,23/05/2021,3,0,83,21,62,49,0,0
571,23/05/2021,3,1,160,30,130,49,0,0
199,14/05/2021,3,1,81,21,60,49,0,0
384,29/05/2021,3,0,101,101,0,NA,NA,NA
294,21/05/2021,3,0,117,111,6,79,0,0
174,20/05/2021,3,2,26,7,19,55,0,0
667,20/05/2021,3,0,10,0,10,NA,NA,NA
185,17/05/2021,3,1,167,47,120,49,0,0
658,22/05/2021,3,0,81,81,0,NA,NA,NA
257,21/05/2021,3,1,43,41,2,94,0,0
812,22/05/2021,3,3,134,102,32,57,0,0
282,25/05/2021,3,28,673,73,600,49,0,0
472,29/05/2021,3,5,229,224,5,132,0,0
310,22/05/2021,3,1,71,54,17,67,0,0
232,21/05/2021,3,2,63,61,2,107,0,0
602,09/05/2021,3,0,64,13,51,49,0,0
359,10/05/2021,3,3,101,51,50,52,0,0
212,14/05/2021,3,2,76,69,7,80,0,0
895,20/05/2021,3,0,69,58,11,57,0,0
494,18/05/2021,3,1,138,76,62,52,0,0
101,21/05/2021,3,1,59,36,23,49,0,0
636,24/05/2021,3,0,120,92,28,62,0,0
93,21/05/2021,3,3,138,138,0,NA,NA,NA
83,22/05/2021,3,9,159,133,26,148,0,0
346,23/05/2021,3,5,115,53,62,49,0,0
577,20/05/2021,3,0,78,28,50,49,0,0
692,17/05/2021,3,0,87,13,74,49,0,0
425,30/05/2021,3,7,243,85,158,70,0,0
336,16/05/2021,3,0,74,60,14,57,0,0
819,12/05/2021,3,1,79,67,12,72,0,0
351,17/05/2021,3,1,65,45,20,55,0,0
716,23/05/2021,3,0,104,41,63,49,0,0
157,17/05/2021,3,2,81,59,22,64,0,0
135,23/05/2021,3,3,63,35,28,66,0,0
303,15/05/2021,3,1,64,37,27,52,0,0
37,14/05/2021,3,2,79,12,67,49,0,0
318,20/05/2021,3,0,59,58,1,87,0,0
813,19/05/2021,3,1,129,97,32,60,0,0
163,22/05/2021,3,1,61,61,0,NA,NA,NA
142,24/05/2021,3,2,60,54,6,84,0,0
538,24/05/2021,3,1,43,30,13,57,0,0
367,14/05/2021,3,0,74,5,69,49,0,0
87,19/05/2021,3,1,117,36,81,49,0,0
89,16/05/2021,3,2,58,8,50,49,0,0
397,19/05/2021,3,0,75,60,15,67,0,0
522,20/05/2021,3,4,58,58,0,NA,NA,NA
747,21/05/2021,3,0,64,45,19,60,0,0
325,22/05/2021,3,0,45,25,20,114,0,0
780,27/05/2021,3,0,60,45,15,66,0,0
713,23/05/2021,3,1,60,50,10,127,0,0
657,28/05/2021,3,0,48,37,11,105,0,0
759,21/05/2021,3,3,84,38,46,55,0,0
878,22/05/2021,3,0,218,11,207,44,0,0
748,25/05/2021,3,10,134,79,55,52,0,0
519,21/05/2021,3,0,64,62,2,102,0,0
665,20/05/2021,3,1,105,69,36,60,0,0
687,26/05/2021,3,2,85,59,26,52,0,0
56,22/05/2021,3,3,62,62,0,NA,NA,NA
824,24/05/2021,3,0,339,28,311,80,0,0
686,21/05/2021,3,0,46,28,18,55,0,0
365,25/05/2021,3,0,68,67,1,132,0,0
147,23/05/2021,3,0,80,30,50,49,0,0
706,14/05/2021,3,1,73,16,57,49,0,0
564,29/05/2021,3,1,73,73,0,NA,NA,NA
180,21/05/2021,3,1,40,17,23,49,0,0
290,20/05/2021,3,2,105,75,30,57,0,0
2,21/05/2021,3,3,56,37,19,60,0,0
61,16/05/2021,3,1,99,13,86,49,0,0
632,21/05/2021,3,0,82,25,57,55,0,0
837,25/05/2021,3,4,322,60,262,90,0,0
812,23/05/2021,3,3,134,26,108,49,0,0
779,22/05/2021,3,0,104,63,41,72,0,0
438,30/05/2021,3,9,87,78,9,67,0,0
742,24/05/2021,3,1,73,50,23,52,0,0
392,26/05/2021,3,0,176,86,90,49,0,0
671,08/05/2021,3,2,63,63,0,NA,NA,NA
82,05/05/2021,3,0,96,55,41,60,0,0
210,14/05/2021,3,2,100,82,18,62,0,0
570,30/05/2021,3,0,149,105,44,52,0,0
343,19/05/2021,3,1,61,48,13,74,0,0
334,21/05/2021,3,0,58,35,23,71,0,0
870,24/05/2021,3,3,43,32,11,74,0,0
378,20/05/2021,3,1,83,68,15,57,0,0
402,22/05/2021,3,0,155,154,1,89,0,0
214,23/05/2021,3,3,83,31,52,49,0,0
595,15/05/2021,3,2,48,18,30,49,0,0
655,15/05/2021,3,0,72,9,63,49,0,0
260,27/05/2021,3,1,119,112,7,65,0,0
336,17/05/2021,3,0,74,73,1,127,0,0
896,14/05/2021,3,0,82,27,55,49,0,0
331,16/05/2021,3,29,65,35,30,49,0,0
724,22/05/2021,3,1,85,81,4,148,0,0
298,24/05/2021,3,2,227,75,152,49,0,0
428,23/05/2021,3,3,89,40,49,49,0,0
471,15/05/2021,3,3,117,54,63,49,0,0
195,19/05/2021,3,2,49,35,14,62,0,0
458,18/05/2021,3,3,178,116,62,49,0,0
760,24/05/2021,3,1,35,10,25,49,0,0
600,22/05/2021,3,1,49,48,1,NA,NA,NA
467,24/05/2021,3,2,110,6,104,85,0,0
569,21/05/2021,3,0,120,97,23,67,0,0
367,11/05/2021,3,0,74,22,52,55,0,0
435,23/05/2021,3,52,68,23,45,49,0,0
278,15/05/2021,3,0,105,6,99,49,0,0
300,18/05/2021,3,0,210,135,75,49,0,0
707,20/05/2021,3,1,39,39,0,NA,NA,NA
747,23/05/2021,3,0,64,23,41,49,0,0
521,23/05/2021,3,1,54,28,26,58,0,0
638,29/05/2021,3,0,101,100,1,87,0,0
811,22/05/2021,3,2,88,70,18,60,0,0
915,27/05/2021,3,5,184,16,168,35,0,0
236,23/05/2021,3,2,117,6,111,49,0,0
1,21/05/2021,3,3,97,16,81,55,0,0
731,26/05/2021,3,4,95,74,21,62,0,0
106,19/05/2021,3,1,30,20,10,88,0,0
376,20/05/2021,3,1,63,43,20,60,0,0
200,27/05/2021,3,6,113,96,17,74,0,0
462,22/05/2021,3,8,181,26,155,90,0,0
797,22/05/2021,3,0,67,63,4,144,0,0
404,23/05/2021,3,0,67,50,17,93,0,0
342,26/05/2021,3,0,114,40,74,49,0,0
776,23/05/2021,3,2,102,20,82,49,0,0
743,14/05/2021,3,1,125,19,106,49,0,0
556,27/05/2021,3,0,117,117,0,NA,NA,NA
34,21/05/2021,3,2,86,28,58,49,0,0
559,19/05/2021,3,46,139,126,13,69,0,0
96,21/05/2021,3,14,55,42,13,59,0,0
604,14/05/2021,3,0,82,13,69,49,0,0
675,22/05/2021,3,1,55,49,6,74,0,0
121,26/05/2021,3,0,110,89,21,161,0,0
317,23/05/2021,3,0,80,50,30,78,0,0
869,23/05/2021,3,1,59,52,7,112,0,0
322,28/05/2021,3,3,97,63,34,55,0,0
691,24/05/2021,3,1,31,31,0,NA,NA,NA
623,26/05/2021,3,0,78,43,35,49,0,0
449,10/05/2021,3,4,91,5,86,66,0,0
359,06/05/2021,3,3,101,65,36,52,0,0
338,14/05/2021,3,3,397,64,333,49,0,0
696,30/05/2021,3,0,89,81,8,62,0,0
179,20/05/2021,3,1,91,41,50,55,0,0
803,20/05/2021,3,0,69,68,1,107,0,0
697,25/05/2021,3,2,107,50,57,60,0,0
702,20/05/2021,3,1,49,40,9,74,0,0
408,21/05/2021,3,5,160,160,0,NA,NA,NA
845,23/05/2021,3,3,117,44,73,49,0,0
874,15/05/2021,3,2,87,6,81,49,0,0
463,16/05/2021,3,0,163,21,142,55,0,0
661,27/05/2021,3,23,149,83,66,52,0,0
273,16/05/2021,3,0,103,88,15,80,0,0
819,16/05/2021,3,0,80,62,18,57,0,0
116,16/05/2021,3,0,61,17,44,49,0,0
856,22/05/2021,3,1,119,100,19,137,0,0
166,23/05/2021,3,1,65,40,25,83,0,0
135,24/05/2021,3,3,63,59,4,84,0,0
22,16/05/2021,3,0,64,17,47,49,0,0
473,19/05/2021,3,4,46,42,4,85,0,0
458,25/05/2021,3,2,179,118,61,49,0,0
202,26/05/2021,3,0,76,71,5,117,0,0
321,27/05/2021,3,1,39,30,9,49,0,0
209,23/05/2021,3,1,113,64,49,60,0,0
551,22/05/2021,3,0,115,101,14,67,0,0
536,11/05/2021,3,2,79,46,33,72,0,0
572,23/05/2021,3,0,61,37,24,49,0,0
852,16/05/2021,3,0,80,74,6,62,0,0
300,21/05/2021,3,0,210,124,86,55,0,0
882,20/05/2021,3,0,130,35,95,39,0,0
720,22/05/2021,3,0,39,30,9,123,0,0
284,22/05/2021,3,1,25,22,3,74,0,0
866,27/05/2021,3,0,100,76,24,62,0,0
90,22/05/2021,3,0,78,68,10,74,0,0
226,26/05/2021,3,0,47,44,3,115,0,0
154,24/05/2021,3,2,102,62,40,49,0,0
1,22/05/2021,3,3,97,19,78,55,0,0
685,25/05/2021,3,2,138,87,51,72,0,0
262,19/05/2021,3,1,50,30,20,60,0,0
197,20/05/2021,3,0,118,43,75,49,0,0
555,27/05/2021,3,0,117,97,20,74,0,0
162,21/05/2021,3,0,122,99,23,90,0,0
846,22/05/2021,3,2,187,72,115,45,0,0
728,24/05/2021,3,0,47,44,3,62,0,0
259,27/05/2021,3,0,60,54,6,164,0,0
776,22/05/2021,3,1,103,62,41,55,0,0
45,15/05/2021,3,2,154,7,147,49,0,0
633,29/05/2021,3,1,49,49,0,NA,NA,NA
294,20/05/2021,3,8,109,109,0,NA,NA,NA
559,20/05/2021,3,46,139,133,6,68,0,0
818,30/05/2021,3,1,80,72,8,140,0,0
850,15/05/2021,3,4,79,24,55,49,0,0
681,22/05/2021,3,5,66,66,0,NA,NA,NA
389,25/05/2021,3,2,124,84,40,52,0,0
513,24/05/2021,3,1,76,39,37,49,0,0
676,22/05/2021,3,1,114,97,17,74,0,0
764,28/05/2021,3,3,66,47,19,55,0,0
772,24/05/2021,3,0,57,57,0,NA,NA,NA
860,25/05/2021,3,0,92,46,46,49,0,0
449,07/05/2021,3,3,92,8,84,66,0,0
328,10/05/2021,3,4,94,59,35,59,0,0
78,15/05/2021,3,0,44,12,32,49,0,0
305,21/05/2021,3,13,46,47,-1,NA,NA,NA
358,18/05/2021,3,2,91,53,38,60,0,0
485,21/05/2021,3,0,65,50,15,67,0,0
355,24/05/2021,3,1,98,59,39,55,0,0
175,20/05/2021,3,8,112,62,50,49,0,0
479,22/05/2021,3,1,54,54,0,NA,NA,NA
483,22/05/2021,3,4,95,92,3,84,0,0
874,20/05/2021,3,2,87,8,79,49,0,0
463,17/05/2021,3,0,163,59,104,55,0,0
24,28/05/2021,3,0,84,60,24,60,0,0
283,13/05/2021,3,0,76,26,50,55,0,0
847,13/05/2021,3,5,192,46,146,35,0,0
388,16/05/2021,3,1,59,12,47,49,0,0
98,22/05/2021,3,2,93,69,24,82,0,0
7,23/05/2021,3,2,101,15,86,49,0,0
129,24/05/2021,3,13,187,104,83,49,0,0
447,16/05/2021,3,0,143,58,85,49,0,0
195,18/05/2021,3,1,50,32,18,49,0,0
628,24/05/2021,3,2,57,26,31,115,0,0
782,26/05/2021,3,0,20,16,4,90,0,0
427,19/05/2021,3,6,304,40,264,66,0,0
816,23/05/2021,3,1,81,77,4,77,0,0
569,24/05/2021,3,0,120,43,77,49,0,0
693,12/05/2021,3,5,120,12,108,49,0,0
749,23/05/2021,3,18,136,39,97,49,0,0
710,16/05/2021,3,0,20,2,18,49,0,0
833,18/05/2021,3,0,83,55,28,57,0,0
790,18/05/2021,3,1,98,70,28,66,0,0
169,22/05/2021,3,1,19,19,0,NA,NA,NA
539,22/05/2021,3,2,95,86,9,74,0,0
638,28/05/2021,3,0,101,70,31,60,0,0
27,23/05/2021,3,0,78,60,18,83,0,0
226,27/05/2021,3,0,47,39,8,90,0,0
759,25/05/2021,3,3,84,39,45,52,0,0
701,19/05/2021,3,2,60,53,7,79,0,0
748,26/05/2021,3,10,134,74,60,49,0,0
262,21/05/2021,3,1,50,40,10,67,0,0
639,19/05/2021,3,0,59,24,35,49,0,0
444,27/05/2021,3,4,115,80,35,49,0,0
15,21/05/2021,3,0,31,28,3,109,0,0
846,23/05/2021,3,2,187,70,117,45,0,0
352,23/05/2021,3,0,64,28,36,49,0,0
817,26/05/2021,3,0,83,38,45,55,0,0
17,23/05/2021,3,1,93,36,57,49,0,0
412,15/05/2021,3,2,99,8,91,49,0,0
323,28/05/2021,3,0,31,31,0,NA,NA,NA
220,20/05/2021,3,26,77,77,0,NA,NA,NA
357,20/05/2021,3,1,82,64,18,67,0,0
2,29/05/2021,3,3,56,49,7,74,0,0
124,17/05/2021,3,2,52,40,12,67,0,0
681,21/05/2021,3,4,67,58,9,67,0,0
709,25/05/2021,3,0,83,51,32,80,0,0
513,25/05/2021,3,2,75,36,39,49,0,0
282,22/05/2021,3,29,672,127,545,49,0,0
218,30/05/2021,3,3,75,49,26,49,0,0
310,19/05/2021,3,1,71,59,12,77,0,0
623,25/05/2021,3,0,78,44,34,52,0,0
449,09/05/2021,3,7,88,5,83,66,0,0
288,06/05/2021,3,1,59,37,22,57,0,0
902,14/05/2021,3,2,124,12,112,49,0,0
305,22/05/2021,3,13,46,49,-3,NA,NA,NA
358,19/05/2021,3,2,91,52,39,55,0,0
723,21/05/2021,3,1,80,62,18,81,0,0
859,26/05/2021,3,1,84,19,65,49,0,0
795,20/05/2021,3,8,97,70,27,55,0,0
899,22/05/2021,3,1,104,104,0,NA,NA,NA
21,23/05/2021,3,1,59,16,43,49,0,0
719,15/05/2021,3,0,41,5,36,49,0,0
635,17/05/2021,3,0,88,67,21,52,0,0
651,29/05/2021,3,3,75,72,3,67,0,0
377,13/05/2021,3,0,149,88,61,55,0,0
896,12/05/2021,3,0,82,59,23,72,0,0
81,17/05/2021,3,1,59,20,39,49,0,0
329,22/05/2021,3,9,98,91,7,135,0,0
196,24/05/2021,3,0,138,23,115,49,0,0
135,22/05/2021,3,4,62,46,16,92,0,0
761,14/05/2021,3,0,83,15,68,49,0,0
244,19/05/2021,3,1,199,94,105,49,0,0
788,24/05/2021,3,2,89,72,17,95,0,0
422,25/05/2021,3,1,78,44,34,49,0,0
266,19/05/2021,3,0,61,58,3,115,0,0
862,24/05/2021,3,1,109,55,54,52,0,0
758,24/05/2021,3,0,73,52,21,74,0,0
693,13/05/2021,3,5,120,16,104,49,0,0
87,24/05/2021,3,46,72,31,41,49,0,0
852,15/05/2021,3,0,80,80,0,NA,NA,NA
833,20/05/2021,3,0,83,66,17,57,0,0
281,19/05/2021,3,1,82,53,29,70,0,0
726,21/05/2021,3,0,39,39,0,NA,NA,NA
873,23/05/2021,3,3,98,33,65,64,0,0
170,29/05/2021,3,0,105,104,1,145,0,0
229,22/05/2021,3,5,51,47,4,124,0,0
226,28/05/2021,3,0,47,40,7,98,0,0
826,21/05/2021,3,2,96,96,0,NA,NA,NA
823,20/05/2021,3,1,60,55,5,70,0,0
624,19/05/2021,3,0,79,40,39,52,0,0
865,19/05/2021,3,1,84,20,64,49,0,0
295,20/05/2021,3,3,102,23,79,49,0,0
904,27/05/2021,3,4,270,9,261,90,0,0
251,21/05/2021,3,1,123,44,79,49,0,0
333,23/05/2021,3,1,56,38,18,91,0,0
714,23/05/2021,3,0,59,38,21,58,0,0
342,27/05/2021,3,0,114,46,68,49,0,0
153,16/05/2021,3,1,63,6,57,49,0,0
39,15/05/2021,3,1,60,30,30,49,0,0
75,29/05/2021,3,0,81,81,0,NA,NA,NA
285,20/05/2021,3,1,79,59,20,67,0,0
476,18/05/2021,3,0,173,38,135,49,0,0
791,30/05/2021,3,19,109,87,22,63,0,0
124,14/05/2021,3,1,53,10,43,49,0,0
60,22/05/2021,3,1,56,55,1,89,0,0
434,24/05/2021,3,2,58,24,34,52,0,0
63,26/05/2021,3,7,57,43,14,49,0,0
282,23/05/2021,3,29,672,117,555,49,0,0
603,28/05/2021,3,0,84,66,18,82,0,0
691,19/05/2021,3,1,31,28,3,123,0,0
480,26/05/2021,3,0,28,22,6,59,0,0
41,11/05/2021,3,1,83,53,30,64,0,0
288,05/05/2021,3,1,59,38,21,67,0,0
902,16/05/2021,3,2,124,7,117,49,0,0
189,22/05/2021,3,0,165,165,0,NA,NA,NA
455,19/05/2021,3,6,245,22,223,66,0,0
172,21/05/2021,3,2,83,67,16,74,0,0
29,17/05/2021,3,0,54,0,54,NA,NA,NA
795,21/05/2021,3,8,97,87,10,74,0,0
264,21/05/2021,3,1,59,26,33,55,0,0
21,22/05/2021,3,1,59,39,20,92,0,0
876,15/05/2021,3,2,180,41,139,45,0,0
463,18/05/2021,3,0,163,89,74,55,0,0
651,26/05/2021,3,1,77,26,51,49,0,0
283,17/05/2021,3,0,76,36,40,55,0,0
470,13/05/2021,3,2,78,71,7,59,0,0
552,16/05/2021,3,12,172,16,156,49,0,0
459,23/05/2021,3,3,89,53,36,49,0,0
157,23/05/2021,3,1,82,52,30,69,0,0
542,23/05/2021,3,4,71,26,45,49,0,0
800,17/05/2021,3,2,55,21,34,49,0,0
309,18/05/2021,3,0,16,12,4,72,0,0
786,24/05/2021,3,2,60,39,21,71,0,0
139,25/05/2021,3,3,56,34,22,63,0,0
266,18/05/2021,3,0,61,61,0,NA,NA,NA
496,25/05/2021,3,1,59,21,38,49,0,0
551,23/05/2021,3,0,115,53,62,49,0,0
727,13/05/2021,3,2,73,37,36,55,0,0
246,24/05/2021,3,2,110,32,78,49,0,0
122,17/05/2021,3,5,116,99,17,74,0,0
557,18/05/2021,3,0,104,73,31,55,0,0
790,19/05/2021,3,1,98,68,30,66,0,0
726,22/05/2021,3,0,39,39,0,NA,NA,NA
521,22/05/2021,3,1,54,54,0,NA,NA,NA
170,30/05/2021,3,0,105,104,1,75,0,0
547,22/05/2021,3,0,74,50,24,163,0,0
4,26/05/2021,3,1,63,47,16,117,0,0
154,07/05/2021,3,6,98,24,74,49,0,0
701,23/05/2021,3,2,60,25,35,49,0,0
86,17/05/2021,3,1,47,47,0,NA,NA,NA
617,19/05/2021,3,2,42,28,14,72,0,0
35,19/05/2021,3,0,110,62,48,49,0,0
231,21/05/2021,3,0,41,30,11,66,0,0
162,22/05/2021,3,1,121,121,0,NA,NA,NA
500,24/05/2021,3,6,73,28,45,49,0,0
598,23/05/2021,3,0,146,105,41,77,0,0
342,28/05/2021,3,0,114,42,72,55,0,0
361,15/05/2021,3,38,27,6,21,80,0,0
706,15/05/2021,3,1,73,6,67,49,0,0
77,29/05/2021,3,0,103,103,0,NA,NA,NA
699,20/05/2021,3,1,61,50,11,89,0,0
476,20/05/2021,3,0,173,46,127,49,0,0
732,29/05/2021,3,0,60,41,19,74,0,0
30,15/05/2021,3,1,70,27,43,49,0,0
383,22/05/2021,3,4,81,75,6,105,0,0
831,26/05/2021,3,1,149,51,98,49,0,0
26,27/05/2021,3,2,64,36,28,55,0,0
629,23/05/2021,3,5,57,31,26,49,0,0
58,30/05/2021,3,1,66,66,0,NA,NA,NA
227,18/05/2021,3,2,42,27,15,57,0,0
480,18/05/2021,3,0,28,12,16,49,0,0
722,11/05/2021,3,0,42,37,5,93,0,0
82,07/05/2021,3,0,96,21,75,49,0,0
117,14/05/2021,3,1,93,69,24,52,0,0
895,22/05/2021,3,0,69,69,0,NA,NA,NA
358,20/05/2021,3,2,91,60,31,55,0,0
890,20/05/2021,3,14,136,45,91,49,0,0
29,19/05/2021,3,0,54,0,54,NA,NA,NA
492,21/05/2021,3,3,34,24,10,67,0,0
83,21/05/2021,3,8,160,157,3,105,0,0
225,23/05/2021,3,11,69,29,40,49,0,0
876,14/05/2021,3,2,180,70,110,45,0,0
635,18/05/2021,3,0,88,66,22,57,0,0
469,27/05/2021,3,4,192,47,145,90,0,0
468,13/05/2021,3,1,95,26,69,49,0,0
819,13/05/2021,3,1,79,64,15,64,0,0
388,17/05/2021,3,1,59,57,2,107,0,0
856,23/05/2021,3,3,117,38,79,55,0,0
646,23/05/2021,3,17,119,83,36,63,0,0
428,21/05/2021,3,3,89,61,28,57,0,0
471,17/05/2021,3,4,116,81,35,60,0,0
443,11/05/2021,3,5,85,29,56,55,0,0
788,25/05/2021,3,2,89,59,30,93,0,0
622,26/05/2021,3,13,31,15,16,100,0,0
875,18/05/2021,3,3,89,91,-2,NA,NA,NA
862,23/05/2021,3,1,109,30,79,54,0,0
650,22/05/2021,3,2,126,100,26,67,0,0
536,14/05/2021,3,2,79,37,42,49,0,0
749,24/05/2021,3,21,133,36,97,49,0,0
89,15/05/2021,3,3,57,5,52,49,0,0
851,21/05/2021,3,0,92,66,26,60,0,0
784,18/05/2021,3,3,46,44,2,70,0,0
747,22/05/2021,3,0,64,64,0,NA,NA,NA
734,22/05/2021,3,1,60,60,0,NA,NA,NA
705,30/05/2021,3,0,91,90,1,70,0,0
721,22/05/2021,3,28,112,103,9,169,0,0
498,28/05/2021,3,0,87,65,22,60,0,0
18,08/05/2021,3,3,89,14,75,49,0,0
265,19/05/2021,3,1,56,27,29,49,0,0
86,18/05/2021,3,1,47,47,0,NA,NA,NA
932,20/05/2021,3,21,86,4,82,45,0,0
85,20/05/2021,3,7,113,103,10,57,0,0
25,21/05/2021,3,1,51,51,0,NA,NA,NA
192,22/05/2021,3,0,86,59,27,67,0,0
846,24/05/2021,3,1,188,40,148,45,0,0
484,23/05/2021,3,0,40,30,10,57,0,0
365,27/05/2021,3,0,68,47,21,77,0,0
361,16/05/2021,3,38,27,10,17,80,0,0
743,15/05/2021,3,1,125,17,108,49,0,0
556,29/05/2021,3,0,117,117,0,NA,NA,NA
143,21/05/2021,3,2,118,110,8,88,0,0
668,19/05/2021,3,4,299,34,265,49,0,0
757,29/05/2021,3,0,117,116,1,94,0,0
842,17/05/2021,3,2,89,42,47,49,0,0
863,21/05/2021,3,2,93,51,42,55,0,0
837,24/05/2021,3,4,322,50,272,85,0,0
576,27/05/2021,3,1,57,36,21,49,0,0
629,22/05/2021,3,2,60,52,8,67,0,0
403,30/05/2021,3,4,94,94,0,NA,NA,NA
227,19/05/2021,3,2,42,24,18,52,0,0
366,18/05/2021,3,0,80,78,2,82,0,0
722,08/05/2021,3,0,42,16,26,49,0,0
288,07/05/2021,3,0,60,21,39,49,0,0
117,15/05/2021,3,1,93,90,3,62,0,0
400,21/05/2021,3,2,28,18,10,60,0,0
414,20/05/2021,3,21,165,117,48,52,0,0
64,20/05/2021,3,3,244,19,225,49,0,0
29,18/05/2021,3,0,54,0,54,NA,NA,NA
537,21/05/2021,3,3,99,96,3,98,0,0
272,22/05/2021,3,2,125,69,56,74,0,0
363,23/05/2021,3,2,97,71,26,94,0,0
876,18/05/2021,3,1,181,56,125,45,0,0
140,16/05/2021,3,0,170,37,133,49,0,0
651,28/05/2021,3,3,75,39,36,55,0,0
468,14/05/2021,3,1,95,13,82,49,0,0
896,13/05/2021,3,0,82,36,46,59,0,0
773,17/05/2021,3,1,73,45,28,64,0,0
319,23/05/2021,3,6,108,56,52,49,0,0
774,23/05/2021,3,4,101,26,75,49,0,0
428,20/05/2021,3,4,88,65,23,67,0,0
8,13/05/2021,3,2,38,29,9,57,0,0
309,11/05/2021,3,1,15,15,0,NA,NA,NA
155,25/05/2021,3,0,93,50,43,80,0,0
464,26/05/2021,3,1,265,45,220,90,0,0
163,20/05/2021,3,1,61,61,0,NA,NA,NA
739,25/05/2021,3,1,74,36,38,49,0,0
137,21/05/2021,3,24,122,41,81,55,0,0
727,14/05/2021,3,2,73,43,30,49,0,0
737,24/05/2021,3,2,40,17,23,49,0,0
122,15/05/2021,3,5,116,43,73,49,0,0
851,18/05/2021,3,0,92,27,65,49,0,0
182,19/05/2021,3,2,78,52,26,52,0,0
871,22/05/2021,3,2,76,76,0,NA,NA,NA
230,22/05/2021,3,0,80,80,0,NA,NA,NA
711,27/05/2021,3,0,89,46,43,55,0,0
736,22/05/2021,3,1,104,68,36,55,0,0
211,26/05/2021,3,3,57,39,18,60,0,0
759,11/05/2021,3,2,85,38,47,49,0,0
265,23/05/2021,3,1,56,19,37,49,0,0
703,18/05/2021,3,1,90,88,2,79,0,0
932,19/05/2021,3,36,71,2,69,45,0,0
674,20/05/2021,3,1,97,43,54,49,0,0
25,22/05/2021,3,1,51,51,0,NA,NA,NA
162,20/05/2021,3,0,122,114,8,62,0,0
566,22/05/2021,3,0,75,65,10,74,0,0
686,23/05/2021,3,0,46,30,16,49,0,0
420,28/05/2021,3,0,69,68,1,112,0,0
17,14/05/2021,3,1,93,12,81,49,0,0
341,16/05/2021,3,2,112,37,75,49,0,0
75,30/05/2021,3,0,81,81,0,NA,NA,NA
385,21/05/2021,3,2,61,55,6,83,0,0
316,20/05/2021,3,1,38,32,6,94,0,0
486,30/05/2021,3,0,124,107,17,62,0,0
289,07/05/2021,3,1,67,7,60,49,0,0
534,22/05/2021,3,1,84,63,21,60,0,0
121,25/05/2021,3,0,110,93,17,159,0,0
345,27/05/2021,3,0,101,84,17,85,0,0
130,22/05/2021,3,3,78,61,17,96,0,0
579,14/05/2021,3,0,44,9,35,49,0,0
481,18/05/2021,3,0,56,24,32,55,0,0
177,19/05/2021,3,0,48,26,22,64,0,0
722,09/05/2021,3,0,42,10,32,49,0,0
328,07/05/2021,3,1,97,30,67,49,0,0
212,15/05/2021,3,1,77,72,5,64,0,0
785,21/05/2021,3,1,109,95,14,96,0,0
156,19/05/2021,3,1,147,136,11,84,0,0
460,20/05/2021,3,3,106,59,47,49,0,0
29,16/05/2021,3,0,54,0,54,NA,NA,NA
504,20/05/2021,3,0,83,19,64,49,0,0
535,21/05/2021,3,1,82,49,33,60,0,0
618,23/05/2021,3,16,135,24,111,49,0,0
876,16/05/2021,3,2,180,36,144,45,0,0
655,17/05/2021,3,0,72,47,25,55,0,0
421,29/05/2021,3,0,19,19,0,NA,NA,NA
395,16/05/2021,3,1,71,11,60,49,0,0
896,17/05/2021,3,0,82,49,33,59,0,0
116,15/05/2021,3,0,61,17,44,49,0,0
301,22/05/2021,3,1,100,33,67,55,0,0
646,22/05/2021,3,16,120,114,6,132,0,0
542,20/05/2021,3,4,71,60,11,65,0,0
447,13/05/2021,3,0,143,95,48,64,0,0
309,10/05/2021,3,0,16,16,0,NA,NA,NA
178,24/05/2021,3,0,38,27,11,64,0,0
464,24/05/2021,3,1,265,33,232,85,0,0
836,19/05/2021,3,3,98,87,11,62,0,0
167,24/05/2021,3,0,84,83,1,89,0,0
137,22/05/2021,3,24,122,59,63,55,0,0
727,15/05/2021,3,2,73,40,33,49,0,0
625,24/05/2021,3,0,161,92,69,49,0,0
745,15/05/2021,3,1,104,17,87,49,0,0
768,21/05/2021,3,0,87,74,13,77,0,0
267,18/05/2021,3,3,80,61,19,49,0,0
548,22/05/2021,3,0,91,91,0,NA,NA,NA
364,22/05/2021,3,2,128,85,43,129,0,0
711,26/05/2021,3,0,89,64,25,72,0,0
770,22/05/2021,3,1,34,30,4,79,0,0
915,26/05/2021,3,5,184,15,169,35,0,0
879,11/05/2021,3,3,161,6,155,39,0,0
111,22/05/2021,3,0,60,50,10,131,0,0
86,19/05/2021,3,1,47,42,5,134,0,0
228,21/05/2021,3,2,40,15,25,55,0,0
674,19/05/2021,3,1,97,27,70,49,0,0
200,22/05/2021,3,6,113,113,0,NA,NA,NA
192,21/05/2021,3,0,86,42,44,55,0,0
114,23/05/2021,3,0,75,63,12,86,0,0
404,24/05/2021,3,0,67,36,31,131,0,0
817,27/05/2021,3,0,83,60,23,52,0,0
153,15/05/2021,3,1,63,9,54,49,0,0
582,16/05/2021,3,0,53,15,38,49,0,0
556,30/05/2021,3,0,117,117,0,NA,NA,NA
750,20/05/2021,3,3,109,90,19,62,0,0
5,18/05/2021,3,5,84,52,32,60,0,0
2,30/05/2021,3,3,56,42,14,52,0,0
124,05/05/2021,3,2,52,29,23,55,0,0
752,21/05/2021,3,20,24,18,6,84,0,0
505,24/05/2021,3,0,84,34,50,49,0,0
317,24/05/2021,3,0,80,52,28,77,0,0
335,22/05/2021,3,6,80,35,45,49,0,0
322,14/05/2021,3,0,100,10,90,49,0,0
222,18/05/2021,3,0,77,25,52,49,0,0
623,18/05/2021,3,0,78,34,44,49,0,0
671,10/05/2021,3,1,64,64,0,NA,NA,NA
261,09/05/2021,3,2,100,16,84,49,0,0
411,14/05/2021,3,1,184,37,147,49,0,0
28,21/05/2021,3,2,126,77,49,60,0,0
179,19/05/2021,3,1,91,43,48,59,0,0
172,20/05/2021,3,2,83,78,5,63,0,0
549,17/05/2021,3,0,61,0,61,NA,NA,NA
504,21/05/2021,3,0,83,24,59,55,0,0
248,22/05/2021,3,0,82,57,25,74,0,0
208,22/05/2021,3,0,60,48,12,67,0,0
876,17/05/2021,3,1,181,57,124,45,0,0
140,18/05/2021,3,0,170,138,32,57,0,0
661,30/05/2021,3,26,146,149,-3,NA,NA,NA
599,14/05/2021,3,2,151,38,113,49,0,0
801,12/05/2021,3,7,160,54,106,49,0,0
771,15/05/2021,3,2,28,15,13,49,0,0
550,23/05/2021,3,2,110,53,57,49,0,0
774,22/05/2021,3,4,101,49,52,55,0,0
135,21/05/2021,3,4,62,61,1,127,0,0
447,17/05/2021,3,0,143,105,38,64,0,0
309,12/05/2021,3,1,15,15,0,NA,NA,NA
155,24/05/2021,3,0,93,54,39,62,0,0
622,24/05/2021,3,12,32,18,14,58,0,0
875,19/05/2021,3,3,89,84,5,85,0,0
394,24/05/2021,3,0,68,33,35,49,0,0
430,24/05/2021,3,4,85,65,20,60,0,0
536,12/05/2021,3,1,80,44,36,59,0,0
87,26/05/2021,3,44,74,39,35,49,0,0
745,16/05/2021,3,1,104,21,83,49,0,0
851,20/05/2021,3,0,92,28,64,49,0,0
446,18/05/2021,3,5,128,64,64,49,0,0
169,07/05/2021,3,0,20,4,16,49,0,0
787,23/05/2021,3,2,106,95,11,68,0,0
170,28/05/2021,3,0,105,85,20,67,0,0
524,23/05/2021,3,1,109,57,52,49,0,0
211,27/05/2021,3,3,57,45,12,74,0,0
879,09/05/2021,3,3,161,2,159,39,0,0
878,23/05/2021,3,0,218,11,207,44,0,0
263,18/05/2021,3,0,66,24,42,49,0,0
106,21/05/2021,3,1,30,28,2,89,0,0
270,21/05/2021,3,1,59,36,23,92,0,0
145,21/05/2021,3,4,54,50,4,71,0,0
15,22/05/2021,3,0,31,30,1,130,0,0
465,22/05/2021,3,4,263,240,23,72,0,0
484,24/05/2021,3,0,40,32,8,77,0,0
689,26/05/2021,3,0,130,97,33,63,0,0
147,14/05/2021,3,1,79,11,68,49,0,0
341,15/05/2021,3,2,112,30,82,49,0,0
219,14/05/2021,3,4,73,4,69,49,0,0
805,20/05/2021,3,3,110,89,21,57,0,0
107,20/05/2021,3,29,60,48,12,89,0,0
386,30/05/2021,3,2,83,75,8,70,0,0
850,05/05/2021,3,2,81,28,53,49,0,0
235,21/05/2021,3,5,152,46,106,49,0,0
835,25/05/2021,3,6,98,96,2,90,0,0
240,26/05/2021,3,1,70,33,37,60,0,0
335,23/05/2021,3,6,80,12,68,49,0,0
579,16/05/2021,3,0,44,10,34,49,0,0
772,19/05/2021,3,0,57,45,12,79,0,0
623,19/05/2021,3,0,78,29,49,49,0,0
722,10/05/2021,3,0,42,35,7,89,0,0
328,09/05/2021,3,3,95,17,78,49,0,0
493,17/05/2021,3,1,34,17,17,49,0,0
187,22/05/2021,3,2,39,32,7,80,0,0
494,19/05/2021,3,1,138,89,49,52,0,0
815,20/05/2021,3,12,117,108,9,62,0,0
549,19/05/2021,3,0,61,0,61,NA,NA,NA
889,20/05/2021,3,1,123,16,107,45,0,0
272,21/05/2021,3,1,126,62,64,66,0,0
225,22/05/2021,3,11,69,52,17,116,0,0
876,21/05/2021,3,2,180,70,110,45,0,0
463,14/05/2021,3,0,163,29,134,55,0,0
461,14/05/2021,3,2,120,1,119,66,0,0
13,14/05/2021,3,4,77,25,52,49,0,0
50,14/05/2021,3,2,119,30,89,49,0,0
552,17/05/2021,3,10,174,75,99,49,0,0
913,22/05/2021,3,0,105,73,32,157,0,0
105,23/05/2021,3,5,70,41,29,57,0,0
129,23/05/2021,3,13,187,75,112,49,0,0
268,17/05/2021,3,1,77,64,13,72,0,0
473,11/05/2021,3,1,49,33,16,72,0,0
478,24/05/2021,3,0,20,16,4,95,0,0
139,24/05/2021,3,2,57,33,24,62,0,0
163,18/05/2021,3,2,60,57,3,95,0,0
167,25/05/2021,3,0,84,74,10,103,0,0
650,23/05/2021,3,4,124,44,80,49,0,0
536,13/05/2021,3,1,80,51,29,64,0,0
205,26/05/2021,3,0,126,55,71,49,0,0
753,15/05/2021,3,4,123,5,118,49,0,0
397,18/05/2021,3,0,75,64,11,55,0,0
446,19/05/2021,3,8,125,65,60,49,0,0
169,11/05/2021,3,0,20,17,3,123,0,0
539,23/05/2021,3,2,95,55,40,49,0,0
705,16/05/2021,3,1,90,6,84,49,0,0
561,23/05/2021,3,1,59,19,40,49,0,0
67,26/05/2021,3,1,51,25,26,64,0,0
221,08/05/2021,3,1,61,12,49,49,0,0
878,24/05/2021,3,0,218,8,210,44,0,0
841,18/05/2021,3,0,182,50,132,55,0,0
451,21/05/2021,3,2,81,70,11,180,0,0
919,20/05/2021,3,0,123,100,23,57,0,0
46,22/05/2021,3,5,55,47,8,99,0,0
393,22/05/2021,3,0,60,53,7,67,0,0
465,23/05/2021,3,4,263,135,128,49,0,0
584,24/05/2021,3,0,97,78,19,108,0,0
243,26/05/2021,3,1,126,58,68,60,0,0
864,14/05/2021,3,1,84,20,64,49,0,0
412,14/05/2021,3,2,99,9,90,49,0,0
633,14/05/2021,3,1,49,3,46,49,0,0
220,21/05/2021,3,27,76,68,8,94,0,0
821,19/05/2021,3,1,78,73,5,95,0,0
490,29/05/2021,3,5,160,128,32,52,0,0
124,07/05/2021,3,2,52,8,44,49,0,0
235,22/05/2021,3,5,152,61,91,49,0,0
389,26/05/2021,3,2,124,70,54,49,0,0
240,27/05/2021,3,1,70,36,34,60,0,0
515,23/05/2021,3,7,105,41,64,49,0,0
472,14/05/2021,3,1,233,8,225,66,0,0
52,18/05/2021,3,12,130,130,0,NA,NA,NA
480,19/05/2021,3,0,28,13,15,57,0,0
602,11/05/2021,3,0,64,32,32,55,0,0
495,10/05/2021,3,2,83,21,62,49,0,0
117,16/05/2021,3,1,93,44,49,49,0,0
785,22/05/2021,3,1,109,106,3,142,0,0
156,18/05/2021,3,1,147,136,11,79,0,0
460,21/05/2021,3,3,106,64,42,52,0,0
549,18/05/2021,3,0,61,0,61,NA,NA,NA
69,21/05/2021,3,1,59,51,8,74,0,0
402,21/05/2021,3,1,154,131,23,74,0,0
725,23/05/2021,3,0,17,12,5,60,0,0
44,16/05/2021,3,4,104,39,65,49,0,0
463,15/05/2021,3,0,163,28,135,55,0,0
425,14/05/2021,3,5,245,6,239,66,0,0
599,16/05/2021,3,2,151,26,125,49,0,0
470,14/05/2021,3,2,78,29,49,49,0,0
351,16/05/2021,3,1,65,17,48,49,0,0
911,22/05/2021,3,0,158,124,34,55,0,0
166,24/05/2021,3,2,64,58,6,65,0,0
616,21/05/2021,3,3,72,62,10,74,0,0
8,17/05/2021,3,1,39,36,3,70,0,0
802,12/05/2021,3,1,64,39,25,64,0,0
528,24/05/2021,3,0,119,118,1,103,0,0
92,24/05/2021,3,1,121,55,66,49,0,0
163,19/05/2021,3,2,60,56,4,90,0,0
394,25/05/2021,3,0,68,37,31,52,0,0
563,24/05/2021,3,2,68,32,36,49,0,0
536,15/05/2021,3,1,80,33,47,49,0,0
205,24/05/2021,3,0,126,64,62,52,0,0
370,15/05/2021,3,0,40,13,27,49,0,0
853,20/05/2021,3,0,102,69,33,55,0,0
66,20/05/2021,3,0,152,21,131,49,0,0
720,11/05/2021,3,0,39,21,18,60,0,0
258,22/05/2021,3,1,142,120,22,85,0,0
424,15/05/2021,3,1,27,27,0,NA,NA,NA
164,23/05/2021,3,0,62,28,34,56,0,0
368,26/05/2021,3,1,84,21,63,124,0,0
488,09/05/2021,3,1,65,8,57,49,0,0
371,22/05/2021,3,0,36,24,12,113,0,0
263,19/05/2021,3,0,66,25,41,49,0,0
917,20/05/2021,3,1,105,15,90,35,0,0
639,20/05/2021,3,0,59,36,23,49,0,0
145,22/05/2021,3,4,54,47,7,100,0,0
399,20/05/2021,3,1,60,58,2,89,0,0
293,23/05/2021,3,3,57,18,39,49,0,0
686,24/05/2021,3,0,46,32,14,57,0,0
778,26/05/2021,3,2,79,69,10,90,0,0
607,14/05/2021,3,1,74,13,61,49,0,0
199,13/05/2021,3,1,81,65,16,67,0,0
633,16/05/2021,3,1,49,2,47,49,0,0
626,21/05/2021,3,3,99,89,10,63,0,0
407,20/05/2021,3,1,40,17,23,49,0,0
791,29/05/2021,3,23,105,104,1,63,0,0
604,05/05/2021,3,1,81,23,58,55,0,0
675,21/05/2021,3,1,55,33,22,60,0,0
855,26/05/2021,3,6,170,86,84,49,0,0
576,26/05/2021,3,1,57,38,19,57,0,0
396,22/05/2021,3,1,29,28,1,74,0,0
308,16/05/2021,3,1,47,7,40,49,0,0
691,18/05/2021,3,1,31,31,0,NA,NA,NA
366,19/05/2021,3,1,79,77,2,90,0,0
449,08/05/2021,3,8,87,15,72,66,0,0
843,07/05/2021,3,4,62,15,47,49,0,0
902,15/05/2021,3,2,124,11,113,49,0,0
570,21/05/2021,3,0,149,77,72,55,0,0
343,18/05/2021,3,1,61,44,17,67,0,0
815,21/05/2021,3,11,118,55,63,133,0,0
549,16/05/2021,3,0,61,0,61,NA,NA,NA
883,21/05/2021,3,6,98,11,87,45,0,0
408,22/05/2021,3,6,159,139,20,146,0,0
225,15/05/2021,3,11,69,6,63,49,0,0
595,17/05/2021,3,2,48,14,34,49,0,0
877,16/05/2021,3,0,158,24,134,35,0,0
461,15/05/2021,3,2,120,2,118,66,0,0
640,17/05/2021,3,4,122,31,91,49,0,0
819,14/05/2021,3,0,80,50,30,49,0,0
331,15/05/2021,3,2,92,22,70,49,0,0
459,22/05/2021,3,4,88,86,2,85,0,0
646,24/05/2021,3,18,118,93,25,63,0,0
68,20/05/2021,3,1,115,20,95,49,0,0
303,17/05/2021,3,1,64,52,12,80,0,0
59,11/05/2021,3,0,75,9,66,49,0,0
565,23/05/2021,3,0,62,21,41,55,0,0
292,24/05/2021,3,0,239,40,199,49,0,0
321,18/05/2021,3,1,39,21,18,49,0,0
167,23/05/2021,3,0,84,62,22,65,0,0
137,23/05/2021,3,24,122,22,100,49,0,0
727,11/05/2021,3,1,74,29,45,55,0,0
572,25/05/2021,3,0,61,40,21,67,0,0
615,16/05/2021,3,0,71,22,49,49,0,0
851,19/05/2021,3,0,92,44,48,49,0,0
401,20/05/2021,3,0,79,67,12,67,0,0
720,08/05/2021,3,0,39,9,30,49,0,0
234,22/05/2021,3,3,59,44,15,72,0,0
717,14/05/2021,3,3,190,17,173,49,0,0
567,23/05/2021,3,0,61,20,41,49,0,0
525,28/05/2021,3,1,74,71,3,83,0,0
704,07/05/2021,3,1,31,2,29,49,0,0
823,19/05/2021,3,1,60,55,5,49,0,0
440,18/05/2021,3,0,265,43,222,66,0,0
917,21/05/2021,3,1,105,9,96,35,0,0
35,20/05/2021,3,0,110,45,65,49,0,0
904,22/05/2021,3,4,270,27,243,105,0,0
683,22/05/2021,3,1,65,51,14,60,0,0
465,24/05/2021,3,4,263,99,164,55,0,0
136,23/05/2021,3,0,128,62,66,49,0,0
778,27/05/2021,3,2,79,76,3,85,0,0
607,15/05/2021,3,1,74,18,56,49,0,0
743,13/05/2021,3,1,125,53,72,55,0,0
219,12/05/2021,3,4,73,19,54,49,0,0
886,21/05/2021,3,5,147,80,67,49,0,0
530,20/05/2021,3,1,59,57,2,77,0,0
921,29/05/2021,3,10,165,12,153,39,0,0
289,05/05/2021,3,1,67,33,34,52,0,0
534,21/05/2021,3,0,85,38,47,55,0,0
314,25/05/2021,3,2,67,52,15,67,0,0
63,25/05/2021,3,7,57,34,23,57,0,0
789,22/05/2021,3,0,72,60,12,123,0,0
308,14/05/2021,3,2,46,4,42,49,0,0
861,18/05/2021,3,0,61,61,0,NA,NA,NA
232,18/05/2021,3,2,63,59,4,85,0,0
41,07/05/2021,3,1,83,19,64,49,0,0
843,10/05/2021,3,2,64,35,29,49,0,0
78,14/05/2021,3,0,44,18,26,49,0,0
238,21/05/2021,3,0,66,42,24,60,0,0
179,18/05/2021,3,1,91,49,42,59,0,0
19,21/05/2021,3,1,93,37,56,56,0,0
859,19/05/2021,3,1,84,10,74,49,0,0
406,21/05/2021,3,1,38,33,5,109,0,0
804,21/05/2021,3,3,142,86,56,49,0,0
827,14/05/2021,3,1,69,45,24,60,0,0
595,20/05/2021,3,2,48,17,31,49,0,0
840,13/05/2021,3,0,312,96,216,49,0,0
680,12/05/2021,3,3,77,17,60,49,0,0
336,14/05/2021,3,0,74,28,46,49,0,0
573,15/05/2021,3,0,57,18,39,49,0,0
351,15/05/2021,3,1,65,31,34,49,0,0
698,22/05/2021,3,3,113,95,18,98,0,0
585,24/05/2021,3,2,58,52,6,93,0,0
68,22/05/2021,3,1,115,105,10,67,0,0
682,13/05/2021,3,2,78,32,46,49,0,0
59,12/05/2021,3,0,75,8,67,49,0,0
237,23/05/2021,3,6,115,35,80,49,0,0
754,24/05/2021,3,0,62,19,43,49,0,0
128,19/05/2021,3,1,20,13,7,72,0,0
527,23/05/2021,3,5,56,26,30,49,0,0
137,24/05/2021,3,24,122,33,89,49,0,0
302,15/05/2021,3,0,61,45,16,52,0,0
374,24/05/2021,3,0,56,48,8,57,0,0
278,17/05/2021,3,0,105,16,89,49,0,0
833,19/05/2021,3,0,83,58,25,52,0,0
416,20/05/2021,3,0,34,22,12,52,0,0
720,09/05/2021,3,0,39,5,34,49,0,0
325,23/05/2021,3,0,45,7,38,61,0,0
70,16/05/2021,3,3,36,8,28,49,0,0
149,23/05/2021,3,0,88,46,42,49,0,0
4,27/05/2021,3,1,63,45,18,98,0,0
704,08/05/2021,3,1,31,2,29,49,0,0
1,19/05/2021,3,1,99,60,39,60,0,0
731,19/05/2021,3,6,93,73,20,63,0,0
594,21/05/2021,3,41,66,67,-1,NA,NA,NA
197,19/05/2021,3,0,118,49,69,49,0,0
353,22/05/2021,3,1,51,50,1,95,0,0
654,20/05/2021,3,6,53,19,34,66,0,0
907,24/05/2021,3,3,77,50,27,67,0,0
352,24/05/2021,3,0,64,35,29,60,0,0
190,28/05/2021,3,3,77,74,3,77,0,0
571,14/05/2021,3,0,161,7,154,49,0,0
126,13/05/2021,3,2,118,49,69,49,0,0
219,15/05/2021,3,5,72,4,68,49,0,0
84,20/05/2021,3,0,20,18,2,79,0,0
679,20/05/2021,3,1,88,77,11,82,0,0
921,30/05/2021,3,10,165,11,154,45,0,0
61,05/05/2021,3,1,99,33,66,55,0,0
632,22/05/2021,3,0,82,44,38,55,0,0
434,25/05/2021,3,2,58,51,7,63,0,0
63,24/05/2021,3,7,57,31,26,49,0,0
419,22/05/2021,3,4,106,65,41,100,0,0
438,14/05/2021,3,14,82,20,62,49,0,0
861,19/05/2021,3,0,61,61,0,NA,NA,NA
232,19/05/2021,3,2,63,63,0,90,0,0
722,07/05/2021,3,0,42,13,29,49,0,0
495,05/05/2021,3,2,83,17,66,49,0,0
78,16/05/2021,3,0,44,12,32,49,0,0
570,22/05/2021,3,0,149,132,17,74,0,0
343,20/05/2021,3,1,61,44,17,57,0,0
738,21/05/2021,3,1,123,110,13,67,0,0
859,16/05/2021,3,1,84,8,76,49,0,0
889,21/05/2021,3,1,123,8,115,45,0,0
479,21/05/2021,3,1,54,53,1,85,0,0
208,15/05/2021,3,0,60,8,52,49,0,0
874,21/05/2021,3,1,88,19,69,49,0,0
663,15/05/2021,3,0,148,16,132,49,0,0
661,15/05/2021,3,2,170,14,156,49,0,0
283,15/05/2021,3,0,76,12,64,49,0,0
50,16/05/2021,3,2,119,37,82,49,0,0
773,15/05/2021,3,1,73,24,49,49,0,0
550,22/05/2021,3,1,111,106,5,77,0,0
105,22/05/2021,3,4,71,67,4,85,0,0
662,23/05/2021,3,1,106,78,28,64,0,0
761,13/05/2021,3,0,83,25,58,49,0,0
161,10/05/2021,3,0,61,16,45,55,0,0
237,24/05/2021,3,6,115,40,75,49,0,0
3,26/05/2021,3,8,105,48,57,49,0,0
51,18/05/2021,3,2,78,78,0,NA,NA,NA
433,23/05/2021,3,1,317,113,204,80,0,0
538,21/05/2021,3,1,43,30,13,60,0,0
367,12/05/2021,3,0,74,15,59,55,0,0
91,24/05/2021,3,1,79,58,21,57,0,0
710,17/05/2021,3,0,20,17,3,67,0,0
300,19/05/2021,3,0,210,134,76,52,0,0
666,20/05/2021,3,2,64,41,23,52,0,0
726,09/05/2021,3,0,39,10,29,49,0,0
364,23/05/2021,3,2,128,86,42,89,0,0
614,14/05/2021,3,2,80,14,66,49,0,0
27,22/05/2021,3,0,78,64,14,133,0,0
57,28/05/2021,3,1,139,124,15,74,0,0
704,09/05/2021,3,1,31,1,30,49,0,0
514,19/05/2021,3,6,228,69,159,49,0,0
634,19/05/2021,3,0,20,20,0,NA,NA,NA
617,20/05/2021,3,2,42,42,0,NA,NA,NA
659,21/05/2021,3,2,41,39,2,93,0,0
555,21/05/2021,3,0,117,95,22,68,0,0
462,20/05/2021,3,7,182,15,167,55,0,0
43,22/05/2021,3,2,71,58,13,84,0,0
598,24/05/2021,3,0,146,136,10,94,0,0
778,28/05/2021,3,2,79,69,10,105,0,0
571,15/05/2021,3,0,161,10,151,49,0,0
510,13/05/2021,3,2,141,12,129,49,0,0
77,16/05/2021,3,2,101,18,83,49,0,0
886,20/05/2021,3,6,146,79,67,49,0,0
476,19/05/2021,3,0,173,44,129,49,0,0
339,29/05/2021,3,15,579,203,376,49,0,0
842,07/05/2021,3,1,90,44,46,59,0,0
918,22/05/2021,3,0,201,17,184,39,0,0
32,25/05/2021,3,1,104,79,25,128,0,0
812,25/05/2021,3,3,134,61,73,49,0,0
592,22/05/2021,3,1,83,82,1,110,0,0
308,15/05/2021,3,2,46,7,39,49,0,0
452,19/05/2021,3,3,57,42,15,67,0,0
480,17/05/2021,3,0,28,28,0,NA,NA,NA
793,07/05/2021,3,1,130,13,117,49,0,0
82,08/05/2021,3,0,96,38,58,49,0,0
210,15/05/2021,3,2,100,88,12,57,0,0
895,21/05/2021,3,0,69,56,13,67,0,0
201,19/05/2021,3,3,135,77,58,49,0,0
19,20/05/2021,3,1,93,67,26,52,0,0
97,18/05/2021,3,5,102,77,25,80,0,0
702,21/05/2021,3,1,49,35,14,60,0,0
264,22/05/2021,3,3,57,23,34,55,0,0
21,14/05/2021,3,1,59,10,49,49,0,0
595,21/05/2021,3,2,48,25,23,53,0,0
663,17/05/2021,3,0,148,25,123,49,0,0
680,16/05/2021,3,3,77,31,46,49,0,0
503,15/05/2021,3,0,184,7,177,49,0,0
801,17/05/2021,3,7,160,43,117,49,0,0
606,16/05/2021,3,1,45,4,41,49,0,0
301,23/05/2021,3,1,100,20,80,49,0,0
166,22/05/2021,3,3,63,60,3,160,0,0
115,22/05/2021,3,0,115,55,60,55,0,0
682,14/05/2021,3,2,78,20,58,49,0,0
473,10/05/2021,3,1,49,30,19,60,0,0
628,25/05/2021,3,2,57,35,22,80,0,0
760,26/05/2021,3,1,35,15,20,49,0,0
213,18/05/2021,3,3,145,116,29,57,0,0
529,24/05/2021,3,3,38,30,8,62,0,0
575,23/05/2021,3,1,49,22,27,49,0,0
302,12/05/2021,3,0,61,32,29,49,0,0
631,24/05/2021,3,1,70,44,26,59,0,0
278,16/05/2021,3,0,105,9,96,49,0,0
300,20/05/2021,3,0,210,130,80,52,0,0
784,20/05/2021,3,3,46,45,1,63,0,0
726,11/05/2021,3,0,39,37,2,123,0,0
734,23/05/2021,3,1,60,33,27,49,0,0
780,16/05/2021,3,2,58,21,37,49,0,0
149,22/05/2021,3,0,88,85,3,77,0,0
560,26/05/2021,3,0,80,55,25,90,0,0
826,08/05/2021,3,2,96,25,71,49,0,0
660,19/05/2021,3,6,180,33,147,49,0,0
216,18/05/2021,3,1,57,44,13,62,0,0
755,21/05/2021,3,0,87,71,16,138,0,0
270,19/05/2021,3,1,59,42,17,72,0,0
448,22/05/2021,3,1,152,70,82,110,0,0
56,21/05/2021,3,3,62,46,16,60,0,0
360,24/05/2021,3,2,42,18,24,60,0,0
136,24/05/2021,3,0,128,79,49,67,0,0
593,27/05/2021,3,26,55,46,9,189,0,0
571,16/05/2021,3,0,161,3,158,49,0,0
543,13/05/2021,3,1,64,22,42,49,0,0
219,16/05/2021,3,5,72,1,71,49,0,0
626,20/05/2021,3,2,100,74,26,67,0,0
679,19/05/2021,3,2,87,80,7,89,0,0
339,30/05/2021,3,13,581,187,394,49,0,0
289,06/05/2021,3,1,67,25,42,49,0,0
418,21/05/2021,3,0,116,27,89,55,0,0
314,26/05/2021,3,1,68,58,10,77,0,0
513,27/05/2021,3,2,75,44,31,49,0,0
20,23/05/2021,3,1,81,50,31,53,0,0
403,16/05/2021,3,2,96,4,92,49,0,0
426,18/05/2021,3,10,153,100,53,60,0,0
232,17/05/2021,3,2,63,61,2,85,0,0
775,09/05/2021,3,2,107,17,90,49,0,0
328,08/05/2021,3,1,97,23,74,49,0,0
212,16/05/2021,3,2,76,53,23,64,0,0
696,22/05/2021,3,0,89,57,32,55,0,0
201,18/05/2021,3,3,135,77,58,49,0,0
88,20/05/2021,3,1,41,39,2,79,0,0
870,18/05/2021,3,5,41,39,2,79,0,0
558,21/05/2021,3,0,44,24,20,55,0,0
804,22/05/2021,3,3,142,125,17,67,0,0
31,15/05/2021,3,1,62,13,49,49,0,0
532,18/05/2021,3,0,84,82,2,90,0,0
840,17/05/2021,3,0,312,67,245,49,0,0
260,14/05/2021,3,1,119,19,100,49,0,0
283,16/05/2021,3,0,76,16,60,49,0,0
849,17/05/2021,3,1,83,42,41,49,0,0
773,16/05/2021,3,1,73,16,57,49,0,0
808,23/05/2021,3,1,167,71,96,49,0,0
585,22/05/2021,3,2,58,57,1,143,0,0
135,20/05/2021,3,4,62,38,24,67,0,0
471,14/05/2021,3,6,114,44,70,49,0,0
443,12/05/2021,3,5,85,37,48,55,0,0
528,25/05/2021,3,0,119,103,16,95,0,0
72,25/05/2021,3,2,58,57,1,83,0,0
51,20/05/2021,3,2,78,63,15,74,0,0
390,23/05/2021,3,2,134,41,93,49,0,0
373,24/05/2021,3,1,102,76,26,60,0,0
693,15/05/2021,3,0,125,7,118,49,0,0
374,25/05/2021,3,1,55,47,8,80,0,0
370,16/05/2021,3,0,40,6,34,49,0,0
557,21/05/2021,3,0,104,71,33,60,0,0
790,20/05/2021,3,1,98,71,27,68,0,0
315,07/05/2021,3,0,62,31,31,55,0,0
230,23/05/2021,3,0,80,9,71,49,0,0
70,14/05/2021,3,2,37,12,25,49,0,0
794,22/05/2021,3,0,137,48,89,95,0,0
657,26/05/2021,3,0,48,32,16,122,0,0
221,11/05/2021,3,0,62,28,34,55,0,0
514,20/05/2021,3,4,230,76,154,49,0,0
369,18/05/2021,3,1,89,48,41,60,0,0
183,19/05/2021,3,0,80,58,22,59,0,0
659,19/05/2021,3,1,42,29,13,67,0,0
591,21/05/2021,3,0,68,57,11,67,0,0
247,22/05/2021,3,2,91,77,14,67,0,0
79,22/05/2021,3,1,45,38,7,130,0,0
714,24/05/2021,3,0,59,26,33,55,0,0
190,26/05/2021,3,5,75,47,28,57,0,0
776,16/05/2021,3,0,104,9,95,49,0,0
126,14/05/2021,3,2,118,26,92,49,0,0
887,16/05/2021,3,19,304,11,293,39,0,0
76,21/05/2021,3,1,92,85,7,83,0,0
668,20/05/2021,3,4,299,53,246,49,0,0
490,30/05/2021,3,7,158,71,87,49,0,0
144,06/05/2021,3,1,98,21,77,49,0,0
918,21/05/2021,3,0,201,18,183,39,0,0
855,25/05/2021,3,6,170,83,87,49,0,0
317,25/05/2021,3,0,80,74,6,90,0,0
20,22/05/2021,3,2,80,50,30,91,0,0
764,14/05/2021,3,2,67,6,61,49,0,0
326,19/05/2021,3,2,79,53,26,60,0,0
860,18/05/2021,3,10,82,54,28,52,0,0
602,10/05/2021,3,0,64,30,34,49,0,0
495,08/05/2021,3,2,83,7,76,49,0,0
212,17/05/2021,3,2,76,57,19,72,0,0
238,22/05/2021,3,0,66,53,13,67,0,0
414,18/05/2021,3,21,165,96,69,49,0,0
99,20/05/2021,3,1,166,145,21,57,0,0
499,18/05/2021,3,0,31,11,20,52,0,0
175,21/05/2021,3,6,114,68,46,55,0,0
112,21/05/2021,3,0,84,48,36,55,0,0
363,14/05/2021,3,4,95,66,29,59,0,0
719,20/05/2021,3,0,41,33,8,80,0,0
140,17/05/2021,3,1,169,131,38,57,0,0
24,16/05/2021,3,1,83,28,55,49,0,0
377,16/05/2021,3,0,149,27,122,49,0,0
819,15/05/2021,3,0,80,77,3,63,0,0
291,17/05/2021,3,1,60,28,32,49,0,0
181,22/05/2021,3,0,34,32,2,67,0,0
798,24/05/2021,3,1,80,65,15,94,0,0
662,20/05/2021,3,1,106,98,8,63,0,0
268,15/05/2021,3,1,77,29,48,49,0,0
195,11/05/2021,3,1,50,16,34,52,0,0
786,15/05/2021,3,2,60,5,55,49,0,0
642,26/05/2021,3,2,93,75,18,62,0,0
684,18/05/2021,3,2,96,64,32,52,0,0
142,25/05/2021,3,1,61,60,1,98,0,0
575,24/05/2021,3,1,49,39,10,55,0,0
302,13/05/2021,3,0,61,36,25,49,0,0
435,25/05/2021,3,50,70,53,17,59,0,0
100,16/05/2021,3,77,147,14,133,49,0,0
853,18/05/2021,3,1,101,71,30,60,0,0
296,19/05/2021,3,3,57,39,18,67,0,0
747,07/05/2021,3,0,64,18,46,49,0,0
118,23/05/2021,3,2,57,17,40,49,0,0
711,12/05/2021,3,1,88,51,37,64,0,0
90,23/05/2021,3,0,78,34,44,49,0,0
560,28/05/2021,3,0,80,64,16,81,0,0
879,07/05/2021,3,3,161,7,154,39,0,0
265,20/05/2021,3,1,56,25,31,49,0,0
511,17/05/2021,3,1,75,49,26,57,0,0
848,19/05/2021,3,6,132,27,105,35,0,0
270,20/05/2021,3,1,59,55,4,82,0,0
119,21/05/2021,3,2,66,36,30,55,0,0
350,22/05/2021,3,2,58,55,3,123,0,0
114,24/05/2021,3,1,74,73,1,130,0,0
431,23/05/2021,3,4,126,78,48,55,0,0
151,27/05/2021,3,6,70,50,20,72,0,0
776,14/05/2021,3,0,104,12,92,49,0,0
582,14/05/2021,3,0,53,23,30,49,0,0
887,12/05/2021,3,17,306,12,294,39,0,0
180,20/05/2021,3,0,41,28,13,52,0,0
5,20/05/2021,3,5,84,40,44,55,0,0
53,29/05/2021,3,0,70,70,0,NA,NA,NA
842,06/05/2021,3,1,90,37,53,49,0,0
60,21/05/2021,3,0,57,39,18,60,0,0
831,25/05/2021,3,0,150,49,101,49,0,0
345,26/05/2021,3,0,101,90,11,85,0,0
130,23/05/2021,3,3,78,45,33,60,0,0
764,16/05/2021,3,2,67,18,49,49,0,0
426,19/05/2021,3,10,153,94,59,60,0,0
120,19/05/2021,3,2,152,104,48,72,0,0
793,11/05/2021,3,1,130,33,97,49,0,0
82,09/05/2021,3,0,96,30,66,49,0,0
304,17/05/2021,3,2,58,34,24,52,0,0
380,22/05/2021,3,0,160,130,30,67,0,0
414,19/05/2021,3,21,165,103,62,49,0,0
101,20/05/2021,3,1,59,44,15,52,0,0
656,19/05/2021,3,0,115,111,4,65,0,0
586,20/05/2021,3,4,79,69,10,80,0,0
104,21/05/2021,3,1,61,55,6,73,0,0
214,14/05/2021,3,4,82,28,54,49,0,0
719,21/05/2021,3,0,41,34,7,84,0,0
453,17/05/2021,3,2,136,82,54,60,0,0
651,16/05/2021,3,1,77,6,71,49,0,0
36,14/05/2021,3,1,62,9,53,49,0,0
470,12/05/2021,3,2,78,77,1,59,0,0
645,17/05/2021,3,3,38,25,13,60,0,0
808,22/05/2021,3,0,168,167,1,122,0,0
105,24/05/2021,3,5,70,53,17,82,0,0
68,21/05/2021,3,1,115,42,73,55,0,0
303,16/05/2021,3,1,64,28,36,49,0,0
244,12/05/2021,3,0,200,69,131,49,0,0
478,15/05/2021,3,6,14,13,1,74,0,0
813,24/05/2021,3,1,129,118,11,62,0,0
417,19/05/2021,3,0,103,74,29,57,0,0
394,18/05/2021,3,1,67,39,28,57,0,0
373,22/05/2021,3,1,102,89,13,74,0,0
367,13/05/2021,3,0,74,25,49,55,0,0
91,26/05/2021,3,2,78,48,30,60,0,0
71,16/05/2021,3,1,61,14,47,49,0,0
348,20/05/2021,3,5,135,107,28,57,0,0
239,19/05/2021,3,0,40,34,6,72,0,0
169,08/05/2021,3,0,20,3,17,49,0,0
118,22/05/2021,3,2,57,29,28,55,0,0
424,12/05/2021,3,1,27,20,7,85,0,0
524,22/05/2021,3,1,109,87,22,67,0,0
4,28/05/2021,3,1,63,63,0,NA,NA,NA
47,10/05/2021,3,2,55,43,12,80,0,0
660,20/05/2021,3,6,180,45,135,49,0,0
703,17/05/2021,3,1,90,71,19,67,0,0
917,19/05/2021,3,1,105,20,85,35,0,0
674,21/05/2021,3,1,97,61,36,60,0,0
353,21/05/2021,3,1,51,51,0,NA,NA,NA
654,22/05/2021,3,6,53,35,18,114,0,0
217,24/05/2021,3,1,40,33,7,57,0,0
110,24/05/2021,3,1,86,80,6,62,0,0
131,18/05/2021,3,3,46,18,28,57,0,0
42,14/05/2021,3,3,96,17,79,49,0,0
102,15/05/2021,3,0,60,20,40,49,0,0
215,12/05/2021,3,0,46,26,20,59,0,0
206,21/05/2021,3,16,197,55,142,59,0,0
290,18/05/2021,3,2,105,73,32,55,0,0
486,29/05/2021,3,1,123,123,0,NA,NA,NA
124,06/05/2021,3,2,52,27,25,55,0,0
418,22/05/2021,3,0,116,30,86,55,0,0
32,17/05/2021,3,1,104,104,0,NA,NA,NA
26,25/05/2021,3,2,64,30,34,72,0,0
781,23/05/2021,3,2,81,68,13,59,0,0
403,14/05/2021,3,2,96,14,82,49,0,0
127,19/05/2021,3,1,59,37,22,64,0,0
860,19/05/2021,3,10,82,62,20,57,0,0
671,07/05/2021,3,2,63,61,2,80,0,0
288,09/05/2021,3,0,60,19,41,49,0,0
330,14/05/2021,3,2,117,14,103,49,0,0
696,21/05/2021,3,1,88,46,42,55,0,0
562,19/05/2021,3,1,67,38,29,49,0,0
738,20/05/2021,3,1,123,119,4,79,0,0
656,17/05/2021,3,0,115,100,15,62,0,0
613,20/05/2021,3,0,56,37,19,52,0,0
104,22/05/2021,3,1,61,60,1,90,0,0
225,14/05/2021,3,11,69,4,65,49,0,0
532,16/05/2021,3,0,84,26,58,49,0,0
453,18/05/2021,3,3,135,85,50,67,0,0
421,16/05/2021,3,0,19,16,3,65,0,0
503,14/05/2021,3,1,183,6,177,49,0,0
379,13/05/2021,3,3,284,90,194,66,0,0
388,15/05/2021,3,1,59,9,50,49,0,0
716,22/05/2021,3,0,104,94,10,79,0,0
157,24/05/2021,3,1,82,68,14,82,0,0
756,23/05/2021,3,0,106,94,12,108,0,0
546,17/05/2021,3,12,140,28,112,49,0,0
443,10/05/2021,3,6,84,36,48,49,0,0
237,16/05/2021,3,4,117,20,97,49,0,0
72,24/05/2021,3,2,58,38,20,57,0,0
252,18/05/2021,3,1,263,140,123,49,0,0
167,19/05/2021,3,1,83,76,7,90,0,0
113,24/05/2021,3,1,31,15,16,52,0,0
908,15/05/2021,3,0,136,3,133,55,0,0
631,25/05/2021,3,1,70,53,17,64,0,0
852,17/05/2021,3,0,80,73,7,75,0,0
768,20/05/2021,3,5,82,68,14,57,0,0
882,19/05/2021,3,0,130,44,86,39,0,0
169,10/05/2021,3,0,20,14,6,64,0,0
49,22/05/2021,3,2,146,52,94,55,0,0
424,13/05/2021,3,1,27,16,11,60,0,0
229,23/05/2021,3,5,51,39,12,72,0,0
525,27/05/2021,3,1,74,74,0,NA,NA,NA
47,11/05/2021,3,2,55,43,12,89,0,0
660,22/05/2021,3,6,180,60,120,49,0,0
233,17/05/2021,3,3,64,47,17,62,0,0
183,20/05/2021,3,1,79,53,26,64,0,0
919,21/05/2021,3,0,123,104,19,67,0,0
809,22/05/2021,3,3,98,98,0,NA,NA,NA
825,22/05/2021,3,5,141,108,33,117,0,0
637,24/05/2021,3,1,73,54,19,130,0,0
362,24/05/2021,3,3,117,103,14,82,0,0
151,18/05/2021,3,5,71,51,20,84,0,0
413,14/05/2021,3,1,115,20,95,49,0,0
134,15/05/2021,3,1,47,20,27,49,0,0
75,12/05/2021,3,0,81,15,66,49,0,0
285,21/05/2021,3,1,79,61,18,67,0,0
668,18/05/2021,3,4,299,24,275,49,0,0
410,23/05/2021,3,0,56,22,34,49,0,0
30,05/05/2021,3,1,70,47,23,67,0,0
918,12/05/2021,3,0,201,17,184,39,0,0
257,18/05/2021,3,2,42,42,0,NA,NA,NA
810,27/05/2021,3,6,383,40,343,75,0,0
789,23/05/2021,3,0,72,45,27,67,0,0
603,16/05/2021,3,2,82,10,72,49,0,0
481,19/05/2021,3,0,56,27,29,55,0,0
274,17/05/2021,3,2,208,50,158,39,0,0
41,10/05/2021,3,2,82,56,26,60,0,0
261,05/05/2021,3,3,99,39,60,49,0,0
338,15/05/2021,3,3,397,93,304,49,0,0
423,22/05/2021,3,1,49,42,7,74,0,0
494,20/05/2021,3,3,136,76,60,49,0,0
466,20/05/2021,3,0,140,48,92,49,0,0
733,18/05/2021,3,0,100,32,68,49,0,0
883,20/05/2021,3,6,98,18,80,45,0,0
112,22/05/2021,3,0,84,63,21,67,0,0
214,15/05/2021,3,4,82,23,59,49,0,0
874,17/05/2021,3,2,87,4,83,49,0,0
453,13/05/2021,3,4,134,83,51,55,0,0
517,14/05/2021,3,0,58,25,33,49,0,0
336,15/05/2021,3,1,73,42,31,49,0,0
379,16/05/2021,3,2,285,48,237,66,0,0
81,16/05/2021,3,1,59,5,54,49,0,0
891,23/05/2021,3,1,81,27,54,49,0,0
196,22/05/2021,3,0,138,97,41,55,0,0
129,22/05/2021,3,13,187,154,33,117,0,0
8,14/05/2021,3,1,39,17,22,49,0,0
37,11/05/2021,3,1,80,22,58,49,0,0
478,16/05/2021,3,6,14,7,7,49,0,0
202,24/05/2021,3,0,76,65,11,99,0,0
600,18/05/2021,3,1,49,33,16,59,0,0
467,20/05/2021,3,3,109,14,95,55,0,0
758,22/05/2021,3,0,73,71,2,139,0,0
693,14/05/2021,3,0,125,6,119,49,0,0
631,26/05/2021,3,1,70,49,21,64,0,0
700,15/05/2021,3,5,127,81,46,55,0,0
312,21/05/2021,3,3,94,35,59,69,0,0
666,18/05/2021,3,2,64,40,24,57,0,0
315,11/05/2021,3,0,62,48,14,80,0,0
873,22/05/2021,3,3,98,87,11,72,0,0
424,14/05/2021,3,1,27,9,18,49,0,0
587,22/05/2021,3,2,79,58,21,113,0,0
226,19/05/2021,3,0,47,45,2,95,0,0
879,08/05/2021,3,3,161,5,156,39,0,0
514,22/05/2021,3,2,232,189,43,67,0,0
369,17/05/2021,3,25,65,38,27,55,0,0
519,20/05/2021,3,0,64,57,7,74,0,0
295,19/05/2021,3,3,102,22,80,49,0,0
677,21/05/2021,3,0,40,23,17,55,0,0
251,20/05/2021,3,0,124,69,55,49,0,0
311,24/05/2021,3,0,97,45,52,60,0,0
431,24/05/2021,3,4,126,68,58,64,0,0
190,18/05/2021,3,3,77,42,35,52,0,0
147,15/05/2021,3,1,79,9,70,49,0,0
45,16/05/2021,3,2,154,13,141,49,0,0
544,12/05/2021,3,0,53,10,43,49,0,0
699,21/05/2021,3,1,61,46,15,77,0,0
5,19/05/2021,3,4,85,58,27,67,0,0
830,23/05/2021,3,0,66,37,29,86,0,0
185,06/05/2021,3,3,165,23,142,49,0,0
675,12/05/2021,3,2,54,27,27,60,0,0
277,18/05/2021,3,6,66,33,33,63,0,0
810,24/05/2021,3,0,389,27,362,75,0,0
254,22/05/2021,3,1,77,65,12,74,0,0
438,15/05/2021,3,14,82,21,61,55,0,0
612,19/05/2021,3,1,41,33,8,74,0,0
274,18/05/2021,3,2,208,63,145,39,0,0
41,08/05/2021,3,1,83,16,67,49,0,0
261,07/05/2021,3,3,99,33,66,49,0,0
411,15/05/2021,3,1,184,48,136,49,0,0
187,21/05/2021,3,2,39,31,8,64,0,0
201,20/05/2021,3,3,135,63,72,49,0,0
723,20/05/2021,3,0,81,62,19,57,0,0
656,18/05/2021,3,0,115,117,-2,NA,NA,NA
69,20/05/2021,3,1,59,43,16,52,0,0
535,22/05/2021,3,1,82,77,5,84,0,0
725,15/05/2021,3,0,17,2,15,55,0,0
595,16/05/2021,3,2,48,11,37,49,0,0
655,13/05/2021,3,1,71,34,37,55,0,0
24,15/05/2021,3,0,84,57,27,49,0,0
36,16/05/2021,3,1,62,14,48,49,0,0
379,17/05/2021,3,2,285,123,162,66,0,0
606,17/05/2021,3,1,45,10,35,49,0,0
724,23/05/2021,3,1,85,71,14,107,0,0
7,24/05/2021,3,2,101,30,71,55,0,0
662,22/05/2021,3,2,105,90,15,109,0,0
546,13/05/2021,3,11,141,8,133,49,0,0
59,10/05/2021,3,0,75,10,65,49,0,0
788,16/05/2021,3,2,89,11,78,49,0,0
3,24/05/2021,3,8,105,54,51,49,0,0
252,19/05/2021,3,1,263,129,134,49,0,0
173,18/05/2021,3,2,69,45,24,67,0,0
569,23/05/2021,3,0,120,41,79,49,0,0
367,15/05/2021,3,0,74,4,70,49,0,0
572,24/05/2021,3,0,61,34,27,55,0,0
370,17/05/2021,3,0,40,28,12,57,0,0
312,18/05/2021,3,2,95,34,61,55,0,0
182,20/05/2021,3,2,78,50,28,52,0,0
649,10/05/2021,3,2,62,28,34,59,0,0
234,23/05/2021,3,2,60,21,39,49,0,0
424,16/05/2021,3,1,27,12,15,49,0,0
587,23/05/2021,3,2,79,39,40,55,0,0
67,18/05/2021,3,1,51,23,28,64,0,0
488,07/05/2021,3,3,63,21,42,49,0,0
823,22/05/2021,3,1,60,59,1,96,0,0
583,17/05/2021,3,2,79,63,16,57,0,0
865,21/05/2021,3,1,84,18,66,49,0,0
372,19/05/2021,3,16,76,74,2,127,0,0
231,22/05/2021,3,0,41,40,1,111,0,0
436,22/05/2021,3,2,204,60,144,49,0,0
797,24/05/2021,3,0,67,58,9,133,0,0
647,24/05/2021,3,5,88,68,20,52,0,0
593,18/05/2021,3,4,77,75,2,146,0,0
287,16/05/2021,3,1,122,29,93,49,0,0
510,16/05/2021,3,2,141,12,129,49,0,0
323,13/05/2021,3,0,31,22,9,72,0,0
750,21/05/2021,3,3,109,93,16,96,0,0
107,18/05/2021,3,33,56,40,16,127,0,0
410,22/05/2021,3,0,56,56,0,NA,NA,NA
850,07/05/2021,3,4,79,20,59,49,0,0
752,14/05/2021,3,24,20,1,19,65,0,0
121,18/05/2021,3,1,109,108,1,127,0,0
810,25/05/2021,3,0,389,43,346,80,0,0
419,23/05/2021,3,6,104,42,62,70,0,0
218,14/05/2021,3,3,75,23,52,49,0,0
310,18/05/2021,3,1,71,58,13,67,0,0
274,19/05/2021,3,2,208,60,148,39,0,0
602,07/05/2021,3,0,64,19,45,49,0,0
261,08/05/2021,3,3,99,27,72,49,0,0
330,16/05/2021,3,3,116,19,97,49,0,0
777,21/05/2021,3,2,118,104,14,85,0,0
653,18/05/2021,3,2,113,42,71,49,0,0
868,20/05/2021,3,0,83,65,18,49,0,0
501,17/05/2021,3,26,207,45,162,49,0,0
477,20/05/2021,3,3,117,45,72,49,0,0
248,21/05/2021,3,0,82,36,46,55,0,0
725,14/05/2021,3,0,17,2,15,55,0,0
577,15/05/2021,3,0,78,5,73,49,0,0
453,16/05/2021,3,1,137,30,107,55,0,0
421,12/05/2021,3,0,19,18,1,90,0,0
605,16/05/2021,3,1,159,23,136,49,0,0
847,14/05/2021,3,5,192,42,150,35,0,0
291,15/05/2021,3,1,60,41,19,49,0,0
814,23/05/2021,3,1,67,56,11,69,0,0
298,23/05/2021,3,2,227,48,179,49,0,0
9,20/05/2021,3,0,27,25,2,89,0,0
730,16/05/2021,3,2,73,9,64,49,0,0
37,12/05/2021,3,0,81,25,56,49,0,0
178,15/05/2021,3,1,37,9,28,49,0,0
782,17/05/2021,3,0,20,18,2,127,0,0
321,20/05/2021,3,1,39,17,22,49,0,0
467,18/05/2021,3,2,110,16,94,55,0,0
563,23/05/2021,3,2,68,15,53,49,0,0
302,11/05/2021,3,0,61,29,32,49,0,0
246,15/05/2021,3,1,111,30,81,55,0,0
700,16/05/2021,3,5,127,31,96,49,0,0
312,19/05/2021,3,2,95,56,39,55,0,0
707,19/05/2021,3,1,39,27,12,72,0,0
548,11/05/2021,3,2,89,39,50,55,0,0
49,23/05/2021,3,2,146,31,115,49,0,0
70,15/05/2021,3,1,38,11,27,49,0,0
673,23/05/2021,3,6,117,50,67,49,0,0
806,18/05/2021,3,1,135,112,23,67,0,0
154,09/05/2021,3,6,98,15,83,49,0,0
1,23/05/2021,3,3,97,41,56,49,0,0
685,17/05/2021,3,4,136,100,36,60,0,0
183,21/05/2021,3,1,79,60,19,67,0,0
554,19/05/2021,3,1,41,17,24,49,0,0
555,22/05/2021,3,0,117,89,28,103,0,0
512,20/05/2021,3,1,61,25,36,49,0,0
311,23/05/2021,3,0,97,47,50,49,0,0
832,24/05/2021,3,2,98,37,61,49,0,0
526,18/05/2021,3,1,37,35,2,95,0,0
332,16/05/2021,3,0,40,6,34,49,0,0
743,16/05/2021,3,1,125,15,110,49,0,0
384,16/05/2021,3,0,101,18,83,49,0,0
805,21/05/2021,3,3,110,56,54,55,0,0
559,18/05/2021,3,46,139,96,43,57,0,0
667,23/05/2021,3,0,10,0,10,NA,NA,NA
604,08/05/2021,3,0,82,18,64,49,0,0
60,12/05/2021,3,0,57,38,19,72,0,0
837,16/05/2021,3,2,324,12,312,66,0,0
148,10/05/2021,3,0,25,1,24,49,0,0
779,23/05/2021,3,0,104,44,60,49,0,0
715,14/05/2021,3,5,83,32,51,49,0,0
52,19/05/2021,3,12,130,125,5,89,0,0
854,17/05/2021,3,3,107,31,76,55,0,0
793,10/05/2021,3,0,131,27,104,49,0,0
843,05/05/2021,3,4,62,27,35,49,0,0
411,16/05/2021,3,0,185,33,152,49,0,0
400,22/05/2021,3,2,28,27,1,74,0,0
445,19/05/2021,3,2,167,59,108,49,0,0
334,20/05/2021,3,0,58,41,17,52,0,0
499,16/05/2021,3,0,31,7,24,49,0,0
613,21/05/2021,3,0,56,26,30,57,0,0
899,21/05/2021,3,1,104,98,6,117,0,0
618,14/05/2021,3,18,133,26,107,49,0,0
577,17/05/2021,3,0,78,16,62,49,0,0
840,14/05/2021,3,3,309,96,213,49,0,0
421,15/05/2021,3,0,19,20,-1,NA,NA,NA
405,17/05/2021,3,1,89,37,52,49,0,0
847,16/05/2021,3,5,192,34,158,35,0,0
606,11/05/2021,3,1,45,13,32,49,0,0
55,23/05/2021,3,2,31,8,23,49,0,0
497,24/05/2021,3,4,189,84,105,49,0,0
662,24/05/2021,3,1,106,81,25,63,0,0
22,13/05/2021,3,0,64,51,13,72,0,0
37,10/05/2021,3,1,80,22,58,49,0,0
279,15/05/2021,3,0,57,8,49,49,0,0
204,18/05/2021,3,0,64,6,58,49,0,0
836,20/05/2021,3,3,98,87,11,57,0,0
142,19/05/2021,3,2,60,49,11,80,0,0
430,23/05/2021,3,4,85,46,39,55,0,0
693,01/05/2021,3,5,120,8,112,49,0,0
246,14/05/2021,3,1,111,27,84,49,0,0
171,15/05/2021,3,2,47,9,38,49,0,0
312,20/05/2021,3,2,95,62,33,49,0,0
491,19/05/2021,3,5,174,60,114,49,0,0
297,11/05/2021,3,3,73,42,31,55,0,0
787,22/05/2021,3,3,105,103,2,169,0,0
11,15/05/2021,3,2,82,21,61,49,0,0
721,23/05/2021,3,28,112,93,19,112,0,0
4,19/05/2021,3,1,63,58,5,82,0,0
154,08/05/2021,3,6,98,17,81,49,0,0
823,23/05/2021,3,1,60,40,20,57,0,0
731,17/05/2021,3,5,94,79,15,62,0,0
932,21/05/2021,3,22,85,5,80,45,0,0
85,21/05/2021,3,7,113,112,1,105,0,0
652,21/05/2021,3,1,68,21,47,55,0,0
350,20/05/2021,3,2,58,48,10,57,0,0
217,23/05/2021,3,1,40,26,14,49,0,0
838,24/05/2021,3,3,62,44,18,65,0,0
151,16/05/2021,3,7,69,6,63,49,0,0
589,16/05/2021,3,5,138,35,103,49,0,0
543,14/05/2021,3,1,64,10,54,49,0,0
323,16/05/2021,3,0,31,13,18,49,0,0
857,21/05/2021,3,0,210,147,63,55,0,0
530,19/05/2021,3,1,59,45,14,72,0,0
667,22/05/2021,3,0,10,0,10,NA,NA,NA
850,08/05/2021,3,4,79,19,60,49,0,0
918,14/05/2021,3,0,201,16,185,39,0,0
176,17/05/2021,3,3,97,20,77,49,0,0
148,11/05/2021,3,0,25,3,22,49,0,0
224,23/05/2021,3,1,56,13,43,49,0,0
218,16/05/2021,3,3,75,17,58,49,0,0
275,18/05/2021,3,3,114,84,30,72,0,0
33,18/05/2021,3,2,78,44,34,55,0,0
775,07/05/2021,3,2,107,13,94,49,0,0
495,06/05/2021,3,2,83,13,70,49,0,0
411,17/05/2021,3,1,184,108,76,49,0,0
777,22/05/2021,3,2,118,115,3,110,0,0
445,18/05/2021,3,2,167,58,109,49,0,0
890,21/05/2021,3,0,150,49,101,97,0,0
501,16/05/2021,3,26,207,17,190,49,0,0
93,20/05/2021,3,3,138,102,36,49,0,0
535,15/05/2021,3,1,82,6,76,49,0,0
21,15/05/2021,3,1,59,6,53,49,0,0
577,18/05/2021,3,0,78,20,58,49,0,0
663,13/05/2021,3,2,146,41,105,49,0,0
651,14/05/2021,3,1,77,6,71,49,0,0
468,17/05/2021,3,1,95,33,62,49,0,0
847,17/05/2021,3,4,193,76,117,35,0,0
291,11/05/2021,3,1,60,30,30,49,0,0
98,23/05/2021,3,2,93,60,33,57,0,0
774,24/05/2021,3,9,96,53,43,49,0,0
933,24/05/2021,3,90,57,16,41,35,0,0
268,14/05/2021,3,1,77,19,58,49,0,0
95,10/05/2021,3,1,87,26,61,49,0,0
565,15/05/2021,3,0,62,13,49,49,0,0
92,18/05/2021,3,1,121,62,59,49,0,0
138,18/05/2021,3,5,93,57,36,55,0,0
496,18/05/2021,3,1,59,25,34,49,0,0
758,23/05/2021,3,0,73,53,20,74,0,0
536,01/05/2021,3,1,80,47,33,49,0,0
737,14/05/2021,3,2,40,2,38,49,0,0
615,15/05/2021,3,0,71,20,51,49,0,0
348,19/05/2021,3,5,135,118,17,65,0,0
416,18/05/2021,3,0,34,14,20,49,0,0
548,07/05/2021,3,1,90,12,78,49,0,0
284,23/05/2021,3,1,25,7,18,49,0,0
711,13/05/2021,3,1,88,56,32,60,0,0
770,23/05/2021,3,1,34,9,25,49,0,0
211,18/05/2021,3,3,57,44,13,74,0,0
18,07/05/2021,3,3,89,14,75,49,0,0
371,19/05/2021,3,0,36,18,18,59,0,0
233,18/05/2021,3,3,64,44,20,80,0,0
106,20/05/2021,3,1,30,27,3,79,0,0
295,21/05/2021,3,3,102,14,88,55,0,0
687,22/05/2021,3,1,86,68,18,67,0,0
512,22/05/2021,3,1,61,51,10,67,0,0
500,23/05/2021,3,5,74,27,47,49,0,0
439,24/05/2021,3,4,87,24,63,49,0,0
184,18/05/2021,3,0,51,38,13,85,0,0
648,16/05/2021,3,0,64,12,52,49,0,0
126,15/05/2021,3,1,119,38,81,49,0,0
215,15/05/2021,3,0,46,5,41,49,0,0
76,20/05/2021,3,1,92,71,21,52,0,0
174,18/05/2021,3,2,26,11,15,55,0,0
386,22/05/2021,3,3,82,83,-1,NA,NA,NA
842,05/05/2021,3,1,90,39,51,49,0,0
418,12/05/2021,3,0,116,24,92,49,0,0
434,18/05/2021,3,2,58,22,36,49,0,0
148,12/05/2021,3,0,25,2,23,49,0,0
676,23/05/2021,3,1,114,38,76,49,0,0
438,16/05/2021,3,15,81,20,61,55,0,0
326,18/05/2021,3,2,79,56,23,67,0,0
854,18/05/2021,3,6,104,54,50,55,0,0
775,08/05/2021,3,2,107,23,84,49,0,0
843,06/05/2021,3,4,62,28,34,49,0,0
117,17/05/2021,3,1,93,82,11,67,0,0
380,21/05/2021,3,0,160,125,35,57,0,0
653,19/05/2021,3,2,113,32,81,49,0,0
520,20/05/2021,3,0,58,53,5,62,0,0
340,18/05/2021,3,16,118,14,104,49,0,0
406,20/05/2021,3,1,38,35,3,80,0,0
264,13/05/2021,3,2,58,33,25,60,0,0
346,13/05/2021,3,5,115,87,28,60,0,0
874,19/05/2021,3,2,87,7,80,49,0,0
840,15/05/2021,3,2,310,121,189,49,0,0
651,15/05/2021,3,1,77,4,73,49,0,0
503,13/05/2021,3,0,184,10,174,49,0,0
573,13/05/2021,3,0,57,19,38,49,0,0
771,11/05/2021,3,2,28,14,14,49,0,0
337,22/05/2021,3,0,60,50,10,67,0,0
196,13/05/2021,3,0,138,5,133,49,0,0
428,24/05/2021,3,3,89,30,59,55,0,0
447,15/05/2021,3,0,143,32,111,49,0,0
244,10/05/2021,3,0,200,47,153,49,0,0
279,16/05/2021,3,0,57,11,46,49,0,0
464,18/05/2021,3,1,265,35,230,66,0,0
427,18/05/2021,3,6,304,36,268,66,0,0
167,20/05/2021,3,1,83,83,0,NA,NA,NA
872,11/05/2021,3,1,64,64,0,NA,NA,NA
367,01/05/2021,3,2,72,7,65,49,0,0
631,13/05/2021,3,1,70,43,27,59,0,0
122,16/05/2021,3,5,116,29,87,49,0,0
348,21/05/2021,3,5,135,103,32,67,0,0
446,20/05/2021,3,8,125,75,50,49,0,0
871,07/05/2021,3,3,75,18,57,49,0,0
258,23/05/2021,3,1,142,84,58,53,0,0
780,15/05/2021,3,1,59,52,7,57,0,0
159,22/05/2021,3,0,77,63,14,67,0,0
915,18/05/2021,3,5,184,16,168,35,0,0
221,09/05/2021,3,1,61,11,50,49,0,0
111,20/05/2021,3,1,59,54,5,93,0,0
748,18/05/2021,3,7,137,86,51,52,0,0
475,20/05/2021,3,1,98,97,1,71,0,0
376,21/05/2021,3,1,63,37,26,55,0,0
200,21/05/2021,3,5,114,91,23,67,0,0
654,21/05/2021,3,6,53,30,23,95,0,0
293,24/05/2021,3,3,57,26,31,49,0,0
574,24/05/2021,3,12,75,30,45,49,0,0
259,16/05/2021,3,0,60,23,37,49,0,0
361,14/05/2021,3,38,27,7,20,80,0,0
126,16/05/2021,3,2,118,24,94,49,0,0
619,14/05/2021,3,0,101,6,95,49,0,0
143,20/05/2021,3,1,119,115,4,62,0,0
174,19/05/2021,3,2,26,10,16,55,0,0
96,23/05/2021,3,14,55,27,28,49,0,0
61,08/05/2021,3,1,99,10,89,49,0,0
60,14/05/2021,3,0,57,14,43,49,0,0
103,18/05/2021,3,0,161,161,0,NA,NA,NA
26,14/05/2021,3,2,64,8,56,49,0,0
592,18/05/2021,3,3,81,81,0,NA,NA,NA
322,15/05/2021,3,0,100,8,92,49,0,0
452,18/05/2021,3,3,57,41,16,60,0,0
33,19/05/2021,3,3,77,47,30,55,0,0
671,09/05/2021,3,2,63,50,13,72,0,0
843,20/05/2021,3,2,64,49,15,57,0,0
807,17/05/2021,3,1,99,47,52,55,0,0
28,22/05/2021,3,2,126,115,11,80,0,0
445,20/05/2021,3,2,167,60,107,49,0,0
485,20/05/2021,3,0,65,40,25,49,0,0
188,18/05/2021,3,7,114,93,21,62,0,0
558,20/05/2021,3,0,44,23,21,49,0,0
934,14/05/2021,3,50,49,1,48,35,0,0
827,15/05/2021,3,2,68,62,6,72,0,0
44,20/05/2021,3,4,104,105,-1,NA,NA,NA
840,16/05/2021,3,2,310,53,257,49,0,0
24,12/05/2021,3,1,83,61,22,57,0,0
640,13/05/2021,3,0,126,41,85,49,0,0
801,13/05/2021,3,7,160,58,102,49,0,0
81,12/05/2021,3,1,59,15,44,49,0,0
337,23/05/2021,3,0,60,12,48,49,0,0
125,14/05/2021,3,2,34,8,26,49,0,0
616,24/05/2021,3,2,73,55,18,57,0,0
268,29/05/2021,3,1,77,77,0,NA,NA,NA
802,10/05/2021,3,1,64,43,21,59,0,0
735,15/05/2021,3,0,29,2,27,49,0,0
518,18/05/2021,3,1,16,15,1,74,0,0
836,18/05/2021,3,3,98,72,26,52,0,0
816,18/05/2021,3,1,81,81,0,NA,NA,NA
563,14/05/2021,3,2,68,8,60,49,0,0
727,01/05/2021,3,1,74,60,14,62,0,0
91,13/05/2021,3,2,78,27,51,49,0,0
171,17/05/2021,3,2,47,19,28,49,0,0
540,21/05/2021,3,1,81,69,12,67,0,0
491,20/05/2021,3,5,174,78,96,49,0,0
649,08/05/2021,3,3,61,14,47,49,0,0
521,15/05/2021,3,1,54,5,49,49,0,0
780,12/05/2021,3,1,59,39,20,52,0,0
164,22/05/2021,3,0,62,38,24,119,0,0
915,19/05/2021,3,7,182,21,161,35,0,0
765,28/05/2021,3,0,101,90,11,97,0,0
1,27/05/2021,3,2,98,48,50,55,0,0
634,22/05/2021,3,0,20,19,1,82,0,0
193,21/05/2021,3,1,107,34,73,55,0,0
270,16/05/2021,3,2,58,17,41,49,0,0
608,23/05/2021,3,10,130,27,103,49,0,0
253,22/05/2021,3,1,57,54,3,77,0,0
783,23/05/2021,3,1,79,37,42,49,0,0
506,24/05/2021,3,2,193,45,148,49,0,0
271,16/05/2021,3,0,70,11,59,49,0,0
153,26/05/2021,3,3,61,48,13,77,0,0
102,14/05/2021,3,0,60,21,39,49,0,0
215,14/05/2021,3,0,46,2,44,49,0,0
34,20/05/2021,3,2,86,57,29,55,0,0
174,25/05/2021,3,2,26,19,7,55,0,0
203,23/05/2021,3,1,39,13,26,49,0,0
124,10/05/2021,3,1,53,27,26,55,0,0
383,12/05/2021,3,4,81,43,38,59,0,0
314,16/05/2021,3,2,67,20,47,49,0,0
678,13/05/2021,3,0,44,0,44,NA,NA,NA
867,19/05/2021,3,1,59,59,0,NA,NA,NA
715,22/05/2021,3,1,87,46,41,130,0,0
222,19/05/2021,3,0,77,36,41,49,0,0
854,19/05/2021,3,4,106,41,65,55,0,0
775,10/05/2021,3,2,107,36,71,49,0,0
328,17/05/2021,3,2,96,44,52,59,0,0
902,26/05/2021,3,3,123,97,26,57,0,0
276,22/05/2021,3,1,203,57,146,49,0,0
414,23/05/2021,3,21,165,102,63,49,0,0
466,21/05/2021,3,0,140,61,79,49,0,0
97,19/05/2021,3,5,102,80,22,80,0,0
477,30/05/2021,3,4,116,30,86,49,0,0
934,15/05/2021,3,75,24,1,23,35,0,0
483,20/05/2021,3,4,95,58,37,49,0,0
595,28/05/2021,3,3,47,34,13,64,0,0
840,27/05/2021,3,3,309,124,185,49,0,0
517,12/05/2021,3,1,57,32,25,57,0,0
377,14/05/2021,3,0,149,25,124,49,0,0
849,26/05/2021,3,0,84,40,44,49,0,0
606,12/05/2021,3,1,45,14,31,49,0,0
911,23/05/2021,3,0,158,29,129,49,0,0
774,14/05/2021,3,6,99,11,88,49,0,0
9,23/05/2021,3,0,27,17,10,61,0,0
268,30/05/2021,3,1,77,77,0,NA,NA,NA
95,11/05/2021,3,1,87,44,43,55,0,0
735,16/05/2021,3,0,29,2,27,49,0,0
760,18/05/2021,3,3,33,23,10,57,0,0
128,18/05/2021,3,1,20,17,3,85,0,0
816,19/05/2021,3,1,81,81,0,NA,NA,NA
137,14/05/2021,3,24,122,27,95,49,0,0
727,05/05/2021,3,1,74,30,44,55,0,0
246,13/05/2021,3,1,111,26,85,49,0,0
71,23/05/2021,3,0,62,17,45,49,0,0
312,27/05/2021,3,2,95,85,10,62,0,0
522,18/05/2021,3,5,57,43,14,57,0,0
871,09/05/2021,3,3,75,25,50,49,0,0
284,21/05/2021,3,1,25,23,2,74,0,0
614,12/05/2021,3,2,80,49,31,60,0,0
794,23/05/2021,3,0,137,32,105,65,0,0
57,18/05/2021,3,1,139,61,78,49,0,0
221,28/05/2021,3,1,61,47,14,81,0,0
514,27/05/2021,3,4,230,56,174,49,0,0
263,24/05/2021,3,0,66,27,39,49,0,0
848,20/05/2021,3,6,132,28,104,35,0,0
665,16/05/2021,3,3,103,16,87,49,0,0
46,23/05/2021,3,5,55,28,27,49,0,0
683,21/05/2021,3,1,65,36,29,55,0,0
500,30/05/2021,3,6,73,60,13,57,0,0
439,16/05/2021,3,4,87,2,85,49,0,0
184,16/05/2021,3,0,51,12,39,49,0,0
607,26/05/2021,3,1,74,49,25,67,0,0
102,23/05/2021,3,1,59,40,19,49,0,0
544,15/05/2021,3,0,53,4,49,49,0,0
206,20/05/2021,3,16,197,124,73,59,0,0
174,16/05/2021,3,2,26,0,26,49,0,0
531,23/05/2021,3,1,58,16,42,49,0,0
604,11/05/2021,3,1,81,33,48,55,0,0
658,12/05/2021,3,1,80,28,52,55,0,0
434,16/05/2021,3,2,58,10,48,49,0,0
678,14/05/2021,3,0,44,0,44,NA,NA,NA
20,18/05/2021,3,3,79,72,7,79,0,0
218,22/05/2021,3,3,75,65,10,67,0,0
742,18/05/2021,3,1,73,47,26,57,0,0
108,23/05/2021,3,0,78,15,63,49,0,0
775,11/05/2021,3,2,107,51,56,49,0,0
328,19/05/2021,3,2,96,50,46,59,0,0
902,27/05/2021,3,2,124,105,19,62,0,0
238,24/05/2021,3,0,66,49,17,60,0,0
455,23/05/2021,3,6,245,35,210,70,0,0
738,25/05/2021,3,1,123,78,45,60,0,0
636,19/05/2021,3,2,118,97,21,74,0,0
558,30/05/2021,3,0,44,28,16,49,0,0
408,13/05/2021,3,4,161,8,153,49,0,0
618,20/05/2021,3,9,142,82,60,49,0,0
577,30/05/2021,3,11,67,40,27,49,0,0
840,28/05/2021,3,3,309,185,124,49,0,0
469,12/05/2021,3,4,192,54,138,66,0,0
468,19/05/2021,3,1,95,47,48,49,0,0
801,25/05/2021,3,7,160,42,118,49,0,0
351,14/05/2021,3,1,65,23,42,49,0,0
844,23/05/2021,3,0,61,10,51,60,0,0
7,15/05/2021,3,5,98,14,84,49,0,0
542,28/05/2021,3,3,72,46,26,55,0,0
22,29/05/2021,3,0,64,64,0,NA,NA,NA
37,20/05/2021,3,3,78,54,24,49,0,0
54,15/05/2021,3,1,60,22,38,49,0,0
139,22/05/2021,3,2,57,47,10,77,0,0
266,20/05/2021,3,0,61,60,1,87,0,0
529,18/05/2021,3,3,38,36,2,62,0,0
563,12/05/2021,3,2,68,19,49,55,0,0
302,07/05/2021,3,0,61,40,21,52,0,0
435,13/05/2021,3,81,39,15,24,49,0,0
370,22/05/2021,3,0,40,19,21,108,0,0
312,28/05/2021,3,2,95,71,24,83,0,0
66,27/05/2021,3,1,151,34,117,49,0,0
169,16/05/2021,3,0,20,13,7,52,0,0
521,21/05/2021,3,1,54,47,7,74,0,0
614,13/05/2021,3,2,80,56,24,60,0,0
159,23/05/2021,3,0,77,28,49,49,0,0
152,18/05/2021,3,1,90,45,45,55,0,0
879,30/05/2021,3,4,160,15,145,39,0,0
660,27/05/2021,3,6,180,47,133,49,0,0
511,24/05/2021,3,0,76,49,27,52,0,0
519,26/05/2021,3,0,64,53,11,79,0,0
674,16/05/2021,3,1,97,5,92,49,0,0
133,23/05/2021,3,2,62,13,49,49,0,0
269,21/05/2021,3,0,80,20,60,55,0,0
637,19/05/2021,3,0,74,74,0,NA,NA,NA
136,16/05/2021,3,0,128,21,107,49,0,0
689,16/05/2021,3,0,130,9,121,49,0,0
589,25/05/2021,3,13,130,99,31,55,0,0
199,23/05/2021,3,1,81,40,41,49,0,0
77,12/05/2021,3,2,101,29,72,49,0,0
285,24/05/2021,3,1,79,47,32,55,0,0
5,15/05/2021,3,5,84,26,58,49,0,0
386,23/05/2021,3,2,83,29,54,49,0,0
842,12/05/2021,3,1,90,58,32,52,0,0
383,13/05/2021,3,4,81,48,33,59,0,0
121,17/05/2021,3,1,109,109,0,NA,NA,NA
678,10/05/2021,3,0,44,0,44,NA,NA,NA
347,19/05/2021,3,23,39,32,7,63,0,0
403,21/05/2021,3,2,96,69,27,84,0,0
227,27/05/2021,3,2,42,29,13,52,0,0
480,23/05/2021,3,0,28,7,21,49,0,0
41,09/05/2021,3,1,83,26,57,49,0,0
495,19/05/2021,3,1,84,43,41,49,0,0
807,25/05/2021,3,2,98,48,50,59,0,0
570,24/05/2021,3,0,149,77,72,49,0,0
414,24/05/2021,3,20,166,94,72,59,0,0
723,25/05/2021,3,1,80,75,5,85,0,0
697,19/05/2021,3,3,106,49,57,55,0,0
883,29/05/2021,3,6,98,10,88,45,0,0
104,14/05/2021,3,1,61,33,28,49,0,0
208,21/05/2021,3,0,60,28,32,55,0,0
876,22/05/2021,3,2,180,91,89,45,0,0
655,28/05/2021,3,0,72,72,0,NA,NA,NA
469,14/05/2021,3,4,192,16,176,66,0,0
36,18/05/2021,3,1,62,28,34,49,0,0
801,28/05/2021,3,7,160,102,58,49,0,0
351,11/05/2021,3,1,65,30,35,67,0,0
814,27/05/2021,3,1,67,55,12,69,0,0
585,13/05/2021,3,2,58,42,16,80,0,0
933,28/05/2021,3,89,58,0,58,35,0,0
546,30/05/2021,3,9,143,143,0,NA,NA,NA
95,20/05/2021,3,0,88,64,24,52,0,0
628,15/05/2021,3,4,55,10,45,49,0,0
422,22/05/2021,3,2,77,60,17,60,0,0
252,24/05/2021,3,2,262,118,144,49,0,0
862,18/05/2021,3,3,107,46,61,49,0,0
575,11/05/2021,3,1,49,28,21,59,0,0
302,09/05/2021,3,0,61,14,47,49,0,0
749,13/05/2021,3,5,149,7,142,49,0,0
753,23/05/2021,3,7,120,89,31,62,0,0
348,28/05/2021,3,9,131,102,29,67,0,0
281,27/05/2021,3,1,82,33,49,49,0,0
315,19/05/2021,3,0,62,48,14,72,0,0
118,20/05/2021,3,2,57,18,39,49,0,0
70,12/05/2021,3,2,37,21,16,52,0,0
736,27/05/2021,3,2,103,78,25,52,0,0
4,18/05/2021,3,1,63,59,4,82,0,0
18,26/05/2021,3,2,90,62,28,74,0,0
371,30/05/2021,3,0,36,34,2,119,0,0
841,22/05/2021,3,0,182,25,157,49,0,0
917,25/05/2021,3,1,105,19,86,35,0,0
307,16/05/2021,3,1,78,13,65,49,0,0
687,23/05/2021,3,2,85,40,45,49,0,0
247,21/05/2021,3,2,91,59,32,55,0,0
333,20/05/2021,3,1,56,56,0,NA,NA,NA
714,16/05/2021,3,0,59,6,53,49,0,0
420,18/05/2021,3,1,68,68,0,NA,NA,NA
17,24/05/2021,3,1,93,76,17,67,0,0
743,23/05/2021,3,1,125,58,67,49,0,0
384,14/05/2021,3,1,100,27,73,49,0,0
294,24/05/2021,3,1,116,51,65,52,0,0
174,15/05/2021,3,2,26,4,22,49,0,0
53,22/05/2021,3,0,70,67,3,144,0,0
289,09/05/2021,3,2,66,18,48,49,0,0
658,13/05/2021,3,1,80,25,55,55,0,0
257,17/05/2021,3,2,42,42,0,NA,NA,NA
678,11/05/2021,3,0,44,0,44,NA,NA,NA
592,19/05/2021,3,2,82,69,13,85,0,0
438,23/05/2021,3,8,88,34,54,55,0,0
452,27/05/2021,3,3,57,47,10,67,0,0
366,22/05/2021,3,2,78,67,11,114,0,0
449,11/05/2021,3,2,93,7,86,66,0,0
454,21/05/2021,3,0,184,64,120,90,0,0
304,26/05/2021,3,0,60,38,22,72,0,0
897,25/05/2021,3,6,102,57,45,60,0,0
201,25/05/2021,3,7,131,77,54,49,0,0
868,25/05/2021,3,0,83,36,47,49,0,0
80,18/05/2021,3,2,123,77,46,52,0,0
93,29/05/2021,3,2,139,130,9,57,0,0
479,14/05/2021,3,1,54,18,36,49,0,0
845,21/05/2021,3,0,120,39,81,55,0,0
876,24/05/2021,3,4,178,59,119,45,0,0
840,29/05/2021,3,3,309,309,0,NA,NA,NA
469,16/05/2021,3,4,192,21,171,66,0,0
405,19/05/2021,3,1,89,37,52,49,0,0
50,27/05/2021,3,2,119,70,49,49,0,0
388,11/05/2021,3,1,59,38,21,60,0,0
913,27/05/2021,3,1,104,13,91,100,0,0
798,14/05/2021,3,1,80,26,54,49,0,0
344,27/05/2021,3,7,58,59,-1,NA,NA,NA
800,30/05/2021,3,2,55,44,11,62,0,0
37,22/05/2021,3,1,80,75,5,74,0,0
54,17/05/2021,3,1,60,59,1,88,0,0
760,22/05/2021,3,2,34,30,4,74,0,0
600,24/05/2021,3,0,50,48,2,49,0,0
433,18/05/2021,3,2,316,82,234,66,0,0
872,12/05/2021,3,1,64,59,5,85,0,0
302,01/05/2021,3,0,61,54,7,57,0,0
435,14/05/2021,3,81,39,7,32,49,0,0
100,21/05/2021,3,77,147,140,7,77,0,0
540,28/05/2021,3,1,81,73,8,67,0,0
446,27/05/2021,3,7,126,66,60,49,0,0
726,16/05/2021,3,0,39,7,32,49,0,0
364,20/05/2021,3,2,128,108,20,72,0,0
638,13/05/2021,3,0,101,46,55,59,0,0
746,27/05/2021,3,1,59,51,8,72,0,0
152,19/05/2021,3,1,90,61,29,67,0,0
765,26/05/2021,3,0,101,61,40,80,0,0
823,30/05/2021,3,1,60,60,0,NA,NA,NA
440,24/05/2021,3,0,265,32,233,85,0,0
865,26/05/2021,3,1,84,47,37,49,0,0
372,16/05/2021,3,16,76,19,57,49,0,0
809,23/05/2021,3,3,98,40,58,49,0,0
350,21/05/2021,3,2,58,57,1,83,0,0
797,19/05/2021,3,0,67,67,0,NA,NA,NA
484,16/05/2021,3,0,40,11,29,49,0,0
365,18/05/2021,3,0,68,68,0,NA,NA,NA
332,25/05/2021,3,0,40,32,8,55,0,0
45,24/05/2021,3,1,155,50,105,49,0,0
323,14/05/2021,3,0,31,8,23,49,0,0
34,24/05/2021,3,4,84,49,35,60,0,0
668,15/05/2021,3,4,299,16,283,49,0,0
327,19/05/2021,3,16,52,51,1,136,0,0
30,09/05/2021,3,1,70,28,42,49,0,0
681,13/05/2021,3,2,69,50,19,55,0,0
103,17/05/2021,3,0,161,145,16,74,0,0
678,12/05/2021,3,0,44,0,44,NA,NA,NA
869,19/05/2021,3,5,55,53,2,93,0,0
764,23/05/2021,3,2,67,30,37,49,0,0
481,25/05/2021,3,0,56,29,27,67,0,0
366,24/05/2021,3,2,78,68,10,113,0,0
671,11/05/2021,3,1,64,63,1,90,0,0
843,19/05/2021,3,2,64,48,16,57,0,0
338,25/05/2021,3,3,397,99,298,49,0,0
238,23/05/2021,3,0,66,28,38,49,0,0
445,25/05/2021,3,2,167,59,108,49,0,0
19,25/05/2021,3,1,93,54,39,62,0,0
355,19/05/2021,3,2,97,59,38,60,0,0
586,29/05/2021,3,4,79,78,1,82,0,0
535,14/05/2021,3,1,82,3,79,49,0,0
31,19/05/2021,3,1,62,44,18,57,0,0
876,25/05/2021,3,9,173,55,118,45,0,0
663,30/05/2021,3,14,134,134,0,NA,NA,NA
425,12/05/2021,3,3,247,39,208,66,0,0
273,20/05/2021,3,0,103,46,57,189,0,0
801,27/05/2021,3,7,160,50,110,49,0,0
773,12/05/2021,3,1,73,58,15,80,0,0
814,26/05/2021,3,1,67,65,2,91,0,0
196,14/05/2021,3,0,138,6,132,49,0,0
9,27/05/2021,3,0,27,27,0,NA,NA,NA
546,29/05/2021,3,10,142,139,3,116,0,0
161,20/05/2021,3,1,60,59,1,79,0,0
628,17/05/2021,3,4,55,28,27,123,0,0
72,23/05/2021,3,2,58,26,32,49,0,0
266,24/05/2021,3,0,61,49,12,67,0,0
527,18/05/2021,3,8,53,47,6,82,0,0
373,12/05/2021,3,1,102,49,53,55,0,0
625,14/05/2021,3,1,160,19,141,49,0,0
615,21/05/2021,3,0,71,51,20,89,0,0
48,27/05/2021,3,11,168,71,97,49,0,0
491,27/05/2021,3,5,174,79,95,49,0,0
726,18/05/2021,3,0,39,32,7,142,0,0
873,20/05/2021,3,4,97,65,32,49,0,0
638,12/05/2021,3,0,101,48,53,59,0,0
587,27/05/2021,3,2,79,58,21,63,0,0
368,19/05/2021,3,1,84,45,39,60,0,0
704,15/05/2021,3,1,31,3,28,49,0,0
265,08/05/2021,3,1,56,11,45,49,0,0
841,23/05/2021,3,0,182,24,158,55,0,0
932,17/05/2021,3,36,71,0,71,45,0,0
627,16/05/2021,3,0,41,10,31,49,0,0
119,23/05/2021,3,2,66,21,45,49,0,0
186,22/05/2021,3,1,57,37,20,55,0,0
566,21/05/2021,3,0,75,75,0,NA,NA,NA
686,16/05/2021,3,0,46,4,42,49,0,0
259,18/05/2021,3,0,60,60,0,NA,NA,NA
147,24/05/2021,3,0,80,46,34,52,0,0
743,24/05/2021,3,1,125,64,61,55,0,0
633,12/05/2021,3,1,49,30,19,60,0,0
220,24/05/2021,3,8,95,58,37,52,0,0
5,16/05/2021,3,5,84,13,71,49,0,0
327,21/05/2021,3,16,52,50,2,126,0,0
144,09/05/2021,3,1,98,10,88,49,0,0
863,13/05/2021,3,6,89,18,71,49,0,0
314,17/05/2021,3,2,67,43,24,57,0,0
146,12/05/2021,3,2,39,22,17,64,0,0
396,18/05/2021,3,1,29,22,7,57,0,0
322,21/05/2021,3,0,100,54,46,55,0,0
861,25/05/2021,3,0,61,43,18,182,0,0
623,23/05/2021,3,0,78,32,46,49,0,0
602,08/05/2021,3,0,64,16,48,49,0,0
82,21/05/2021,3,1,95,73,22,68,0,0
807,27/05/2021,3,2,98,59,39,55,0,0
777,25/05/2021,3,3,117,69,48,67,0,0
358,24/05/2021,3,1,92,71,21,67,0,0
101,26/05/2021,3,1,59,34,25,67,0,0
340,17/05/2021,3,16,118,12,106,49,0,0
406,29/05/2021,3,1,38,38,0,NA,NA,NA
899,15/05/2021,3,7,98,20,78,49,0,0
31,20/05/2021,3,1,62,54,8,57,0,0
876,28/05/2021,3,5,177,60,117,45,0,0
692,12/05/2021,3,0,87,0,87,49,0,0
425,13/05/2021,3,3,247,31,216,66,0,0
13,20/05/2021,3,4,77,67,10,65,0,0
849,27/05/2021,3,0,84,36,48,49,0,0
771,12/05/2021,3,2,28,15,13,62,0,0
891,27/05/2021,3,1,81,74,7,65,0,0
123,15/05/2021,3,0,95,6,89,49,0,0
344,26/05/2021,3,1,64,51,13,63,0,0
22,30/05/2021,3,0,64,51,13,62,0,0
195,23/05/2021,3,1,50,15,35,49,0,0
279,17/05/2021,3,0,57,46,11,55,0,0
642,23/05/2021,3,2,93,26,67,49,0,0
836,24/05/2021,3,0,101,83,18,67,0,0
173,19/05/2021,3,2,69,52,17,74,0,0
569,14/05/2021,3,0,120,16,104,49,0,0
374,15/05/2021,3,0,56,19,37,49,0,0
278,22/05/2021,3,0,105,36,69,49,0,0
397,28/05/2021,3,1,74,50,24,55,0,0
450,27/05/2021,3,3,181,108,73,49,0,0
747,20/05/2021,3,0,64,44,20,72,0,0
539,21/05/2021,3,2,95,67,28,60,0,0
11,12/05/2021,3,1,83,43,40,55,0,0
561,27/05/2021,3,2,58,40,18,52,0,0
560,17/05/2021,3,0,80,63,17,62,0,0
236,12/05/2021,3,2,117,9,108,49,0,0
701,08/05/2021,3,2,60,11,49,49,0,0
440,22/05/2021,3,0,265,61,204,100,0,0
932,18/05/2021,3,36,71,2,69,45,0,0
554,17/05/2021,3,2,40,21,19,52,0,0
652,23/05/2021,3,0,69,19,50,49,0,0
393,20/05/2021,3,1,59,44,15,57,0,0
293,19/05/2021,3,1,59,24,35,49,0,0
110,16/05/2021,3,1,86,10,76,49,0,0
420,17/05/2021,3,15,54,55,-1,NA,NA,NA
648,24/05/2021,3,0,64,58,6,93,0,0
706,25/05/2021,3,1,73,40,33,59,0,0
887,13/05/2021,3,17,306,12,294,39,0,0
750,25/05/2021,3,3,109,70,39,77,0,0
407,17/05/2021,3,1,40,8,32,49,0,0
2,19/05/2021,3,2,57,49,8,93,0,0
604,09/05/2021,3,0,82,21,61,49,0,0
632,14/05/2021,3,0,82,9,73,49,0,0
835,17/05/2021,3,5,99,62,37,55,0,0
26,12/05/2021,3,2,64,29,35,59,0,0
789,19/05/2021,3,0,72,46,26,72,0,0
603,23/05/2021,3,0,84,45,39,60,0,0
772,27/05/2021,3,0,57,49,8,84,0,0
177,23/05/2021,3,0,48,11,37,49,0,0
793,09/05/2021,3,0,131,13,118,49,0,0
328,21/05/2021,3,4,94,80,14,68,0,0
304,12/05/2021,3,2,58,23,35,49,0,0
276,24/05/2021,3,1,203,98,105,49,0,0
179,24/05/2021,3,1,91,39,52,55,0,0
738,26/05/2021,3,1,123,91,32,67,0,0
601,17/05/2021,3,3,65,31,34,49,0,0
558,23/05/2021,3,0,44,11,33,49,0,0
264,15/05/2021,3,0,60,28,32,49,0,0
845,20/05/2021,3,0,120,84,36,52,0,0
876,29/05/2021,3,6,176,75,101,45,0,0
655,07/05/2021,3,0,72,3,69,49,0,0
425,15/05/2021,3,5,245,8,237,66,0,0
13,21/05/2021,3,4,77,51,26,82,0,0
553,02/05/2021,3,4,38,0,38,49,0,0
606,14/05/2021,3,1,45,6,39,49,0,0
337,27/05/2021,3,0,60,36,24,49,0,0
196,15/05/2021,3,0,138,3,135,49,0,0
428,27/05/2021,3,2,90,75,15,67,0,0
8,29/05/2021,3,1,39,40,-1,NA,NA,NA
244,21/05/2021,3,0,200,84,116,55,0,0
528,17/05/2021,3,0,119,89,30,57,0,0
622,23/05/2021,3,5,39,23,16,55,0,0
417,16/05/2021,3,0,103,32,71,49,0,0
496,20/05/2021,3,1,59,36,23,49,0,0
872,10/05/2021,3,1,64,64,0,NA,NA,NA
572,15/05/2021,3,0,61,17,44,49,0,0
71,22/05/2021,3,0,62,45,17,60,0,0
557,28/05/2021,3,0,104,75,29,67,0,0
882,27/05/2021,3,0,130,53,77,39,0,0
169,17/05/2021,3,1,19,19,0,NA,NA,NA
230,20/05/2021,3,0,80,24,56,49,0,0
170,12/05/2021,3,0,105,28,77,55,0,0
770,27/05/2021,3,2,33,29,4,74,0,0
669,17/05/2021,3,0,87,62,25,52,0,0
236,13/05/2021,3,2,117,4,113,49,0,0
701,09/05/2021,3,2,60,3,57,49,0,0
263,23/05/2021,3,0,66,24,42,49,0,0
228,18/05/2021,3,2,40,17,23,49,0,0
659,17/05/2021,3,1,42,14,28,55,0,0
145,23/05/2021,3,2,56,35,21,49,0,0
186,20/05/2021,3,1,57,39,18,52,0,0
114,20/05/2021,3,1,74,67,7,85,0,0
574,17/05/2021,3,12,75,28,47,49,0,0
526,16/05/2021,3,1,37,9,28,49,0,0
864,24/05/2021,3,2,83,41,42,60,0,0
126,22/05/2021,3,3,117,113,4,135,0,0
887,14/05/2021,3,18,305,20,285,39,0,0
886,24/05/2021,3,1,151,82,69,49,0,0
476,15/05/2021,3,1,172,8,164,49,0,0
158,19/05/2021,3,2,22,21,1,89,0,0
185,09/05/2021,3,2,166,19,147,49,0,0
658,14/05/2021,3,0,81,31,50,49,0,0
837,17/05/2021,3,2,324,60,264,66,0,0
812,14/05/2021,3,2,135,20,115,49,0,0
207,18/05/2021,3,2,61,36,25,59,0,0
58,23/05/2021,3,1,66,32,34,49,0,0
452,25/05/2021,3,2,58,32,26,69,0,0
177,22/05/2021,3,0,48,31,17,55,0,0
793,08/05/2021,3,0,131,10,121,49,0,0
495,22/05/2021,3,1,84,58,26,60,0,0
210,11/05/2021,3,2,100,71,29,57,0,0
570,25/05/2021,3,0,149,80,69,49,0,0
343,23/05/2021,3,1,61,15,46,49,0,0
803,26/05/2021,3,1,68,50,18,63,0,0
340,19/05/2021,3,16,118,22,96,49,0,0
586,22/05/2021,3,4,79,79,0,NA,NA,NA
248,15/05/2021,3,0,82,23,59,55,0,0
208,20/05/2021,3,0,60,32,28,55,0,0
876,30/05/2021,3,6,176,44,132,45,0,0
457,07/05/2021,3,2,61,9,52,49,0,0
425,16/05/2021,3,3,247,15,232,66,0,0
36,21/05/2021,3,2,61,40,21,74,0,0
470,04/05/2021,3,1,79,79,0,NA,NA,NA
331,11/05/2021,3,2,92,73,19,82,0,0
844,27/05/2021,3,0,61,22,39,75,0,0
105,13/05/2021,3,12,63,35,28,64,0,0
616,27/05/2021,3,3,72,62,10,57,0,0
447,29/05/2021,3,0,143,144,-1,NA,NA,NA
473,20/05/2021,3,3,47,42,5,77,0,0
565,17/05/2021,3,0,62,40,22,64,0,0
204,22/05/2021,3,0,64,26,38,66,0,0
600,16/05/2021,3,1,49,14,35,49,0,0
527,20/05/2021,3,8,53,49,4,65,0,0
551,10/05/2021,3,0,115,71,44,49,0,0
737,15/05/2021,3,2,40,7,33,49,0,0
89,23/05/2021,3,2,58,14,44,49,0,0
670,28/05/2021,3,0,108,103,5,125,0,0
182,25/05/2021,3,2,78,40,38,49,0,0
726,20/05/2021,3,0,39,39,0,NA,NA,NA
539,20/05/2021,3,2,95,63,32,52,0,0
717,13/05/2021,3,2,191,62,129,55,0,0
229,27/05/2021,3,1,55,37,18,86,0,0
560,18/05/2021,3,0,80,59,21,89,0,0
236,14/05/2021,3,2,117,6,111,49,0,0
701,11/05/2021,3,2,60,28,32,60,0,0
841,24/05/2021,3,0,182,23,159,55,0,0
451,18/05/2021,3,2,81,81,0,NA,NA,NA
372,18/05/2021,3,17,75,75,0,NA,NA,NA
353,23/05/2021,3,1,51,28,23,49,0,0
683,20/05/2021,3,1,65,35,30,49,0,0
217,21/05/2021,3,1,40,25,15,55,0,0
728,17/05/2021,3,1,46,34,12,52,0,0
817,16/05/2021,3,1,82,12,70,49,0,0
571,24/05/2021,3,2,159,24,135,49,0,0
199,22/05/2021,3,2,80,65,15,60,0,0
887,15/05/2021,3,19,304,10,294,39,0,0
84,24/05/2021,3,0,20,20,0,NA,NA,NA
530,15/05/2021,3,1,59,59,0,NA,NA,NA
757,19/05/2021,3,0,117,117,0,NA,NA,NA
850,12/05/2021,3,5,78,39,39,49,0,0
863,12/05/2021,3,6,89,17,72,52,0,0
837,18/05/2021,3,3,323,62,261,66,0,0
240,11/05/2021,3,0,71,47,24,60,0,0
347,18/05/2021,3,23,39,33,6,115,0,0
509,23/05/2021,3,1,111,48,63,49,0,0
310,25/05/2021,3,1,71,57,14,67,0,0
480,22/05/2021,3,0,28,28,0,NA,NA,NA
449,06/05/2021,3,2,93,16,77,66,0,0
495,21/05/2021,3,1,84,37,47,55,0,0
78,12/05/2021,3,0,44,39,5,115,0,0
28,23/05/2021,3,2,126,68,58,49,0,0
494,23/05/2021,3,4,135,35,100,49,0,0
460,18/05/2021,3,10,99,31,68,52,0,0
501,19/05/2021,3,26,207,61,146,49,0,0
492,23/05/2021,3,3,34,21,13,57,0,0
934,13/05/2021,3,26,73,1,72,35,0,0
827,21/05/2021,3,1,69,63,6,97,0,0
595,04/05/2021,3,2,48,17,31,57,0,0
453,08/05/2021,3,2,136,20,116,55,0,0
421,13/05/2021,3,0,19,15,4,80,0,0
405,21/05/2021,3,2,88,16,72,55,0,0
470,05/05/2021,3,1,79,79,0,NA,NA,NA
331,13/05/2021,3,2,92,69,23,72,0,0
911,27/05/2021,3,9,149,16,133,49,0,0
125,13/05/2021,3,2,34,28,6,67,0,0
115,28/05/2021,3,5,110,82,28,67,0,0
303,29/05/2021,3,1,64,64,0,NA,NA,NA
443,22/05/2021,3,6,84,83,1,79,0,0
237,17/05/2021,3,4,117,32,85,49,0,0
754,23/05/2021,3,0,62,17,45,49,0,0
321,17/05/2021,3,1,39,11,28,49,0,0
467,19/05/2021,3,3,109,16,93,55,0,0
839,10/05/2021,3,3,152,51,101,49,0,0
572,14/05/2021,3,0,61,12,49,49,0,0
700,21/05/2021,3,8,124,89,35,71,0,0
851,27/05/2021,3,0,92,38,54,49,0,0
491,25/05/2021,3,7,172,39,133,49,0,0
169,18/05/2021,3,1,19,19,0,NA,NA,NA
364,21/05/2021,3,2,128,86,42,98,0,0
717,12/05/2021,3,3,190,72,118,55,0,0
168,27/05/2021,3,0,48,40,8,72,0,0
211,19/05/2021,3,4,56,41,15,67,0,0
154,14/05/2021,3,4,100,27,73,49,0,0
823,07/05/2021,3,1,60,35,25,52,0,0
440,23/05/2021,3,0,265,31,234,70,0,0
475,18/05/2021,3,1,98,98,0,NA,NA,NA
554,18/05/2021,3,1,41,41,0,NA,NA,NA
200,23/05/2021,3,6,113,65,48,49,0,0
253,20/05/2021,3,1,57,40,17,60,0,0
360,21/05/2021,3,1,43,20,23,49,0,0
584,16/05/2021,3,3,94,15,79,49,0,0
778,18/05/2021,3,1,80,76,4,95,0,0
589,24/05/2021,3,16,127,83,44,57,0,0
412,22/05/2021,3,10,91,56,35,55,0,0
349,12/05/2021,3,1,89,37,52,59,0,0
750,15/05/2021,3,83,29,30,-1,NA,NA,NA
559,17/05/2021,3,46,139,98,41,52,0,0
53,20/05/2021,3,0,70,70,0,NA,NA,NA
61,09/05/2021,3,1,99,14,85,49,0,0
675,13/05/2021,3,1,55,24,31,55,0,0
277,17/05/2021,3,4,68,47,21,57,0,0
345,11/05/2021,3,0,101,87,14,82,0,0
869,18/05/2021,3,5,55,53,2,90,0,0
472,11/05/2021,3,0,234,13,221,66,0,0
275,25/05/2021,3,0,117,112,5,142,0,0
588,22/05/2021,3,0,59,59,0,NA,NA,NA
793,03/05/2021,3,1,130,8,122,49,0,0
843,22/05/2021,3,2,64,54,10,83,0,0
78,13/05/2021,3,0,44,22,22,59,0,0
400,23/05/2021,3,3,27,8,19,49,0,0
414,25/05/2021,3,20,166,78,88,59,0,0
890,18/05/2021,3,67,83,33,50,57,0,0
601,19/05/2021,3,5,63,26,37,49,0,0
477,23/05/2021,3,4,116,21,95,49,0,0
272,14/05/2021,3,1,126,20,106,49,0,0
225,21/05/2021,3,11,69,49,20,80,0,0
719,01/05/2021,3,0,41,11,30,49,0,0
463,09/05/2021,3,1,162,19,143,55,0,0
580,12/05/2021,3,0,98,46,52,55,0,0
336,18/05/2021,3,1,73,69,4,127,0,0
553,01/05/2021,3,4,38,3,35,49,0,0
116,12/05/2021,3,0,61,48,13,72,0,0
844,26/05/2021,3,0,61,22,39,80,0,0
298,15/05/2021,3,2,227,225,2,62,0,0
616,28/05/2021,3,2,73,44,29,55,0,0
471,29/05/2021,3,6,114,114,0,NA,NA,NA
309,21/05/2021,3,0,16,14,2,67,0,0
155,15/05/2021,3,0,93,32,61,49,0,0
92,23/05/2021,3,1,121,44,77,49,0,0
266,17/05/2021,3,0,61,55,6,74,0,0
527,19/05/2021,3,8,53,52,1,123,0,0
137,13/05/2021,3,24,122,17,105,49,0,0
91,14/05/2021,3,2,78,10,68,49,0,0
700,22/05/2021,3,11,121,108,13,98,0,0
300,29/05/2021,3,0,210,142,68,89,0,0
882,26/05/2021,3,0,130,68,62,39,0,0
169,02/05/2021,3,0,20,5,15,49,0,0
230,21/05/2021,3,0,80,47,33,55,0,0
866,12/05/2021,3,0,100,29,71,55,0,0
567,27/05/2021,3,0,61,48,13,67,0,0
226,17/05/2021,3,0,47,40,7,80,0,0
236,15/05/2021,3,2,117,5,112,49,0,0
265,07/05/2021,3,1,56,14,42,49,0,0
216,14/05/2021,3,1,57,17,40,49,0,0
755,18/05/2021,3,0,87,87,0,NA,NA,NA
295,17/05/2021,3,3,102,25,77,49,0,0
507,23/05/2021,3,4,196,51,145,49,0,0
474,20/05/2021,3,0,112,72,40,49,0,0
333,21/05/2021,3,1,56,34,22,114,0,0
110,17/05/2021,3,1,86,53,33,49,0,0
243,16/05/2021,3,1,126,34,92,49,0,0
607,24/05/2021,3,1,74,57,17,60,0,0
126,23/05/2021,3,2,118,46,72,49,0,0
349,13/05/2021,3,1,89,46,43,55,0,0
385,15/05/2021,3,2,61,11,50,49,0,0
821,17/05/2021,3,1,78,77,1,95,0,0
830,20/05/2021,3,0,66,66,0,NA,NA,NA
842,09/05/2021,3,1,90,49,41,49,0,0
60,13/05/2021,3,0,57,44,13,72,0,0
709,17/05/2021,3,0,83,52,31,60,0,0
148,14/05/2021,3,0,25,8,17,49,0,0
629,19/05/2021,3,0,62,39,23,52,0,0
472,12/05/2021,3,0,234,13,221,66,0,0
222,25/05/2021,3,0,77,50,27,62,0,0
623,15/05/2021,3,0,78,9,69,49,0,0
793,04/05/2021,3,1,130,18,112,49,0,0
495,17/05/2021,3,2,83,30,53,49,0,0
330,11/05/2021,3,2,117,31,86,55,0,0
380,24/05/2021,3,4,156,63,93,49,0,0
494,25/05/2021,3,2,137,77,60,52,0,0
101,18/05/2021,3,1,59,50,9,62,0,0
733,19/05/2021,3,1,99,38,61,49,0,0
702,22/05/2021,3,1,49,44,5,79,0,0
479,15/05/2021,3,1,54,18,36,49,0,0
845,19/05/2021,3,1,119,90,29,67,0,0
532,02/05/2021,3,0,84,23,61,49,0,0
140,07/05/2021,3,0,170,39,131,49,0,0
461,12/05/2021,3,0,122,5,117,66,0,0
336,20/05/2021,3,1,73,67,6,127,0,0
801,01/05/2021,3,7,160,20,140,49,0,0
81,13/05/2021,3,1,59,21,38,49,0,0
891,26/05/2021,3,1,81,79,2,79,0,0
123,14/05/2021,3,0,95,7,88,49,0,0
115,27/05/2021,3,5,110,27,83,49,0,0
8,30/05/2021,3,1,39,39,0,NA,NA,NA
443,20/05/2021,3,11,79,55,24,52,0,0
318,16/05/2021,3,0,59,20,39,49,0,0
139,23/05/2021,3,2,57,19,38,49,0,0
128,16/05/2021,3,1,20,4,16,49,0,0
167,18/05/2021,3,2,82,81,1,95,0,0
538,13/05/2021,3,1,43,15,28,49,0,0
91,15/05/2021,3,2,78,12,66,49,0,0
122,23/05/2021,3,3,118,62,56,56,0,0
851,26/05/2021,3,0,92,29,63,49,0,0
182,27/05/2021,3,2,78,36,42,49,0,0
726,02/05/2021,3,0,39,3,36,49,0,0
787,21/05/2021,3,3,105,101,4,117,0,0
638,14/05/2021,3,0,101,47,54,49,0,0
159,27/05/2021,3,0,77,59,18,52,0,0
67,17/05/2021,3,0,52,36,16,64,0,0
236,16/05/2021,3,2,117,3,114,49,0,0
265,09/05/2021,3,1,56,7,49,49,0,0
86,14/05/2021,3,1,47,5,42,49,0,0
183,17/05/2021,3,1,79,59,20,72,0,0
270,18/05/2021,3,1,59,42,17,72,0,0
442,23/05/2021,3,8,150,91,59,49,0,0
393,21/05/2021,3,0,60,54,6,74,0,0
293,21/05/2021,3,3,57,28,29,55,0,0
352,16/05/2021,3,0,64,22,42,49,0,0
131,17/05/2021,3,2,47,18,29,52,0,0
607,25/05/2021,3,1,74,61,13,77,0,0
412,23/05/2021,3,13,88,25,63,49,0,0
384,13/05/2021,3,1,100,54,46,55,0,0
385,16/05/2021,3,2,61,9,52,49,0,0
821,15/05/2021,3,1,78,32,46,49,0,0
203,19/05/2021,3,0,40,18,22,49,0,0
144,10/05/2021,3,1,98,21,77,49,0,0
235,12/05/2021,3,5,152,36,116,49,0,0
314,18/05/2021,3,3,66,54,12,74,0,0
810,10/05/2021,3,0,389,13,376,55,0,0
130,18/05/2021,3,2,79,64,15,65,0,0
579,12/05/2021,3,0,44,10,34,49,0,0
861,27/05/2021,3,0,61,46,15,230,0,0
232,15/05/2021,3,3,62,22,40,49,0,0
602,06/05/2021,3,0,64,18,46,49,0,0
261,18/05/2021,3,3,99,61,38,49,0,0
493,12/05/2021,3,1,34,17,17,52,0,0
570,23/05/2021,3,0,149,45,104,49,0,0
179,25/05/2021,3,1,91,46,45,59,0,0
101,19/05/2021,3,1,59,48,11,65,0,0
610,17/05/2021,3,1,66,40,26,60,0,0
889,22/05/2021,3,1,123,4,119,45,0,0
804,13/05/2021,3,3,142,18,124,49,0,0
664,20/05/2021,3,8,147,99,48,52,0,0
577,04/05/2021,3,0,78,15,63,49,0,0
140,11/05/2021,3,0,170,72,98,49,0,0
578,13/05/2021,3,1,57,25,32,49,0,0
395,18/05/2021,3,1,71,44,27,57,0,0
573,05/05/2021,3,0,57,26,31,55,0,0
291,13/05/2021,3,2,59,31,28,49,0,0
301,26/05/2021,3,1,100,30,70,49,0,0
157,15/05/2021,3,2,81,22,59,49,0,0
129,27/05/2021,3,15,185,94,91,49,0,0
471,30/05/2021,3,6,114,98,16,76,0,0
37,21/05/2021,3,3,78,45,33,55,0,0
458,16/05/2021,3,3,178,41,137,49,0,0
813,23/05/2021,3,1,129,51,78,49,0,0
138,16/05/2021,3,2,96,13,83,49,0,0
12,19/05/2021,3,1,42,31,11,62,0,0
563,13/05/2021,3,2,68,30,38,49,0,0
533,14/05/2021,3,1,90,1,89,49,0,0
852,23/05/2021,3,0,80,42,38,49,0,0
300,27/05/2021,3,0,210,112,98,55,0,0
267,27/05/2021,3,2,81,52,29,49,0,0
726,04/05/2021,3,0,39,38,1,142,0,0
258,21/05/2021,3,1,142,119,23,89,0,0
711,14/05/2021,3,1,88,10,78,49,0,0
746,28/05/2021,3,3,57,55,2,74,0,0
525,17/05/2021,3,1,74,55,19,52,0,0
826,16/05/2021,3,2,96,17,79,49,0,0
371,09/05/2021,3,1,35,18,17,49,0,0
511,14/05/2021,3,1,75,13,62,49,0,0
519,17/05/2021,3,0,64,47,17,60,0,0
376,18/05/2021,3,1,63,55,8,74,0,0
555,23/05/2021,3,0,117,70,47,53,0,0
436,21/05/2021,3,2,204,49,155,49,0,0
824,21/05/2021,3,0,339,52,287,85,0,0
714,17/05/2021,3,0,59,29,30,55,0,0
131,16/05/2021,3,2,47,11,36,49,0,0
589,26/05/2021,3,3,140,125,15,55,0,0
510,22/05/2021,3,1,142,111,31,60,0,0
219,13/05/2021,3,4,73,15,58,49,0,0
285,15/05/2021,3,1,79,12,67,49,0,0
476,17/05/2021,3,0,173,32,141,49,0,0
441,19/05/2021,3,0,168,27,141,55,0,0
144,12/05/2021,3,1,98,32,66,49,0,0
235,13/05/2021,3,6,151,33,118,49,0,0
32,18/05/2021,3,1,104,103,1,95,0,0
810,13/05/2021,3,0,389,9,380,55,0,0
419,19/05/2021,3,2,108,70,38,66,0,0
58,12/05/2021,3,1,66,62,4,88,0,0
481,27/05/2021,3,0,56,27,29,52,0,0
120,14/05/2021,3,2,152,24,128,49,0,0
775,02/05/2021,3,2,107,5,102,49,0,0
495,20/05/2021,3,1,84,27,57,49,0,0
117,11/05/2021,3,1,93,49,44,55,0,0
785,23/05/2021,3,1,109,76,33,74,0,0
358,25/05/2021,3,1,92,68,24,67,0,0
64,19/05/2021,3,3,244,32,212,49,0,0
188,19/05/2021,3,8,113,87,26,62,0,0
69,22/05/2021,3,1,59,53,6,74,0,0
899,14/05/2021,3,7,98,15,83,49,0,0
363,21/05/2021,3,4,95,71,24,107,0,0
719,04/05/2021,3,0,41,14,27,59,0,0
635,12/05/2021,3,0,88,29,59,49,0,0
651,13/05/2021,3,1,77,19,58,49,0,0
599,18/05/2021,3,1,152,135,17,63,0,0
819,04/05/2021,3,0,80,65,15,64,0,0
606,13/05/2021,3,1,45,16,29,49,0,0
313,26/05/2021,3,1,30,22,8,57,0,0
105,15/05/2021,3,3,72,10,62,49,0,0
756,27/05/2021,3,0,106,100,6,112,0,0
730,29/05/2021,3,1,74,69,5,77,0,0
195,20/05/2021,3,1,50,36,14,52,0,0
458,17/05/2021,3,3,178,112,66,49,0,0
202,22/05/2021,3,0,76,76,0,164,0,0
213,16/05/2021,3,3,145,49,96,49,0,0
496,19/05/2021,3,1,59,23,36,49,0,0
839,13/05/2021,3,5,150,58,92,49,0,0
631,14/05/2021,3,1,70,5,65,49,0,0
171,11/05/2021,3,2,47,47,0,NA,NA,NA
300,28/05/2021,3,0,210,123,87,55,0,0
416,27/05/2021,3,0,34,19,15,49,0,0
169,04/05/2021,3,0,20,19,1,180,0,0
49,20/05/2021,3,9,139,37,102,49,0,0
614,15/05/2021,3,1,81,8,73,49,0,0
721,27/05/2021,3,39,101,79,22,139,0,0
806,17/05/2021,3,1,135,120,15,60,0,0
488,12/05/2021,3,3,63,54,9,80,0,0
391,11/05/2021,3,1,75,26,49,49,0,0
86,15/05/2021,3,1,47,5,42,49,0,0
193,17/05/2021,3,1,107,47,60,49,0,0
659,18/05/2021,3,1,42,26,16,67,0,0
792,23/05/2021,3,0,102,99,3,71,0,0
474,21/05/2021,3,0,112,70,42,60,0,0
637,20/05/2021,3,0,74,74,0,NA,NA,NA
686,17/05/2021,3,0,46,22,24,49,0,0
190,16/05/2021,3,4,76,12,64,49,0,0
776,25/05/2021,3,0,104,58,46,52,0,0
543,23/05/2021,3,1,64,47,17,89,0,0
564,12/05/2021,3,3,71,32,39,49,0,0
285,16/05/2021,3,1,79,7,72,49,0,0
5,17/05/2021,3,5,84,60,24,60,0,0
830,19/05/2021,3,0,66,63,3,127,0,0
144,13/05/2021,3,1,98,26,72,49,0,0
418,13/05/2021,3,0,116,23,93,49,0,0
709,18/05/2021,3,0,83,46,37,60,0,0
810,14/05/2021,3,0,389,4,385,55,0,0
781,19/05/2021,3,5,78,49,29,52,0,0
218,11/05/2021,3,2,76,36,40,49,0,0
742,25/05/2021,3,1,73,50,23,62,0,0
854,16/05/2021,3,3,107,10,97,55,0,0
793,05/05/2021,3,0,131,20,111,49,0,0
454,19/05/2021,3,0,184,43,141,66,0,0
807,11/05/2021,3,3,97,37,60,59,0,0
696,25/05/2021,3,1,88,60,28,57,0,0
828,24/05/2021,3,0,75,72,3,100,0,0
890,19/05/2021,3,58,92,43,49,49,0,0
636,18/05/2021,3,2,118,80,38,60,0,0
69,23/05/2021,3,1,59,39,20,52,0,0
804,15/05/2021,3,3,142,42,100,49,0,0
21,21/05/2021,3,1,59,29,30,56,0,0
577,01/05/2021,3,0,78,4,74,49,0,0
463,07/05/2021,3,0,163,21,142,55,0,0
694,13/05/2021,3,1,108,40,68,49,0,0
640,18/05/2021,3,4,122,31,91,49,0,0
847,02/05/2021,3,0,197,20,177,35,0,0
291,14/05/2021,3,2,59,40,19,49,0,0
98,26/05/2021,3,2,93,71,22,85,0,0
774,15/05/2021,3,4,101,9,92,49,0,0
68,27/05/2021,3,1,115,29,86,49,0,0
682,30/05/2021,3,1,79,68,11,63,0,0
195,22/05/2021,3,1,50,45,5,74,0,0
237,15/05/2021,3,4,117,46,71,49,0,0
92,22/05/2021,3,2,120,112,8,67,0,0
252,16/05/2021,3,1,263,44,219,49,0,0
142,18/05/2021,3,2,60,52,8,80,0,0
839,14/05/2021,3,7,148,38,110,49,0,0
533,15/05/2021,3,1,90,2,88,49,0,0
700,11/05/2021,3,5,127,34,93,49,0,0
540,29/05/2021,3,1,81,81,0,NA,NA,NA
790,27/05/2021,3,1,98,55,43,90,0,0
169,05/05/2021,3,0,20,19,1,136,0,0
234,20/05/2021,3,3,59,36,23,49,0,0
705,15/05/2021,3,1,90,10,80,49,0,0
721,28/05/2021,3,15,125,115,10,150,0,0
368,17/05/2021,3,1,84,66,18,52,0,0
879,12/05/2021,3,3,161,4,157,39,0,0
660,11/05/2021,3,6,180,23,157,49,0,0
233,14/05/2021,3,4,63,11,52,49,0,0
865,18/05/2021,3,1,84,21,63,49,0,0
627,18/05/2021,3,0,41,22,19,64,0,0
444,23/05/2021,3,4,115,50,65,49,0,0
474,22/05/2021,3,0,112,109,3,77,0,0
797,20/05/2021,3,0,67,65,2,74,0,0
404,16/05/2021,3,0,67,21,46,49,0,0
420,16/05/2021,3,8,61,25,36,49,0,0
198,24/05/2021,3,0,135,120,15,80,0,0
126,24/05/2021,3,1,119,72,47,57,0,0
564,13/05/2021,3,3,71,33,38,49,0,0
432,16/05/2021,3,0,165,10,155,66,0,0
357,17/05/2021,3,1,82,65,17,67,0,0
441,20/05/2021,3,0,168,26,142,55,0,0
289,13/05/2021,3,1,67,24,43,49,0,0
752,12/05/2021,3,24,20,9,11,79,0,0
835,18/05/2021,3,5,99,82,17,72,0,0
240,13/05/2021,3,1,70,41,29,55,0,0
254,18/05/2021,3,1,77,50,27,67,0,0
603,11/05/2021,3,2,82,29,53,55,0,0
52,25/05/2021,3,7,135,110,25,82,0,0
120,15/05/2021,3,2,152,21,131,49,0,0
775,06/05/2021,3,2,107,18,89,49,0,0
454,22/05/2021,3,0,184,68,116,100,0,0
212,12/05/2021,3,2,76,59,17,72,0,0
785,24/05/2021,3,1,109,82,27,90,0,0
621,23/05/2021,3,0,60,26,34,49,0,0
334,19/05/2021,3,0,58,32,26,60,0,0
870,19/05/2021,3,5,41,30,11,67,0,0
406,22/05/2021,3,1,38,37,1,130,0,0
408,15/05/2021,3,4,161,14,147,49,0,0
483,21/05/2021,3,4,95,75,20,74,0,0
719,03/05/2021,3,0,41,8,33,59,0,0
663,07/05/2021,3,0,148,7,141,49,0,0
578,15/05/2021,3,1,57,13,44,49,0,0
468,18/05/2021,3,1,95,40,55,49,0,0
573,03/05/2021,3,0,57,11,46,49,0,0
331,14/05/2021,3,2,92,22,70,49,0,0
550,26/05/2021,3,2,110,74,36,57,0,0
7,14/05/2021,3,6,97,20,77,49,0,0
428,25/05/2021,3,3,89,39,50,55,0,0
761,29/05/2021,3,1,82,81,1,77,0,0
195,21/05/2021,3,1,50,33,17,55,0,0
318,15/05/2021,3,0,59,11,48,49,0,0
422,23/05/2021,3,1,78,24,54,49,0,0
138,17/05/2021,3,2,96,47,49,49,0,0
209,19/05/2021,3,1,113,63,50,55,0,0
373,14/05/2021,3,1,102,23,79,49,0,0
374,14/05/2021,3,0,56,26,30,49,0,0
89,12/05/2021,3,3,57,25,32,49,0,0
898,30/05/2021,3,2,98,98,0,NA,NA,NA
281,21/05/2021,3,1,82,27,55,55,0,0
169,06/05/2021,3,0,20,19,1,93,0,0
230,14/05/2021,3,0,80,11,69,49,0,0
170,16/05/2021,3,1,104,52,52,49,0,0
794,27/05/2021,3,0,137,34,103,80,0,0
806,19/05/2021,3,1,135,115,20,74,0,0
879,16/05/2021,3,3,161,9,152,39,0,0
660,12/05/2021,3,6,180,23,157,49,0,0
731,14/05/2021,3,7,92,12,80,49,0,0
475,17/05/2021,3,1,98,87,11,62,0,0
639,17/05/2021,3,0,59,8,51,49,0,0
591,23/05/2021,3,0,68,25,43,49,0,0
597,22/05/2021,3,3,98,78,20,67,0,0
311,20/05/2021,3,0,97,72,25,60,0,0
506,16/05/2021,3,0,195,15,180,49,0,0
593,16/05/2021,3,5,76,19,57,49,0,0
413,24/05/2021,3,3,113,81,32,52,0,0
743,25/05/2021,3,1,125,77,48,60,0,0
77,14/05/2021,3,3,100,12,88,49,0,0
180,15/05/2021,3,0,41,10,31,49,0,0
530,17/05/2021,3,1,59,47,12,57,0,0
732,21/05/2021,3,0,60,33,27,55,0,0
842,13/05/2021,3,1,90,51,39,49,0,0
235,14/05/2021,3,6,151,19,132,49,0,0
505,18/05/2021,3,0,84,36,48,49,0,0
317,13/05/2021,3,0,80,44,36,55,0,0
629,18/05/2021,3,1,61,43,18,52,0,0
308,12/05/2021,3,2,46,11,35,49,0,0
326,25/05/2021,3,2,79,56,23,74,0,0
250,14/05/2021,3,0,115,61,54,59,0,0
793,06/05/2021,3,0,131,23,108,49,0,0
82,22/05/2021,3,0,96,69,27,94,0,0
330,12/05/2021,3,2,117,30,87,55,0,0
189,23/05/2021,3,0,165,58,107,49,0,0
741,23/05/2021,3,0,70,28,42,49,0,0
520,19/05/2021,3,0,58,56,2,77,0,0
97,17/05/2021,3,5,102,90,12,80,0,0
504,23/05/2021,3,0,83,23,60,49,0,0
688,13/05/2021,3,4,115,50,65,49,0,0
21,20/05/2021,3,1,59,27,32,49,0,0
532,03/05/2021,3,0,84,28,56,59,0,0
877,08/05/2021,3,0,158,25,133,35,0,0
578,16/05/2021,3,1,57,14,43,49,0,0
36,19/05/2021,3,1,62,25,37,49,0,0
801,05/05/2021,3,7,160,25,135,49,0,0
773,14/05/2021,3,1,73,22,51,49,0,0
181,26/05/2021,3,0,34,24,10,64,0,0
105,14/05/2021,3,31,44,12,32,49,0,0
129,26/05/2021,3,13,187,110,77,49,0,0
303,30/05/2021,3,1,64,38,26,52,0,0
95,21/05/2021,3,0,88,58,30,81,0,0
178,16/05/2021,3,1,37,11,26,49,0,0
72,22/05/2021,3,2,58,56,2,84,0,0
836,17/05/2021,3,1,100,63,37,49,0,0
739,20/05/2021,3,2,73,19,54,49,0,0
575,10/05/2021,3,1,49,25,24,55,0,0
87,13/05/2021,3,2,116,24,92,49,0,0
100,12/05/2021,3,77,147,26,121,49,0,0
851,16/05/2021,3,0,92,11,81,49,0,0
707,21/05/2021,3,1,39,37,2,95,0,0
548,02/05/2021,3,0,91,37,54,49,0,0
118,14/05/2021,3,3,56,13,43,49,0,0
170,13/05/2021,3,0,105,36,69,49,0,0
90,28/05/2021,3,0,78,36,42,67,0,0
437,17/05/2021,3,2,163,75,88,49,0,0
879,13/05/2021,3,3,161,6,155,39,0,0
1,07/05/2021,3,3,97,11,86,49,0,0
233,15/05/2021,3,3,64,9,55,49,0,0
594,17/05/2021,3,43,64,52,12,72,0,0
376,17/05/2021,3,1,63,51,12,55,0,0
581,23/05/2021,3,39,186,77,109,49,0,0
512,21/05/2021,3,1,61,28,33,55,0,0
356,21/05/2021,3,2,134,99,35,60,0,0
404,17/05/2021,3,0,67,54,13,64,0,0
365,16/05/2021,3,0,68,26,42,55,0,0
776,24/05/2021,3,0,104,56,48,49,0,0
543,25/05/2021,3,1,64,54,10,141,0,0
77,13/05/2021,3,3,100,28,72,49,0,0
699,16/05/2021,3,0,62,21,41,49,0,0
679,17/05/2021,3,2,87,74,13,72,0,0
158,21/05/2021,3,1,23,23,0,NA,NA,NA
850,09/05/2021,3,6,77,18,59,49,0,0
534,12/05/2021,3,0,85,39,46,49,0,0
831,18/05/2021,3,2,148,56,92,49,0,0
240,10/05/2021,3,0,71,32,39,55,0,0
789,18/05/2021,3,1,71,63,8,93,0,0
715,12/05/2021,3,4,84,56,28,64,0,0
426,25/05/2021,3,8,155,96,59,64,0,0
588,14/05/2021,3,0,59,10,49,49,0,0
793,02/05/2021,3,1,130,12,118,49,0,0
288,20/05/2021,3,0,60,41,19,67,0,0
212,13/05/2021,3,2,76,74,2,93,0,0
305,24/05/2021,3,12,47,33,14,74,0,0
641,24/05/2021,3,0,160,44,116,49,0,0
485,18/05/2021,3,0,65,48,17,67,0,0
188,17/05/2021,3,7,114,84,30,52,0,0
613,23/05/2021,3,0,56,23,33,49,0,0
408,14/05/2021,3,4,161,13,148,49,0,0
31,21/05/2021,3,1,62,36,26,55,0,0
44,02/05/2021,3,6,102,72,30,52,0,0
877,09/05/2021,3,0,158,21,137,35,0,0
694,16/05/2021,3,1,108,9,99,49,0,0
405,18/05/2021,3,1,89,40,49,49,0,0
470,03/05/2021,3,1,79,36,43,59,0,0
116,14/05/2021,3,0,61,19,42,49,0,0
181,27/05/2021,3,0,34,12,22,55,0,0
798,15/05/2021,3,1,80,30,50,49,0,0
135,27/05/2021,3,3,63,55,8,79,0,0
800,29/05/2021,3,2,55,54,1,85,0,0
161,21/05/2021,3,1,60,55,5,90,0,0
735,17/05/2021,3,0,29,7,22,49,0,0
3,22/05/2021,3,8,105,29,76,55,0,0
427,16/05/2021,3,6,304,6,298,66,0,0
209,18/05/2021,3,1,113,71,42,55,0,0
650,10/05/2021,3,3,125,34,91,55,0,0
205,13/05/2021,3,0,126,20,106,49,0,0
71,14/05/2021,3,3,59,7,52,49,0,0
540,15/05/2021,3,1,81,21,60,49,0,0
790,21/05/2021,3,1,98,57,41,95,0,0
720,02/05/2021,3,0,39,6,33,49,0,0
234,14/05/2021,3,3,59,15,44,49,0,0
866,13/05/2021,3,0,100,27,73,49,0,0
164,28/05/2021,3,0,62,54,8,75,0,0
152,17/05/2021,3,1,90,35,55,49,0,0
704,16/05/2021,3,1,31,4,27,49,0,0
111,11/05/2021,3,0,60,59,1,123,0,0
233,16/05/2021,3,3,64,7,57,49,0,0
617,17/05/2021,3,1,43,28,15,60,0,0
674,17/05/2021,3,1,97,23,74,49,0,0
231,18/05/2021,3,0,41,26,15,74,0,0
597,21/05/2021,3,3,98,57,41,55,0,0
79,20/05/2021,3,2,44,37,7,72,0,0
598,17/05/2021,3,0,146,138,8,74,0,0
365,17/05/2021,3,0,68,66,2,80,0,0
776,26/05/2021,3,0,104,42,62,49,0,0
706,24/05/2021,3,1,73,42,31,49,0,0
77,15/05/2021,3,3,100,20,80,49,0,0
180,16/05/2021,3,0,41,8,33,49,0,0
407,15/05/2021,3,1,40,6,34,49,0,0
818,21/05/2021,3,1,80,80,0,NA,NA,NA
61,10/05/2021,3,1,99,50,49,49,0,0
418,14/05/2021,3,0,116,11,105,49,0,0
389,18/05/2021,3,2,124,60,64,49,0,0
317,10/05/2021,3,0,80,57,23,67,0,0
282,18/05/2021,3,28,673,39,634,49,0,0
58,10/05/2021,3,1,66,65,1,79,0,0
326,26/05/2021,3,2,79,53,26,55,0,0
767,14/05/2021,3,0,67,6,61,49,0,0
602,05/05/2021,3,0,64,22,42,55,0,0
359,18/05/2021,3,5,99,51,48,80,0,0
212,11/05/2021,3,3,75,68,7,89,0,0
400,25/05/2021,3,3,27,14,13,52,0,0
562,23/05/2021,3,0,68,18,50,49,0,0
520,18/05/2021,3,0,58,57,1,115,0,0
355,17/05/2021,3,2,97,51,46,55,0,0
883,22/05/2021,3,6,98,11,87,45,0,0
402,14/05/2021,3,0,155,25,130,49,0,0
214,21/05/2021,3,3,83,52,31,55,0,0
44,04/05/2021,3,6,102,45,57,55,0,0
692,11/05/2021,3,0,87,3,84,49,0,0
661,14/05/2021,3,4,168,13,155,49,0,0
468,20/05/2021,3,1,95,40,55,49,0,0
573,04/05/2021,3,2,55,16,39,55,0,0
388,14/05/2021,3,1,59,10,49,49,0,0
313,20/05/2021,3,0,31,25,6,62,0,0
798,13/05/2021,3,1,80,63,17,72,0,0
68,28/05/2021,3,1,115,88,27,60,0,0
730,30/05/2021,3,2,73,54,19,52,0,0
309,20/05/2021,3,0,16,15,1,79,0,0
458,15/05/2021,3,3,178,40,138,49,0,0
642,22/05/2021,3,2,93,82,11,67,0,0
321,16/05/2021,3,1,39,3,36,49,0,0
209,20/05/2021,3,1,113,72,41,55,0,0
650,11/05/2021,3,3,125,42,83,55,0,0
87,14/05/2021,3,1,117,11,106,49,0,0
753,14/05/2021,3,1,126,16,110,49,0,0
397,15/05/2021,3,0,75,5,70,49,0,0
267,22/05/2021,3,2,81,68,13,67,0,0
548,03/05/2021,3,0,91,9,82,49,0,0
325,14/05/2021,3,0,45,7,38,49,0,0
170,14/05/2021,3,0,105,21,84,49,0,0
794,19/05/2021,3,0,137,49,88,55,0,0
437,18/05/2021,3,2,163,86,77,49,0,0
221,16/05/2021,3,1,61,11,50,49,0,0
371,07/05/2021,3,0,36,8,28,49,0,0
624,16/05/2021,3,0,79,11,68,49,0,0
755,17/05/2021,3,0,87,85,2,90,0,0
919,16/05/2021,3,0,123,11,112,49,0,0
652,18/05/2021,3,0,69,40,29,64,0,0
825,21/05/2021,3,2,144,88,56,72,0,0
217,20/05/2021,3,2,39,29,10,57,0,0
728,16/05/2021,3,0,47,13,34,49,0,0
817,18/05/2021,3,0,83,23,60,55,0,0
413,18/05/2021,3,2,114,105,9,70,0,0
45,23/05/2021,3,1,155,22,133,49,0,0
564,14/05/2021,3,1,73,21,52,49,0,0
34,15/05/2021,3,4,84,10,74,49,0,0
668,16/05/2021,3,4,299,19,280,49,0,0
820,19/05/2021,3,0,127,121,6,80,0,0
185,10/05/2021,3,1,167,37,130,49,0,0
534,13/05/2021,3,0,85,42,43,49,0,0
176,18/05/2021,3,3,97,33,64,49,0,0
63,10/05/2021,3,3,61,25,36,49,0,0
20,19/05/2021,3,3,79,74,5,85,0,0
438,13/05/2021,3,14,82,38,44,82,0,0
127,26/05/2021,3,1,59,37,22,72,0,0
588,15/05/2021,3,0,59,29,30,49,0,0
41,03/05/2021,3,1,83,12,71,55,0,0
359,19/05/2021,3,5,99,58,41,72,0,0
210,12/05/2021,3,3,99,85,14,65,0,0
187,25/05/2021,3,1,40,19,21,49,0,0
414,16/05/2021,3,21,165,19,146,49,0,0
466,19/05/2021,3,0,140,38,102,49,0,0
80,17/05/2021,3,2,123,58,65,49,0,0
795,22/05/2021,3,8,97,97,0,NA,NA,NA
112,15/05/2021,3,0,84,36,48,49,0,0
618,21/05/2021,3,9,142,84,58,55,0,0
532,04/05/2021,3,0,84,58,26,64,0,0
692,10/05/2021,3,0,87,1,86,49,0,0
580,16/05/2021,3,0,98,18,80,49,0,0
605,20/05/2021,3,1,159,69,90,49,0,0
553,05/05/2021,3,19,23,4,19,57,0,0
552,14/05/2021,3,12,172,26,146,49,0,0
313,21/05/2021,3,0,31,20,11,60,0,0
157,13/05/2021,3,2,81,50,31,64,0,0
68,25/05/2021,3,1,115,18,97,49,0,0
761,30/05/2021,3,1,82,60,22,52,0,0
59,20/05/2021,3,0,75,21,54,49,0,0
788,15/05/2021,3,2,89,17,72,49,0,0
292,22/05/2021,3,1,238,108,130,60,0,0
684,16/05/2021,3,2,96,9,87,49,0,0
433,19/05/2021,3,2,316,96,220,66,0,0
430,12/05/2021,3,2,87,25,62,55,0,0
205,14/05/2021,3,0,126,16,110,49,0,0
171,13/05/2021,3,2,47,27,20,52,0,0
851,15/05/2021,3,0,92,6,86,49,0,0
281,22/05/2021,3,2,81,42,39,60,0,0
726,03/05/2021,3,0,39,3,36,59,0,0
521,14/05/2021,3,1,54,10,44,49,0,0
705,14/05/2021,3,1,90,9,81,49,0,0
567,21/05/2021,3,0,61,55,6,74,0,0
57,19/05/2021,3,2,138,72,66,49,0,0
704,12/05/2021,3,1,31,27,4,62,0,0
371,11/05/2021,3,0,36,18,18,80,0,0
634,15/05/2021,3,0,20,12,8,59,0,0
519,18/05/2021,3,0,64,47,17,60,0,0
197,18/05/2021,3,0,118,37,81,49,0,0
677,18/05/2021,3,0,40,21,19,52,0,0
56,20/05/2021,3,3,62,51,11,80,0,0
907,20/05/2021,3,3,77,65,12,57,0,0
598,16/05/2021,3,0,146,37,109,49,0,0
689,18/05/2021,3,0,130,97,33,57,0,0
864,18/05/2021,3,1,84,32,52,64,0,0
582,22/05/2021,3,0,53,50,3,161,0,0
349,15/05/2021,3,1,89,35,54,49,0,0
857,16/05/2021,3,1,209,28,181,49,0,0
290,17/05/2021,3,2,105,60,45,49,0,0
830,21/05/2021,3,0,66,60,6,130,0,0
842,10/05/2021,3,1,90,63,27,49,0,0
534,14/05/2021,3,0,85,25,60,49,0,0
855,18/05/2021,3,1,175,92,83,49,0,0
513,10/05/2021,3,1,76,26,50,49,0,0
335,19/05/2021,3,4,82,33,49,55,0,0
715,13/05/2021,3,5,83,82,1,90,0,0
275,26/05/2021,3,0,117,116,1,94,0,0
480,14/05/2021,3,0,28,8,20,49,0,0
449,05/05/2021,3,2,93,13,80,66,0,0
82,20/05/2021,3,1,95,85,10,119,0,0
117,12/05/2021,3,0,94,38,56,55,0,0
305,16/05/2021,3,12,47,10,37,49,0,0
455,16/05/2021,3,8,243,9,234,66,0,0
803,18/05/2021,3,0,69,69,0,NA,NA,NA
636,17/05/2021,3,1,119,76,43,49,0,0
378,22/05/2021,3,1,83,70,13,67,0,0
402,15/05/2021,3,0,155,26,129,49,0,0
483,19/05/2021,3,3,96,43,53,49,0,0
577,02/05/2021,3,0,78,7,71,49,0,0
877,11/05/2021,3,0,158,37,121,35,0,0
661,16/05/2021,3,2,170,10,160,49,0,0
503,18/05/2021,3,0,184,66,118,49,0,0
379,02/05/2021,3,4,283,41,242,66,0,0
645,11/05/2021,3,3,38,32,6,59,0,0
844,21/05/2021,3,0,61,15,46,80,0,0
123,13/05/2021,3,0,95,18,77,49,0,0
616,25/05/2021,3,2,73,58,15,90,0,0
447,30/05/2021,3,0,143,129,14,62,0,0
37,23/05/2021,3,2,79,30,49,49,0,0
786,16/05/2021,3,2,60,3,57,49,0,0
464,23/05/2021,3,1,265,32,233,70,0,0
128,17/05/2021,3,1,20,16,4,80,0,0
862,19/05/2021,3,2,108,68,40,49,0,0
650,12/05/2021,3,1,127,47,80,55,0,0
435,15/05/2021,3,80,40,16,24,49,0,0
89,14/05/2021,3,3,57,4,53,49,0,0
768,15/05/2021,3,1,86,15,71,49,0,0
416,21/05/2021,3,0,34,26,8,60,0,0
315,05/05/2021,3,0,62,44,18,67,0,0
539,14/05/2021,3,2,95,4,91,49,0,0
409,16/05/2021,3,9,98,23,75,49,0,0
736,21/05/2021,3,1,104,51,53,55,0,0
437,19/05/2021,3,2,163,85,78,49,0,0
242,15/05/2021,3,1,137,93,44,60,0,0
878,08/05/2021,3,0,218,9,209,44,0,0
440,16/05/2021,3,0,265,7,258,66,0,0
594,18/05/2021,3,43,64,63,1,115,0,0
639,18/05/2021,3,0,59,25,34,49,0,0
25,18/05/2021,3,1,51,33,18,77,0,0
192,20/05/2021,3,0,86,55,31,52,0,0
311,21/05/2021,3,0,97,64,33,69,0,0
136,17/05/2021,3,0,128,64,64,49,0,0
271,18/05/2021,3,0,70,49,21,60,0,0
153,18/05/2021,3,1,63,35,28,67,0,0
582,24/05/2021,3,0,53,40,13,130,0,0
349,16/05/2021,3,1,89,32,57,49,0,0
76,15/05/2021,3,1,92,27,65,49,0,0
668,17/05/2021,3,4,299,24,275,49,0,0
757,20/05/2021,3,0,117,101,16,72,0,0
185,11/05/2021,3,1,167,35,132,49,0,0
632,13/05/2021,3,0,82,41,41,55,0,0
389,17/05/2021,3,2,124,41,83,49,0,0
812,10/05/2021,3,2,135,54,81,49,0,0
130,19/05/2021,3,2,79,56,23,62,0,0
603,12/05/2021,3,2,82,30,52,55,0,0
742,15/05/2021,3,1,73,6,67,49,0,0
177,15/05/2021,3,0,48,3,45,49,0,0
449,02/05/2021,3,7,88,7,81,66,0,0
495,03/05/2021,3,2,83,6,77,49,0,0
902,11/05/2021,3,2,124,46,78,49,0,0
400,16/05/2021,3,2,28,4,24,49,0,0
179,16/05/2021,3,1,91,18,73,49,0,0
803,19/05/2021,3,0,69,69,0,NA,NA,NA
697,17/05/2021,3,2,107,45,62,49,0,0
378,23/05/2021,3,1,83,42,41,49,0,0
479,13/05/2021,3,1,54,27,27,49,0,0
208,19/05/2021,3,0,60,30,30,59,0,0
719,02/05/2021,3,0,41,11,30,49,0,0
457,08/05/2021,3,2,61,11,50,49,0,0
694,12/05/2021,3,1,108,38,70,49,0,0
503,20/05/2021,3,0,184,37,147,49,0,0
379,03/05/2021,3,4,283,49,234,66,0,0
116,13/05/2021,3,0,61,46,15,72,0,0
814,21/05/2021,3,1,67,65,2,69,0,0
166,13/05/2021,3,3,63,18,45,49,0,0
115,26/05/2021,3,1,114,33,81,49,0,0
682,29/05/2021,3,1,79,79,0,NA,NA,NA
443,23/05/2021,3,6,84,43,41,49,0,0
528,15/05/2021,3,0,119,17,102,49,0,0
292,23/05/2021,3,1,238,37,201,49,0,0
600,17/05/2021,3,1,49,20,29,55,0,0
12,18/05/2021,3,2,41,35,6,103,0,0
758,12/05/2021,3,1,72,32,40,55,0,0
533,13/05/2021,3,1,90,4,86,49,0,0
615,11/05/2021,3,0,71,25,46,49,0,0
249,16/05/2021,3,2,125,49,76,49,0,0
401,22/05/2021,3,0,79,78,1,77,0,0
747,02/05/2021,3,0,64,6,58,49,0,0
787,14/05/2021,3,3,105,14,91,49,0,0
11,13/05/2021,3,14,70,54,16,49,0,0
713,19/05/2021,3,1,60,60,0,NA,NA,NA
498,19/05/2021,3,0,87,46,41,49,0,0
221,13/05/2021,3,1,61,31,30,55,0,0
878,09/05/2021,3,0,218,7,211,44,0,0
841,16/05/2021,3,0,182,20,162,55,0,0
848,18/05/2021,3,5,133,26,107,35,0,0
674,18/05/2021,3,1,97,28,69,49,0,0
687,18/05/2021,3,2,85,49,36,52,0,0
269,20/05/2021,3,1,79,7,72,161,0,0
465,19/05/2021,3,5,262,119,143,55,0,0
484,17/05/2021,3,0,40,37,3,55,0,0
778,16/05/2021,3,1,80,45,35,49,0,0
571,18/05/2021,3,0,161,25,136,49,0,0
510,23/05/2021,3,2,141,24,117,49,0,0
633,13/05/2021,3,1,49,21,28,49,0,0
76,16/05/2021,3,1,92,18,74,49,0,0
559,15/05/2021,3,46,139,22,117,49,0,0
820,21/05/2021,3,0,127,102,25,67,0,0
185,12/05/2021,3,1,167,32,135,49,0,0
632,12/05/2021,3,0,82,32,50,64,0,0
505,17/05/2021,3,0,84,33,51,49,0,0
513,12/05/2021,3,1,76,31,45,49,0,0
396,19/05/2021,3,1,29,28,1,75,0,0
603,13/05/2021,3,2,82,30,52,55,0,0
127,16/05/2021,3,1,59,5,54,49,0,0
588,16/05/2021,3,0,59,11,48,49,0,0
449,04/05/2021,3,6,89,10,79,66,0,0
328,04/05/2021,3,1,97,97,0,NA,NA,NA
304,11/05/2021,3,2,58,37,21,49,0,0
400,17/05/2021,3,2,28,8,20,49,0,0
343,16/05/2021,3,1,61,12,49,49,0,0
101,17/05/2021,3,1,59,36,23,52,0,0
499,19/05/2021,3,0,31,16,15,49,0,0
889,23/05/2021,3,1,123,3,120,45,0,0
264,14/05/2021,3,1,59,24,35,49,0,0
214,19/05/2021,3,4,82,49,33,52,0,0
44,03/05/2021,3,7,101,19,82,49,0,0
663,12/05/2021,3,2,146,29,117,49,0,0
694,14/05/2021,3,1,108,37,71,49,0,0
283,19/05/2021,3,0,76,34,42,64,0,0
379,04/05/2021,3,4,283,112,171,66,0,0
771,13/05/2021,3,2,28,23,5,77,0,0
459,21/05/2021,3,4,88,91,-3,NA,NA,NA
497,14/05/2021,3,1,192,42,150,49,0,0
662,26/05/2021,3,1,106,63,43,74,0,0
682,10/05/2021,3,2,78,11,67,49,0,0
473,21/05/2021,3,3,47,37,10,74,0,0
528,16/05/2021,3,0,119,23,96,49,0,0
204,14/05/2021,3,0,64,3,61,49,0,0
163,16/05/2021,3,2,60,28,32,49,0,0
529,19/05/2021,3,3,38,32,6,52,0,0
373,13/05/2021,3,1,102,41,61,55,0,0
625,13/05/2021,3,0,161,55,106,49,0,0
852,11/05/2021,3,0,80,26,54,49,0,0
557,17/05/2021,3,1,103,70,33,55,0,0
239,22/05/2021,3,0,40,30,10,74,0,0
315,03/05/2021,3,0,62,24,38,55,0,0
734,14/05/2021,3,2,59,27,32,49,0,0
11,14/05/2021,3,2,82,27,55,49,0,0
746,21/05/2021,3,2,58,58,0,NA,NA,NA
211,17/05/2021,3,3,57,39,18,60,0,0
704,13/05/2021,3,1,31,22,9,52,0,0
878,10/05/2021,3,0,218,8,210,44,0,0
685,14/05/2021,3,3,137,17,120,49,0,0
617,18/05/2021,3,1,43,30,13,80,0,0
307,17/05/2021,3,1,78,33,45,52,0,0
904,18/05/2021,3,2,272,5,267,66,0,0
247,20/05/2021,3,2,91,64,27,55,0,0
566,20/05/2021,3,0,75,43,32,49,0,0
352,17/05/2021,3,0,64,58,6,77,0,0
190,17/05/2021,3,3,77,42,35,52,0,0
571,17/05/2021,3,0,161,30,131,49,0,0
134,22/05/2021,3,1,47,36,11,92,0,0
349,14/05/2021,3,1,89,19,70,49,0,0
143,16/05/2021,3,2,118,15,103,49,0,0
679,16/05/2021,3,2,87,73,14,72,0,0
410,20/05/2021,3,0,56,51,5,62,0,0
61,13/05/2021,3,1,99,50,49,49,0,0
681,12/05/2021,3,2,69,36,33,60,0,0
831,17/05/2021,3,2,148,52,96,49,0,0
812,12/05/2021,3,2,135,70,65,49,0,0
224,18/05/2021,3,1,56,26,30,49,0,0
218,10/05/2021,3,3,75,33,42,49,0,0
772,15/05/2021,3,0,57,12,45,49,0,0
480,16/05/2021,3,0,28,12,16,49,0,0
602,04/05/2021,3,0,64,19,45,55,0,0
261,02/05/2021,3,3,99,12,87,49,0,0
411,11/05/2021,3,2,183,32,151,49,0,0
28,17/05/2021,3,2,126,126,0,NA,NA,NA
828,17/05/2021,3,0,75,73,2,71,0,0
803,17/05/2021,3,1,68,67,1,75,0,0
80,16/05/2021,3,1,124,26,98,49,0,0
93,22/05/2021,3,3,138,121,17,57,0,0
104,15/05/2021,3,1,61,31,30,49,0,0
664,21/05/2021,3,10,145,76,69,64,0,0
595,01/05/2021,3,2,48,30,18,49,0,0
463,11/05/2021,3,1,162,34,128,55,0,0
517,16/05/2021,3,0,58,22,36,49,0,0
503,21/05/2021,3,0,184,61,123,55,0,0
819,05/05/2021,3,0,80,76,4,72,0,0
773,11/05/2021,3,1,73,57,16,80,0,0
724,20/05/2021,3,3,83,83,0,NA,NA,NA
646,14/05/2021,3,19,117,38,79,49,0,0
933,10/05/2021,3,116,31,0,31,35,0,0
268,11/05/2021,3,1,77,72,5,93,0,0
95,23/05/2021,3,2,86,35,51,49,0,0
155,16/05/2021,3,0,93,23,70,49,0,0
204,16/05/2021,3,0,64,1,63,49,0,0
836,16/05/2021,3,1,100,21,79,49,0,0
12,20/05/2021,3,2,41,36,5,62,0,0
650,13/05/2021,3,1,127,72,55,55,0,0
205,15/05/2021,3,0,126,40,86,49,0,0
852,12/05/2021,3,0,80,28,52,49,0,0
48,14/05/2021,3,5,174,7,167,49,0,0
784,21/05/2021,3,1,48,48,0,NA,NA,NA
720,04/05/2021,3,0,39,24,15,60,0,0
325,13/05/2021,3,0,45,29,16,57,0,0
170,15/05/2021,3,0,105,27,78,49,0,0
547,20/05/2021,3,0,74,74,0,NA,NA,NA
525,19/05/2021,3,2,73,65,8,79,0,0
765,13/05/2021,3,2,99,58,41,59,0,0
371,08/05/2021,3,0,36,15,21,49,0,0
748,15/05/2021,3,5,139,18,121,49,0,0
228,17/05/2021,3,2,40,16,24,49,0,0
295,16/05/2021,3,3,102,13,89,49,0,0
46,18/05/2021,3,3,57,52,5,89,0,0
269,22/05/2021,3,0,80,35,45,55,0,0
465,21/05/2021,3,4,263,153,110,55,0,0
506,17/05/2021,3,0,195,33,162,49,0,0
243,17/05/2021,3,1,126,26,100,49,0,0
153,17/05/2021,3,1,63,38,25,67,0,0
706,22/05/2021,3,1,73,68,5,96,0,0
564,15/05/2021,3,1,73,18,55,49,0,0
206,15/05/2021,3,16,197,40,157,55,0,0
290,15/05/2021,3,2,105,80,25,52,0,0
732,20/05/2021,3,0,60,44,16,57,0,0
185,13/05/2021,3,1,167,25,142,49,0,0
752,13/05/2021,3,24,20,4,16,65,0,0
434,17/05/2021,3,2,58,21,37,49,0,0
63,12/05/2021,3,2,62,31,31,49,0,0
224,19/05/2021,3,1,56,23,33,49,0,0
764,10/05/2021,3,2,67,41,26,49,0,0
481,15/05/2021,3,0,56,2,54,49,0,0
480,15/05/2021,3,0,28,7,21,49,0,0
602,02/05/2021,3,0,64,7,57,49,0,0
843,03/05/2021,3,4,62,11,51,49,0,0
493,13/05/2021,3,1,34,16,18,49,0,0
895,17/05/2021,3,0,69,60,9,57,0,0
641,16/05/2021,3,0,160,6,154,49,0,0
738,18/05/2021,3,1,123,108,15,74,0,0
355,16/05/2021,3,2,97,16,81,49,0,0
858,22/05/2021,3,0,81,80,1,140,0,0
83,13/05/2021,3,79,89,71,18,49,0,0
725,11/05/2021,3,0,17,17,0,NA,NA,NA
595,02/05/2021,3,2,48,21,27,49,0,0
463,12/05/2021,3,1,162,35,127,55,0,0
578,12/05/2021,3,1,57,23,34,49,0,0
377,21/05/2021,3,0,149,118,31,77,0,0
849,02/05/2021,3,1,83,13,70,49,0,0
351,13/05/2021,3,1,65,28,37,67,0,0
808,20/05/2021,3,1,167,167,0,NA,NA,NA
166,15/05/2021,3,3,63,32,31,49,0,0
933,14/05/2021,3,115,32,1,31,35,0,0
8,12/05/2021,3,1,39,18,21,52,0,0
161,08/05/2021,3,0,61,14,47,49,0,0
565,16/05/2021,3,0,62,13,49,49,0,0
204,15/05/2021,3,0,64,2,62,49,0,0
875,16/05/2021,3,2,90,27,63,49,0,0
173,20/05/2021,3,1,70,51,19,60,0,0
758,13/05/2021,3,1,72,31,41,55,0,0
625,15/05/2021,3,1,160,25,135,49,0,0
278,11/05/2021,3,0,105,11,94,49,0,0
312,14/05/2021,3,3,94,12,82,49,0,0
666,22/05/2021,3,2,64,64,0,NA,NA,NA
726,05/05/2021,3,0,39,24,15,72,0,0
734,13/05/2021,3,2,59,47,12,59,0,0
717,15/05/2021,3,3,190,24,166,49,0,0
561,19/05/2021,3,1,59,31,28,55,0,0
915,17/05/2021,3,5,184,13,171,35,0,0
488,13/05/2021,3,3,63,36,27,55,0,0
111,12/05/2021,3,1,59,55,4,89,0,0
216,15/05/2021,3,1,57,5,52,49,0,0
262,17/05/2021,3,2,49,39,10,67,0,0
554,16/05/2021,3,2,40,8,32,49,0,0
353,18/05/2021,3,1,51,51,0,NA,NA,NA
186,21/05/2021,3,1,57,28,29,55,0,0
465,20/05/2021,3,3,264,135,129,55,0,0
431,17/05/2021,3,1,129,66,63,59,0,0
593,17/05/2021,3,5,76,72,4,93,0,0
147,18/05/2021,3,1,79,58,21,62,0,0
45,22/05/2021,3,1,155,36,119,49,0,0
633,15/05/2021,3,1,49,5,44,49,0,0
626,15/05/2021,3,3,99,31,68,49,0,0
679,15/05/2021,3,2,87,85,2,59,0,0
386,19/05/2021,3,3,82,51,31,52,0,0
604,13/05/2021,3,1,81,26,55,49,0,0
383,14/05/2021,3,3,82,24,58,49,0,0
855,17/05/2021,3,1,175,79,96,49,0,0
812,13/05/2021,3,2,135,56,79,49,0,0
207,19/05/2021,3,2,61,50,11,72,0,0
218,13/05/2021,3,2,76,42,34,49,0,0
861,17/05/2021,3,0,61,61,0,NA,NA,NA
177,14/05/2021,3,0,48,8,40,49,0,0
671,01/05/2021,3,2,63,64,-1,NA,NA,NA
288,04/05/2021,3,1,59,37,22,67,0,0
493,11/05/2021,3,1,34,18,16,49,0,0
189,17/05/2021,3,1,164,133,31,72,0,0
156,17/05/2021,3,2,146,117,29,52,0,0
738,19/05/2021,3,1,123,114,9,77,0,0
656,16/05/2021,3,0,115,39,76,49,0,0
477,22/05/2021,3,3,117,48,69,55,0,0
402,13/05/2021,3,0,155,45,110,49,0,0
725,12/05/2021,3,0,17,17,0,NA,NA,NA
595,03/05/2021,3,2,48,19,29,49,0,0
457,11/05/2021,3,2,61,30,31,52,0,0
578,14/05/2021,3,1,57,6,51,49,0,0
377,18/05/2021,3,0,149,122,27,85,0,0
23,01/05/2021,3,2,62,29,33,49,0,0
552,11/05/2021,3,11,173,36,137,49,0,0
329,21/05/2021,3,9,98,98,0,NA,NA,NA
497,15/05/2021,3,2,191,48,143,49,0,0
933,11/05/2021,3,116,31,0,31,39,0,0
682,07/05/2021,3,2,78,13,65,49,0,0
309,07/05/2021,3,0,16,16,0,NA,NA,NA
786,17/05/2021,3,2,60,13,47,49,0,0
292,14/05/2021,3,0,239,130,109,49,0,0
213,17/05/2021,3,3,145,107,38,52,0,0
142,20/05/2021,3,2,60,57,3,115,0,0
430,14/05/2021,3,2,87,14,73,55,0,0
749,15/05/2021,3,5,149,27,122,49,0,0
278,12/05/2021,3,0,105,13,92,49,0,0
348,14/05/2021,3,5,135,43,92,49,0,0
707,22/05/2021,3,1,39,39,0,NA,NA,NA
747,06/05/2021,3,0,64,49,15,72,0,0
364,13/05/2021,3,3,127,106,21,72,0,0
11,16/05/2021,3,2,82,23,59,49,0,0
561,21/05/2021,3,1,59,33,26,55,0,0
4,17/05/2021,3,1,63,52,11,80,0,0
18,15/05/2021,3,3,89,68,21,62,0,0
701,10/05/2021,3,2,60,26,34,55,0,0
86,16/05/2021,3,1,47,18,29,49,0,0
917,17/05/2021,3,1,105,14,91,35,0,0
85,17/05/2021,3,6,114,92,22,52,0,0
507,18/05/2021,3,3,197,71,126,49,0,0
253,21/05/2021,3,1,57,44,13,52,0,0
846,20/05/2021,3,1,188,22,166,45,0,0
362,16/05/2021,3,5,115,51,64,59,0,0
526,17/05/2021,3,1,37,34,3,65,0,0
42,18/05/2021,3,2,97,71,26,74,0,0
582,23/05/2021,3,0,53,45,8,97,0,0
564,16/05/2021,3,1,73,21,52,49,0,0
220,16/05/2021,3,28,75,6,69,49,0,0
107,17/05/2021,3,29,60,42,18,90,0,0
921,19/05/2021,3,10,165,42,123,45,0,0
604,10/05/2021,3,1,81,29,52,49,0,0
675,14/05/2021,3,1,55,13,42,49,0,0
103,16/05/2021,3,1,160,59,101,49,0,0
240,14/05/2021,3,1,70,36,34,49,0,0
65,18/05/2021,3,1,77,38,39,49,0,0
764,13/05/2021,3,2,67,21,46,49,0,0
52,17/05/2021,3,13,129,130,-1,NA,NA,NA
366,14/05/2021,3,0,80,26,54,49,0,0
722,01/05/2021,3,0,42,16,26,49,0,0
843,04/05/2021,3,4,62,22,40,49,0,0
338,11/05/2021,3,3,397,79,318,49,0,0
423,17/05/2021,3,1,49,40,9,67,0,0
358,17/05/2021,3,2,91,50,41,55,0,0
88,17/05/2021,3,1,41,18,23,55,0,0
733,17/05/2021,3,0,100,37,63,49,0,0
492,22/05/2021,3,3,34,31,3,85,0,0
804,14/05/2021,3,3,142,29,113,49,0,0
664,11/05/2021,3,3,152,42,110,55,0,0
532,01/05/2021,3,0,84,31,53,49,0,0
655,11/05/2021,3,1,71,48,23,72,0,0
651,12/05/2021,3,1,77,19,58,49,0,0
503,19/05/2021,3,0,184,30,154,49,0,0
50,01/05/2021,3,2,119,13,106,49,0,0
388,13/05/2021,3,1,59,32,27,49,0,0
181,20/05/2021,3,0,34,27,7,74,0,0
585,14/05/2021,3,2,58,46,12,52,0,0
933,12/05/2021,3,116,31,0,31,46,0,0
22,08/05/2021,3,0,64,13,51,49,0,0
37,07/05/2021,3,3,78,16,62,49,0,0
178,17/05/2021,3,1,37,26,11,64,0,0
518,16/05/2021,3,1,16,3,13,49,0,0
417,17/05/2021,3,0,103,71,32,52,0,0
529,20/05/2021,3,3,38,35,3,63,0,0
373,11/05/2021,3,1,102,53,49,60,0,0
737,13/05/2021,3,2,40,11,29,49,0,0
710,12/05/2021,3,0,20,12,8,72,0,0
348,15/05/2021,3,4,136,37,99,49,0,0
267,21/05/2021,3,2,81,50,31,55,0,0
747,05/05/2021,3,0,64,58,6,85,0,0
234,13/05/2021,3,3,59,17,42,49,0,0
638,16/05/2021,3,21,80,13,67,49,0,0
229,19/05/2021,3,4,52,51,1,123,0,0
368,18/05/2021,3,1,84,60,24,74,0,0
759,12/05/2021,3,2,85,30,55,49,0,0
823,08/05/2021,3,1,60,37,23,52,0,0
511,16/05/2021,3,1,75,15,60,49,0,0
865,17/05/2021,3,1,84,21,63,49,0,0
307,18/05/2021,3,1,78,34,44,52,0,0
231,17/05/2021,3,0,41,29,12,57,0,0
462,21/05/2021,3,7,182,24,158,80,0,0
846,21/05/2021,3,2,187,53,134,45,0,0
362,17/05/2021,3,4,116,97,19,64,0,0
243,18/05/2021,3,1,126,49,77,49,0,0
648,18/05/2021,3,0,64,37,27,64,0,0
341,11/05/2021,3,16,98,98,0,NA,NA,NA
544,13/05/2021,3,0,53,16,37,49,0,0
626,16/05/2021,3,3,99,24,75,49,0,0
290,16/05/2021,3,2,105,45,60,49,0,0
921,20/05/2021,3,10,165,38,127,45,0,0
144,11/05/2021,3,1,98,34,64,49,0,0
658,20/05/2021,3,1,80,68,12,74,0,0
176,16/05/2021,3,4,96,10,86,49,0,0
26,10/05/2021,3,2,64,26,38,55,0,0
781,18/05/2021,3,5,78,38,40,49,0,0
322,13/05/2021,3,0,100,15,85,49,0,0
326,17/05/2021,3,4,77,51,26,67,0,0
767,15/05/2021,3,0,67,8,59,49,0,0
775,01/05/2021,3,2,107,10,97,49,0,0
359,08/05/2021,3,3,101,54,47,49,0,0
902,12/05/2021,3,2,124,42,82,49,0,0
189,16/05/2021,3,0,165,37,128,49,0,0
455,17/05/2021,3,8,243,25,218,66,0,0
88,18/05/2021,3,1,41,28,13,60,0,0
501,18/05/2021,3,26,207,48,159,49,0,0
93,23/05/2021,3,3,138,48,90,49,0,0
112,13/05/2021,3,0,84,52,32,49,0,0
618,12/05/2021,3,12,139,53,86,49,0,0
577,03/05/2021,3,0,78,8,70,49,0,0
635,07/05/2021,3,1,87,26,61,49,0,0
517,15/05/2021,3,0,58,21,37,49,0,0
36,08/05/2021,3,1,62,11,51,49,0,0
470,02/05/2021,3,1,79,20,59,49,0,0
552,13/05/2021,3,12,172,26,146,49,0,0
319,20/05/2021,3,7,107,92,15,62,0,0
7,13/05/2021,3,6,97,60,37,55,0,0
68,10/05/2021,3,0,116,2,114,49,0,0
268,08/05/2021,3,1,77,28,49,49,0,0
195,09/05/2021,3,1,50,6,44,49,0,0
155,17/05/2021,3,0,93,71,22,57,0,0
464,15/05/2021,3,1,265,17,248,66,0,0
427,17/05/2021,3,6,304,25,279,66,0,0
394,19/05/2021,3,1,67,31,36,49,0,0
551,12/05/2021,3,0,115,65,50,52,0,0
749,14/05/2021,3,5,149,14,135,49,0,0
710,11/05/2021,3,0,20,8,12,64,0,0
540,14/05/2021,3,2,80,16,64,49,0,0
784,22/05/2021,3,2,47,47,0,NA,NA,NA
315,02/05/2021,3,0,62,33,29,55,0,0
521,13/05/2021,3,1,54,20,34,49,0,0
705,13/05/2021,3,1,90,31,59,49,0,0
770,19/05/2021,3,2,33,19,14,60,0,0
525,18/05/2021,3,1,74,60,14,74,0,0
47,07/05/2021,3,2,55,14,41,49,0,0
823,11/05/2021,3,1,60,33,27,52,0,0
369,14/05/2021,3,13,77,7,70,49,0,0
917,18/05/2021,3,1,105,19,86,35,0,0
639,23/05/2021,3,0,59,9,50,49,0,0
555,18/05/2021,3,0,117,83,34,64,0,0
597,26/05/2021,3,4,97,44,53,49,0,0
43,19/05/2021,3,2,71,50,21,80,0,0
838,17/05/2021,3,3,62,44,18,57,0,0
271,17/05/2021,3,0,70,40,30,49,0,0
589,19/05/2021,3,4,139,93,46,55,0,0
510,11/05/2021,3,1,142,17,125,49,0,0
77,22/05/2021,3,0,103,78,25,165,0,0
750,16/05/2021,3,85,27,11,16,49,0,0
407,18/05/2021,3,1,40,13,27,49,0,0
791,20/05/2021,3,34,94,72,22,57,0,0
850,20/05/2021,3,2,81,63,18,52,0,0
752,20/05/2021,3,13,31,21,10,57,0,0
121,16/05/2021,3,0,110,56,54,49,0,0
345,10/05/2021,3,0,101,93,8,85,0,0
254,19/05/2021,3,1,77,46,31,60,0,0
438,11/05/2021,3,11,85,29,56,95,0,0
452,17/05/2021,3,3,57,41,16,60,0,0
623,14/05/2021,3,0,78,8,70,49,0,0
41,01/05/2021,3,1,83,11,72,49,0,0
359,09/05/2021,3,3,101,14,87,49,0,0
807,20/05/2021,3,1,99,82,17,67,0,0
895,16/05/2021,3,0,69,13,56,49,0,0
653,20/05/2021,3,2,113,46,67,49,0,0
88,19/05/2021,3,1,41,31,10,74,0,0
870,17/05/2021,3,4,42,38,4,79,0,0
883,17/05/2021,3,6,98,11,87,45,0,0
402,16/05/2021,3,0,155,25,130,49,0,0
21,11/05/2021,3,1,59,6,53,49,0,0
44,19/05/2021,3,4,104,104,0,NA,NA,NA
635,08/05/2021,3,1,87,23,64,49,0,0
260,18/05/2021,3,1,119,91,28,52,0,0
273,07/05/2021,3,0,103,103,0,NA,NA,NA
801,02/05/2021,3,7,160,19,141,49,0,0
116,18/05/2021,3,0,61,61,0,NA,NA,NA
716,20/05/2021,3,0,104,83,21,74,0,0
298,13/05/2021,3,2,227,63,164,49,0,0
68,12/05/2021,3,0,116,7,109,49,0,0
471,08/05/2021,3,8,112,43,69,49,0,0
802,06/05/2021,3,1,64,42,22,64,0,0
318,17/05/2021,3,0,59,55,4,89,0,0
464,16/05/2021,3,1,265,13,252,66,0,0
875,17/05/2021,3,2,90,64,26,55,0,0
816,21/05/2021,3,1,81,81,0,NA,NA,NA
551,13/05/2021,3,0,115,77,38,52,0,0
87,15/05/2021,3,1,117,13,104,49,0,0
370,12/05/2021,3,0,40,9,31,59,0,0
853,15/05/2021,3,2,100,11,89,49,0,0
182,21/05/2021,3,2,78,45,33,55,0,0
169,03/05/2021,3,0,20,6,14,59,0,0
230,17/05/2021,3,0,80,22,58,49,0,0
424,24/05/2021,3,1,27,24,3,86,0,0
456,21/05/2021,3,4,86,70,16,57,0,0
806,15/05/2021,3,1,135,47,88,49,0,0
242,09/05/2021,3,2,136,40,96,49,0,0
1,08/05/2021,3,3,97,16,81,49,0,0
487,14/05/2021,3,4,35,8,27,49,0,0
183,18/05/2021,3,0,80,66,14,59,0,0
627,24/05/2021,3,0,41,19,22,64,0,0
581,18/05/2021,3,60,165,145,20,80,0,0
251,27/05/2021,3,2,122,47,75,49,0,0
311,19/05/2021,3,0,97,64,33,60,0,0
584,17/05/2021,3,2,95,66,29,67,0,0
184,17/05/2021,3,0,51,40,11,93,0,0
607,19/05/2021,3,1,74,57,17,74,0,0
412,12/05/2021,3,3,98,26,72,49,0,0
215,22/05/2021,3,0,46,40,6,79,0,0
84,15/05/2021,3,0,20,13,7,60,0,0
357,19/05/2021,3,1,82,63,19,67,0,0
256,21/05/2021,3,1,108,71,37,67,0,0
144,20/05/2021,3,1,98,63,35,52,0,0
863,18/05/2021,3,3,92,42,50,52,0,0
855,22/05/2021,3,3,173,121,52,67,0,0
317,12/05/2021,3,0,80,42,38,64,0,0
676,25/05/2021,3,2,113,92,21,49,0,0
438,12/05/2021,3,14,82,42,40,89,0,0
127,15/05/2021,3,1,59,16,43,49,0,0
108,14/05/2021,3,0,78,13,65,49,0,0
602,01/05/2021,3,0,64,11,53,49,0,0
261,10/05/2021,3,2,100,22,78,49,0,0
338,18/05/2021,3,0,400,106,294,49,0,0
777,18/05/2021,3,3,117,94,23,67,0,0
621,19/05/2021,3,0,60,52,8,89,0,0
19,17/05/2021,3,1,93,54,39,49,0,0
355,18/05/2021,3,2,97,69,28,67,0,0
93,18/05/2021,3,3,138,130,8,49,0,0
408,16/05/2021,3,6,159,12,147,49,0,0
827,11/05/2021,3,1,69,24,45,55,0,0
44,21/05/2021,3,4,104,104,0,NA,NA,NA
663,08/05/2021,3,0,148,7,141,49,0,0
517,19/05/2021,3,1,57,50,7,63,0,0
36,24/05/2021,3,1,62,32,30,49,0,0
50,03/05/2021,3,2,119,19,100,49,0,0
116,19/05/2021,3,0,61,61,0,NA,NA,NA
301,20/05/2021,3,1,100,43,57,49,0,0
497,19/05/2021,3,4,189,89,100,49,0,0
68,11/05/2021,3,0,116,5,111,49,0,0
730,08/05/2021,3,2,73,4,69,49,0,0
59,06/05/2021,3,0,75,7,68,49,0,0
478,17/05/2021,3,0,20,15,5,85,0,0
813,16/05/2021,3,1,129,13,116,49,0,0
51,17/05/2021,3,2,78,62,16,67,0,0
12,21/05/2021,3,2,41,30,11,67,0,0
563,10/05/2021,3,1,69,27,42,52,0,0
435,20/05/2021,3,51,69,36,33,49,0,0
710,10/05/2021,3,0,20,6,14,55,0,0
853,16/05/2021,3,2,100,21,79,49,0,0
401,19/05/2021,3,0,79,68,11,67,0,0
548,15/05/2021,3,1,90,19,71,49,0,0
734,17/05/2021,3,2,59,58,1,89,0,0
424,21/05/2021,3,1,27,19,8,49,0,0
587,21/05/2021,3,2,79,48,31,75,0,0
152,16/05/2021,3,1,90,17,73,49,0,0
826,11/05/2021,3,2,96,27,69,49,0,0
514,10/05/2021,3,5,229,36,193,49,0,0
369,15/05/2021,3,25,65,14,51,49,0,0
755,24/05/2021,3,0,87,86,1,108,0,0
197,24/05/2021,3,0,118,23,95,49,0,0
145,17/05/2021,3,3,55,24,31,55,0,0
436,27/05/2021,3,9,197,108,89,49,0,0
356,19/05/2021,3,2,134,89,45,60,0,0
362,19/05/2021,3,4,116,116,0,NA,NA,NA
190,22/05/2021,3,5,75,70,5,74,0,0
864,19/05/2021,3,1,84,34,50,64,0,0
582,09/05/2021,3,0,53,10,43,49,0,0
323,22/05/2021,3,0,31,30,1,115,0,0
385,23/05/2021,3,3,60,44,16,67,0,0
821,20/05/2021,3,0,79,73,6,80,0,0
791,21/05/2021,3,25,103,79,24,57,0,0
842,22/05/2021,3,1,90,49,41,96,0,0
235,19/05/2021,3,6,151,36,115,49,0,0
32,22/05/2021,3,1,104,81,23,87,0,0
345,13/05/2021,3,0,101,73,28,72,0,0
781,25/05/2021,3,2,81,60,21,62,0,0
403,12/05/2021,3,2,96,50,46,55,0,0
861,15/05/2021,3,0,61,35,26,55,0,0
392,14/05/2021,3,0,176,16,160,49,0,0
793,01/05/2021,3,1,130,10,120,49,0,0
82,10/05/2021,3,0,96,63,33,64,0,0
411,19/05/2021,3,0,185,113,72,49,0,0
187,18/05/2021,3,1,40,16,24,49,0,0
156,20/05/2021,3,0,148,93,55,52,0,0
334,17/05/2021,3,1,57,35,22,49,0,0
80,19/05/2021,3,2,123,68,55,52,0,0
795,19/05/2021,3,7,98,74,24,55,0,0
535,16/05/2021,3,2,81,10,71,49,0,0
31,12/05/2021,3,1,62,26,36,57,0,0
876,01/05/2021,3,1,181,28,153,45,0,0
140,08/05/2021,3,0,170,44,126,49,0,0
24,19/05/2021,3,1,83,69,14,62,0,0
273,22/05/2021,3,0,103,96,7,144,0,0
23,04/05/2021,3,5,59,28,31,49,0,0
606,18/05/2021,3,1,45,13,32,49,0,0
301,21/05/2021,3,1,100,35,65,55,0,0
123,19/05/2021,3,0,95,44,51,49,0,0
9,14/05/2021,3,0,27,12,15,49,0,0
303,09/05/2021,3,1,64,22,42,49,0,0
309,08/05/2021,3,0,16,9,7,49,0,0
237,22/05/2021,3,6,115,94,21,60,0,0
760,15/05/2021,3,1,35,6,29,49,0,0
321,15/05/2021,3,1,39,3,36,49,0,0
527,22/05/2021,3,8,53,53,0,NA,NA,NA
758,10/05/2021,3,0,73,41,32,60,0,0
533,20/05/2021,3,1,90,19,71,49,0,0
370,14/05/2021,3,0,40,8,32,49,0,0
768,14/05/2021,3,1,86,15,71,49,0,0
522,19/05/2021,3,4,58,47,11,62,0,0
871,14/05/2021,3,2,76,25,51,49,0,0
258,17/05/2021,3,0,143,98,45,60,0,0
780,25/05/2021,3,0,60,42,18,66,0,0
721,21/05/2021,3,28,112,107,5,150,0,0
525,16/05/2021,3,1,74,11,63,49,0,0
879,10/05/2021,3,3,161,5,156,39,0,0
660,10/05/2021,3,6,180,32,148,49,0,0
685,15/05/2021,3,3,137,31,106,49,0,0
755,23/05/2021,3,0,87,63,24,84,0,0
307,24/05/2021,3,1,78,57,21,62,0,0
200,18/05/2021,3,5,114,100,14,74,0,0
597,27/05/2021,3,4,97,56,41,49,0,0
783,19/05/2021,3,3,77,57,20,80,0,0
584,19/05/2021,3,1,96,96,0,NA,NA,NA
243,19/05/2021,3,1,126,64,62,49,0,0
17,20/05/2021,3,1,93,74,19,74,0,0
102,12/05/2021,3,0,60,21,39,55,0,0
75,24/05/2021,3,0,81,59,22,77,0,0
143,22/05/2021,3,2,118,106,12,143,0,0
407,09/05/2021,3,1,40,0,40,49,0,0
386,20/05/2021,3,2,83,68,15,57,0,0
124,22/05/2021,3,0,54,51,3,67,0,0
863,19/05/2021,3,5,90,31,59,49,0,0
831,22/05/2021,3,1,149,66,83,49,0,0
812,15/05/2021,3,2,135,19,116,49,0,0
869,25/05/2021,3,9,51,46,5,189,0,0
308,10/05/2021,3,2,46,4,42,49,0,0
227,16/05/2021,3,2,42,22,20,49,0,0
108,15/05/2021,3,0,78,13,65,49,0,0
449,01/05/2021,3,7,88,11,77,66,0,0
359,05/05/2021,3,3,101,55,46,59,0,0
330,20/05/2021,3,3,116,42,74,49,0,0
380,18/05/2021,3,1,159,71,88,49,0,0
741,20/05/2021,3,0,70,63,7,57,0,0
334,18/05/2021,3,1,57,41,16,67,0,0
610,19/05/2021,3,1,66,35,31,60,0,0
883,19/05/2021,3,6,98,17,81,45,0,0
83,17/05/2021,3,25,143,98,45,49,0,0
664,10/05/2021,3,3,152,45,107,49,0,0
876,02/05/2021,3,1,181,30,151,45,0,0
140,12/05/2021,3,0,170,66,104,49,0,0
578,19/05/2021,3,1,57,37,20,52,0,0
273,23/05/2021,3,0,103,89,14,107,0,0
801,04/05/2021,3,7,160,32,128,49,0,0
771,18/05/2021,3,2,28,27,1,71,0,0
724,21/05/2021,3,3,83,75,8,131,0,0
798,20/05/2021,3,1,80,79,1,90,0,0
9,13/05/2021,3,0,27,20,7,72,0,0
546,10/05/2021,3,9,143,3,140,49,0,0
59,07/05/2021,3,0,75,5,70,49,0,0
458,21/05/2021,3,4,177,147,30,52,0,0
139,14/05/2021,3,2,57,7,50,49,0,0
266,14/05/2021,3,0,61,23,38,49,0,0
529,22/05/2021,3,3,38,38,0,NA,NA,NA
563,11/05/2021,3,1,69,24,45,67,0,0
749,20/05/2021,3,4,150,37,113,49,0,0
852,14/05/2021,3,0,80,64,16,57,0,0
833,15/05/2021,3,1,82,23,59,49,0,0
666,19/05/2021,3,2,64,43,21,57,0,0
747,12/05/2021,3,0,64,51,13,80,0,0
364,17/05/2021,3,2,128,111,17,72,0,0
711,21/05/2021,3,0,89,65,24,67,0,0
746,19/05/2021,3,2,58,38,20,64,0,0
67,16/05/2021,3,0,52,11,41,49,0,0
488,11/05/2021,3,3,63,51,12,72,0,0
514,11/05/2021,3,5,229,41,188,49,0,0
731,15/05/2021,3,7,92,21,71,49,0,0
106,23/05/2021,3,1,30,17,13,62,0,0
627,22/05/2021,3,0,41,41,0,67,0,0
444,17/05/2021,3,4,115,54,61,49,0,0
436,28/05/2021,3,10,196,78,118,49,0,0
907,19/05/2021,3,3,77,57,20,60,0,0
574,19/05/2021,3,12,75,25,50,49,0,0
778,19/05/2021,3,2,79,72,7,85,0,0
607,20/05/2021,3,1,74,48,26,60,0,0
102,09/05/2021,3,0,60,12,48,49,0,0
619,24/05/2021,3,0,101,73,28,67,0,0
805,22/05/2021,3,2,111,102,9,74,0,0
5,09/05/2021,3,68,21,20,1,103,0,0
386,21/05/2021,3,2,83,67,16,67,0,0
185,18/05/2021,3,1,167,61,106,49,0,0
235,20/05/2021,3,5,152,46,106,49,0,0
505,23/05/2021,3,0,84,16,68,49,0,0
146,16/05/2021,3,2,39,13,26,49,0,0
419,24/05/2021,3,6,104,50,54,85,0,0
308,11/05/2021,3,2,46,7,39,49,0,0
310,16/05/2021,3,1,71,23,48,49,0,0
392,15/05/2021,3,0,176,31,145,49,0,0
722,12/05/2021,3,0,42,30,12,80,0,0
288,08/05/2021,3,0,60,26,34,49,0,0
338,20/05/2021,3,0,400,125,275,49,0,0
696,18/05/2021,3,1,88,59,29,52,0,0
562,20/05/2021,3,0,68,51,17,57,0,0
19,19/05/2021,3,1,93,65,28,52,0,0
610,18/05/2021,3,1,66,39,27,60,0,0
858,19/05/2021,3,0,81,78,3,147,0,0
272,17/05/2021,3,1,126,46,80,49,0,0
363,10/05/2021,3,4,95,73,22,64,0,0
876,04/05/2021,3,1,181,55,126,45,0,0
140,09/05/2021,3,0,170,38,132,49,0,0
24,17/05/2021,3,3,81,50,31,49,0,0
283,24/05/2021,3,0,76,18,58,55,0,0
849,04/05/2021,3,1,83,21,62,49,0,0
331,19/05/2021,3,29,65,60,5,95,0,0
459,20/05/2021,3,4,88,62,26,52,0,0
7,19/05/2021,3,2,101,52,49,55,0,0
9,11/05/2021,3,0,27,26,1,82,0,0
546,12/05/2021,3,9,143,5,138,49,0,0
59,09/05/2021,3,0,75,3,72,49,0,0
458,22/05/2021,3,4,177,148,29,57,0,0
642,15/05/2021,3,2,93,24,69,49,0,0
321,14/05/2021,3,1,39,3,36,49,0,0
390,21/05/2021,3,2,134,113,21,67,0,0
872,13/05/2021,3,1,64,44,20,59,0,0
246,20/05/2021,3,1,111,31,80,49,0,0
615,14/05/2021,3,0,71,15,56,49,0,0
898,15/05/2021,3,1,99,22,77,49,0,0
281,20/05/2021,3,1,82,66,16,57,0,0
315,12/05/2021,3,0,62,45,17,72,0,0
521,17/05/2021,3,1,54,36,18,52,0,0
780,22/05/2021,3,0,60,57,3,107,0,0
27,19/05/2021,3,0,78,74,4,90,0,0
498,16/05/2021,3,0,87,27,60,49,0,0
704,11/05/2021,3,1,31,8,23,52,0,0
265,10/05/2021,3,1,56,17,39,49,0,0
583,16/05/2021,3,2,79,23,56,49,0,0
932,22/05/2021,3,23,84,12,72,45,0,0
270,22/05/2021,3,1,59,49,10,131,0,0
809,17/05/2021,3,5,96,55,41,49,0,0
399,28/05/2021,3,1,60,60,0,NA,NA,NA
500,20/05/2021,3,5,74,46,28,52,0,0
484,18/05/2021,3,0,40,33,7,84,0,0
593,20/05/2021,3,7,74,60,14,89,0,0
607,21/05/2021,3,1,74,54,20,60,0,0
134,11/05/2021,3,1,47,21,26,55,0,0
384,25/05/2021,3,0,101,85,16,80,0,0
34,22/05/2021,3,2,86,40,46,49,0,0
5,11/05/2021,3,5,84,43,41,60,0,47
490,21/05/2021,3,7,158,19,139,49,0,0
850,21/05/2021,3,1,82,75,7,72,0,0
863,20/05/2021,3,1,94,52,42,49,0,0
855,23/05/2021,3,3,173,61,112,49,0,0
240,16/05/2021,3,1,70,16,54,49,0,0
254,24/05/2021,3,1,77,38,39,67,0,0
509,12/05/2021,3,1,111,33,78,49,0,0
452,16/05/2021,3,1,59,24,35,55,0,0
108,16/05/2021,3,0,78,8,70,49,0,0
775,16/05/2021,3,4,105,13,92,49,0,0
495,07/05/2021,3,2,83,7,76,49,0,0
304,20/05/2021,3,2,58,36,22,52,0,0
895,19/05/2021,3,0,69,65,4,77,0,0
641,20/05/2021,3,0,160,47,113,49,0,0
738,17/05/2021,3,1,123,88,35,60,0,0
340,21/05/2021,3,16,118,11,107,49,0,0
558,17/05/2021,3,0,44,25,19,49,0,0
112,16/05/2021,3,0,84,30,54,49,0,0
214,11/05/2021,3,4,82,55,27,52,0,0
876,03/05/2021,3,1,181,48,133,45,0,0
840,11/05/2021,3,0,312,60,252,49,0,0
651,17/05/2021,3,1,77,33,44,49,0,0
503,22/05/2021,3,0,184,107,77,55,0,0
23,05/05/2021,3,3,61,26,35,49,0,0
351,19/05/2021,3,2,64,45,19,67,0,0
98,21/05/2021,3,2,93,70,23,80,0,0
7,21/05/2021,3,2,101,22,79,55,0,0
9,12/05/2021,3,0,27,23,4,80,0,0
730,12/05/2021,3,2,73,8,65,49,0,0
161,06/05/2021,3,1,60,15,45,55,0,0
628,22/05/2021,3,2,57,56,1,113,0,0
72,16/05/2021,3,2,58,15,43,49,0,0
427,15/05/2021,3,6,304,3,301,66,0,0
394,22/05/2021,3,0,68,48,20,60,0,0
373,10/05/2021,3,1,102,50,52,55,0,0
87,20/05/2021,3,1,117,36,81,49,0,0
122,11/05/2021,3,6,115,79,36,64,0,0
540,16/05/2021,3,1,81,20,61,49,0,0
882,18/05/2021,3,0,130,44,86,39,0,0
747,13/05/2021,3,0,64,43,21,64,0,0
258,18/05/2021,3,1,142,113,29,74,0,0
170,24/05/2021,3,0,105,92,13,65,0,0
567,19/05/2021,3,0,61,51,10,79,0,0
57,15/05/2021,3,1,139,24,115,49,0,0
488,08/05/2021,3,1,65,20,45,49,0,0
111,07/05/2021,3,0,60,18,42,49,0,0
841,14/05/2021,3,0,182,19,163,49,0,0
932,23/05/2021,3,13,94,8,86,45,0,0
665,24/05/2021,3,2,104,66,38,74,0,0
442,18/05/2021,3,10,148,61,87,49,0,0
269,18/05/2021,3,0,80,12,68,49,0,0
43,20/05/2021,3,2,71,47,24,60,0,0
714,19/05/2021,3,0,59,32,27,72,0,0
131,22/05/2021,3,4,45,23,22,55,0,0
198,20/05/2021,3,1,134,119,15,82,0,0
102,10/05/2021,3,0,60,27,33,55,0,0
75,21/05/2021,3,0,81,61,20,77,0,0
34,23/05/2021,3,3,85,29,56,49,0,0
174,11/05/2021,3,2,26,14,12,77,0,0
53,21/05/2021,3,0,70,67,3,117,0,0
604,21/05/2021,3,0,82,60,22,80,0,0
60,19/05/2021,3,0,57,30,27,64,0,0
434,23/05/2021,3,3,57,8,49,49,0,0
317,16/05/2021,3,0,80,27,53,49,0,0
207,24/05/2021,3,2,61,38,23,59,0,0
579,11/05/2021,3,0,44,10,34,49,0,0
222,17/05/2021,3,0,77,30,47,49,0,0
177,16/05/2021,3,0,48,14,34,49,0,0
793,12/05/2021,3,1,130,28,102,49,0,0
495,09/05/2021,3,2,83,11,72,49,0,0
807,18/05/2021,3,1,99,53,46,59,0,0
305,14/05/2021,3,5,54,4,50,49,0,0
621,20/05/2021,3,0,60,53,7,83,0,0
723,17/05/2021,3,1,80,39,41,49,0,0
697,20/05/2021,3,3,106,57,49,49,0,0
558,18/05/2021,3,0,44,29,15,60,0,0
535,17/05/2021,3,2,81,24,57,49,0,0
208,10/05/2021,3,0,60,22,38,55,0,0
44,01/05/2021,3,6,102,102,0,NA,NA,NA
877,07/05/2021,3,0,158,24,134,35,0,0
661,18/05/2021,3,2,170,31,139,49,0,0
503,23/05/2021,3,0,184,35,149,49,0,0
23,03/05/2021,3,4,60,14,46,49,0,0
116,20/05/2021,3,0,61,56,5,85,0,0
329,20/05/2021,3,9,98,24,74,161,0,0
196,20/05/2021,3,0,138,17,121,49,0,0
428,11/05/2021,3,3,89,43,46,59,0,0
800,12/05/2021,3,2,55,18,37,49,0,0
309,06/05/2021,3,0,16,9,7,55,0,0
786,22/05/2021,3,2,60,42,18,135,0,0
760,16/05/2021,3,3,33,5,28,49,0,0
321,13/05/2021,3,1,39,5,34,49,0,0
862,22/05/2021,3,1,109,91,18,132,0,0
569,12/05/2021,3,0,120,16,104,49,0,0
625,20/05/2021,3,1,160,83,77,49,0,0
122,12/05/2021,3,8,113,70,43,64,0,0
768,16/05/2021,3,1,86,16,70,49,0,0
450,18/05/2021,3,4,180,53,127,49,0,0
315,13/05/2021,3,0,62,40,22,64,0,0
325,18/05/2021,3,0,45,28,17,55,0,0
170,25/05/2021,3,0,105,92,13,79,0,0
567,20/05/2021,3,0,61,44,17,67,0,0
368,15/05/2021,3,1,84,20,64,49,0,0
765,08/05/2021,3,1,100,40,60,49,0,0
391,07/05/2021,3,0,76,8,68,49,0,0
263,15/05/2021,3,0,66,22,44,49,0,0
932,15/05/2021,3,10,97,0,97,45,0,0
639,24/05/2021,3,0,59,20,39,49,0,0
809,18/05/2021,3,3,98,62,36,49,0,0
15,18/05/2021,3,0,31,24,7,80,0,0
43,21/05/2021,3,2,71,56,15,74,0,0
598,19/05/2021,3,0,146,144,2,90,0,0
365,19/05/2021,3,0,68,68,0,NA,NA,NA
648,20/05/2021,3,1,63,36,27,64,0,0
134,10/05/2021,3,1,47,24,23,55,0,0
215,21/05/2021,3,0,46,39,7,74,0,0
805,23/05/2021,3,2,111,54,57,49,0,0
174,09/05/2021,3,2,26,1,25,49,0,0
96,19/05/2021,3,14,55,46,9,70,0,0
289,18/05/2021,3,1,67,37,30,60,0,0
60,20/05/2021,3,0,57,45,12,64,0,0
709,23/05/2021,3,0,83,58,25,54,0,0
345,17/05/2021,3,0,101,97,4,93,0,0
515,24/05/2021,3,7,105,58,47,52,0,0
579,13/05/2021,3,0,44,16,28,49,0,0
426,17/05/2021,3,10,153,91,62,55,0,0
366,16/05/2021,3,0,80,23,57,49,0,0
41,13/05/2021,3,1,83,50,33,55,0,0
261,06/05/2021,3,3,99,32,67,49,0,0
411,18/05/2021,3,0,185,119,66,49,0,0
305,15/05/2021,3,4,55,3,52,49,0,0
641,19/05/2021,3,0,160,54,106,49,0,0
19,18/05/2021,3,1,93,41,52,49,0,0
501,21/05/2021,3,26,207,145,62,60,0,0
613,19/05/2021,3,0,56,45,11,70,0,0
899,17/05/2021,3,3,102,82,20,71,0,0
225,10/05/2021,3,13,67,42,25,55,0,0
532,05/05/2021,3,0,84,55,29,72,0,0
463,08/05/2021,3,0,163,20,143,55,0,0
469,19/05/2021,3,4,192,40,152,66,0,0
13,23/05/2021,3,4,77,29,48,49,0,0
896,04/05/2021,3,0,82,30,52,49,0,0
81,18/05/2021,3,1,59,23,36,52,0,0
814,20/05/2021,3,1,67,64,3,85,0,0
157,21/05/2021,3,1,82,69,13,105,0,0
344,14/05/2021,3,1,64,19,45,49,0,0
546,11/05/2021,3,9,143,2,141,49,0,0
473,06/05/2021,3,3,47,27,20,55,0,0
279,22/05/2021,3,0,57,44,13,67,0,0
292,15/05/2021,3,0,239,239,0,NA,NA,NA
684,15/05/2021,3,2,96,5,91,49,0,0
739,21/05/2021,3,2,73,28,45,55,0,0
839,12/05/2021,3,3,152,52,100,49,0,0
435,21/05/2021,3,51,69,29,40,49,0,0
745,11/05/2021,3,2,103,45,58,55,0,0
48,17/05/2021,3,1,178,4,174,49,0,0
267,19/05/2021,3,3,80,76,4,49,0,0
726,13/05/2021,3,0,39,24,15,64,0,0
521,19/05/2021,3,1,54,36,18,60,0,0
638,25/05/2021,3,0,101,77,24,72,0,0
168,20/05/2021,3,0,48,31,17,80,0,0
657,15/05/2021,3,0,48,18,30,49,0,0
759,07/05/2021,3,2,85,20,65,49,0,0
391,08/05/2021,3,0,76,16,60,49,0,0
634,16/05/2021,3,0,20,11,9,49,0,0
932,16/05/2021,3,30,77,0,77,45,0,0
554,22/05/2021,3,0,42,42,0,NA,NA,NA
25,17/05/2021,3,1,51,43,8,57,0,0
192,19/05/2021,3,0,86,63,23,62,0,0
114,21/05/2021,3,1,74,63,11,112,0,0
404,19/05/2021,3,0,67,66,1,90,0,0
526,22/05/2021,3,1,37,37,0,NA,NA,NA
413,19/05/2021,3,2,114,102,12,65,0,0
199,10/05/2021,3,2,80,45,35,55,0,0
323,21/05/2021,3,0,31,25,6,67,0,0
886,22/05/2021,3,1,151,105,46,49,0,0
679,11/05/2021,3,2,87,75,12,82,0,0
2,20/05/2021,3,2,57,40,17,72,0,0
842,21/05/2021,3,1,90,47,43,79,0,0
534,18/05/2021,3,0,85,32,53,49,0,0
277,23/05/2021,3,6,66,25,41,49,0,0
148,19/05/2021,3,0,25,20,5,63,0,0
629,24/05/2021,3,5,57,55,2,65,0,0
322,11/05/2021,3,0,100,19,81,49,0,0
52,15/05/2021,3,9,133,50,83,49,0,0
392,16/05/2021,3,0,176,18,158,49,0,0
41,14/05/2021,3,1,83,23,60,49,0,0
843,08/05/2021,3,4,62,19,43,49,0,0
493,18/05/2021,3,1,34,20,14,49,0,0
423,15/05/2021,3,1,49,49,0,NA,NA,NA
741,19/05/2021,3,0,70,40,30,49,0,0
172,17/05/2021,3,2,83,70,13,63,0,0
859,21/05/2021,3,1,84,59,25,49,0,0
477,18/05/2021,3,3,117,37,80,49,0,0
248,17/05/2021,3,0,82,46,36,55,0,0
827,10/05/2021,3,1,69,33,36,55,0,0
719,09/05/2021,3,0,41,8,33,49,0,0
877,10/05/2021,3,0,158,38,120,35,0,0
461,20/05/2021,3,2,120,13,107,66,0,0
468,25/05/2021,3,3,93,49,44,49,0,0
849,01/05/2021,3,1,83,6,77,49,0,0
388,18/05/2021,3,1,59,53,6,55,0,0
716,21/05/2021,3,0,104,93,11,57,0,0
196,21/05/2021,3,0,138,49,89,55,0,0
542,14/05/2021,3,4,71,21,50,49,0,0
471,10/05/2021,3,8,112,67,45,55,0,0
59,08/05/2021,3,0,75,13,62,49,0,0
318,21/05/2021,3,0,59,51,8,66,0,0
782,16/05/2021,3,0,20,9,11,55,0,42
51,14/05/2021,3,2,78,18,60,49,0,0
167,22/05/2021,3,0,84,82,2,110,0,0
113,13/05/2021,3,1,31,16,15,49,0,0
374,20/05/2021,3,0,56,30,26,49,0,0
745,12/05/2021,3,2,103,45,58,55,0,0
397,17/05/2021,3,0,75,51,24,60,0,0
450,19/05/2021,3,4,180,57,123,49,0,0
649,12/05/2021,3,3,61,36,25,59,0,0
49,17/05/2021,3,9,139,33,106,49,0,0
866,25/05/2021,3,0,100,44,56,67,0,0
90,19/05/2021,3,0,78,78,0,NA,NA,NA
669,15/05/2021,3,0,87,18,69,49,0,0
759,08/05/2021,3,2,85,19,66,49,0,0
371,10/05/2021,3,0,36,15,21,84,0,0
624,15/05/2021,3,0,79,8,71,49,0,0
106,14/05/2021,3,1,30,4,26,49,0,0
674,14/05/2021,3,1,97,3,94,49,0,0
133,18/05/2021,3,2,62,29,33,49,0,0
186,18/05/2021,3,1,57,45,12,62,0,0
712,19/05/2021,3,1,84,19,65,49,0,0
362,18/05/2021,3,4,116,116,0,NA,NA,NA
131,12/05/2021,3,2,47,18,29,57,0,0
42,20/05/2021,3,2,97,91,6,63,0,0
341,10/05/2021,3,3,111,103,8,77,0,0
77,25/05/2021,3,0,103,53,50,97,0,0
285,23/05/2021,3,1,79,43,36,49,0,0
316,09/05/2021,3,1,38,11,27,49,0,0
490,19/05/2021,3,6,159,24,135,49,0,0
185,19/05/2021,3,1,167,61,106,49,0,0
632,19/05/2021,3,0,82,41,41,59,0,0
32,23/05/2021,3,1,104,48,56,49,0,0
810,19/05/2021,3,0,389,34,355,55,0,0
867,24/05/2021,3,1,59,58,1,118,0,0
509,11/05/2021,3,1,111,38,73,49,0,0
426,15/05/2021,3,9,154,55,99,49,0,0
623,16/05/2021,3,0,78,14,64,49,0,0
722,16/05/2021,3,0,42,9,33,49,0,0
82,04/05/2021,3,0,96,42,54,60,0,0
338,19/05/2021,3,0,400,109,291,49,0,0
380,15/05/2021,3,1,159,33,126,49,0,0
414,11/05/2021,3,18,168,14,154,49,0,0
890,17/05/2021,3,67,83,23,60,57,0,0
188,21/05/2021,3,7,114,60,54,55,0,0
93,19/05/2021,3,3,138,106,32,49,0,0
264,17/05/2021,3,1,59,37,22,60,0,0
346,11/05/2021,3,5,115,70,45,55,0,0
874,12/05/2021,3,0,89,6,83,49,0,0
655,12/05/2021,3,0,72,42,30,64,0,0
680,20/05/2021,3,3,77,38,39,49,0,0
395,22/05/2021,3,2,70,60,10,77,0,0
23,02/05/2021,3,2,62,23,39,49,0,0
388,19/05/2021,3,1,59,48,11,74,0,0
808,21/05/2021,3,0,168,166,2,80,0,0
774,21/05/2021,3,4,101,36,65,55,0,0
135,11/05/2021,3,5,61,31,30,60,0,0
682,12/05/2021,3,2,78,27,51,55,0,0
195,07/05/2021,3,1,50,4,46,49,0,0
565,21/05/2021,3,0,62,35,27,81,0,0
782,14/05/2021,3,0,20,10,10,49,0,38
427,14/05/2021,3,6,304,5,299,66,0,0
173,21/05/2021,3,2,69,50,19,67,0,0
569,13/05/2021,3,0,120,18,102,49,0,0
737,22/05/2021,3,2,40,34,6,67,0,0
171,12/05/2021,3,2,47,33,14,52,0,0
851,14/05/2021,3,0,92,4,88,49,0,0
296,20/05/2021,3,2,58,39,19,49,0,0
297,12/05/2021,3,3,73,35,38,55,0,0
325,17/05/2021,3,0,45,19,26,49,0,0
711,25/05/2021,3,0,89,83,6,85,0,0
746,20/05/2021,3,2,58,58,0,NA,NA,NA
211,16/05/2021,3,3,57,11,46,49,0,0
18,11/05/2021,3,2,90,47,43,55,0,0
878,11/05/2021,3,0,218,8,210,44,0,0
440,14/05/2021,3,0,265,3,262,66,0,0
106,16/05/2021,3,1,30,4,26,49,0,0
307,14/05/2021,3,3,76,7,69,49,0,0
591,18/05/2021,3,0,68,52,16,80,0,0
512,18/05/2021,3,1,61,30,31,49,0,0
566,19/05/2021,3,1,74,41,33,52,0,0
647,18/05/2021,3,4,89,83,6,63,0,0
151,12/05/2021,3,7,69,37,32,67,0,0
332,20/05/2021,3,0,40,15,25,55,0,0
39,10/05/2021,3,1,60,46,14,67,0,0
384,21/05/2021,3,0,101,96,5,77,0,0
886,23/05/2021,3,1,151,101,50,49,0,0
38,11/05/2021,3,1,49,35,14,49,0,0
53,19/05/2021,3,0,70,68,2,147,0,0
185,22/05/2021,3,0,168,98,70,49,0,0
534,20/05/2021,3,0,85,37,48,49,0,0
121,23/05/2021,3,1,109,98,11,83,0,0
146,17/05/2021,3,2,39,32,7,79,0,0
65,24/05/2021,3,1,77,36,41,49,0,0
322,12/05/2021,3,0,100,16,84,49,0,0
426,16/05/2021,3,10,153,32,121,49,0,0
767,16/05/2021,3,0,67,14,53,49,0,0
602,12/05/2021,3,0,64,29,35,55,0,0
328,03/05/2021,3,1,97,88,9,74,0,0
78,20/05/2021,3,0,44,44,0,NA,NA,NA
187,14/05/2021,3,1,40,11,29,49,0,0
455,11/05/2021,3,7,244,4,240,66,0,0
172,18/05/2021,3,2,83,63,20,74,0,0
601,22/05/2021,3,3,65,44,21,74,0,0
795,18/05/2021,3,7,98,82,16,67,0,0
112,17/05/2021,3,0,84,59,25,52,0,0
346,12/05/2021,3,5,115,72,43,55,0,0
874,13/05/2021,3,3,86,4,82,49,0,0
840,08/05/2021,3,0,312,41,271,49,0,0
517,17/05/2021,3,0,58,52,6,63,0,0
640,22/05/2021,3,5,121,120,1,88,0,0
553,04/05/2021,3,16,26,10,16,49,0,0
645,21/05/2021,3,4,37,32,5,88,0,0
856,21/05/2021,3,1,119,91,28,80,0,0
798,19/05/2021,3,1,80,77,3,95,0,0
542,11/05/2021,3,4,71,50,21,71,0,0
471,12/05/2021,3,9,111,67,44,72,0,0
473,09/05/2021,3,2,48,9,39,49,0,0
318,22/05/2021,3,0,59,58,1,107,0,0
622,15/05/2021,3,1,43,36,7,72,0,0
684,14/05/2021,3,2,96,11,85,49,0,0
433,21/05/2021,3,2,316,146,170,100,0,0
137,11/05/2021,3,24,122,18,104,49,0,0
246,22/05/2021,3,1,111,69,42,72,0,0
370,11/05/2021,3,0,40,20,20,72,0,0
397,14/05/2021,3,0,75,16,59,49,0,0
450,20/05/2021,3,3,181,79,102,49,0,0
548,12/05/2021,3,2,89,36,53,55,0,0
873,17/05/2021,3,3,98,39,59,49,0,0
780,23/05/2021,3,0,60,38,22,49,0,0
673,20/05/2021,3,1,122,83,39,52,0,0
437,16/05/2021,3,2,163,28,135,49,0,0
704,10/05/2021,3,1,31,12,19,49,0,0
878,12/05/2021,3,0,218,7,211,44,0,0
634,14/05/2021,3,0,20,9,11,59,0,0
519,14/05/2021,3,0,64,15,49,49,0,0
554,14/05/2021,3,2,40,8,32,49,0,0
904,17/05/2021,3,1,273,10,263,66,0,0
462,18/05/2021,3,4,185,12,173,55,0,0
824,20/05/2021,3,0,339,35,304,55,0,0
838,18/05/2021,3,3,62,44,18,80,0,0
593,12/05/2021,3,5,76,59,17,85,0,0
17,21/05/2021,3,1,93,53,40,55,0,0
39,11/05/2021,3,1,60,40,20,94,0,0
887,07/05/2021,3,17,306,11,295,39,0,0
294,22/05/2021,3,0,117,90,27,80,0,0
407,11/05/2021,3,1,40,4,36,49,0,0
820,20/05/2021,3,0,127,109,18,85,0,0
850,19/05/2021,3,3,80,79,1,62,0,0
918,19/05/2021,3,0,201,37,164,39,0,0
389,23/05/2021,3,2,124,67,57,49,0,0
240,15/05/2021,3,1,70,27,43,55,0,0
335,24/05/2021,3,6,80,33,47,49,0,0
58,13/05/2021,3,1,66,60,6,77,0,0
691,17/05/2021,3,1,31,21,10,59,0,0
366,15/05/2021,3,0,80,29,51,49,0,0
722,15/05/2021,3,0,42,27,15,49,0,0
328,01/05/2021,3,1,97,93,4,62,0,0
304,08/05/2021,3,2,58,5,53,49,0,0
423,14/05/2021,3,1,49,33,16,52,0,0
455,12/05/2021,3,7,244,6,238,66,0,0
172,19/05/2021,3,2,83,59,24,74,0,0
80,22/05/2021,3,1,124,71,53,55,0,0
889,19/05/2021,3,1,123,19,104,45,0,0
402,17/05/2021,3,0,155,98,57,52,0,0
363,12/05/2021,3,4,95,57,38,59,0,0
655,09/05/2021,3,0,72,10,62,49,0,0
580,17/05/2021,3,0,98,76,22,52,0,0
13,24/05/2021,3,4,77,55,22,63,0,0
553,03/05/2021,3,12,30,3,27,49,0,0
771,09/05/2021,3,2,28,6,22,49,0,0
550,20/05/2021,3,2,110,59,51,49,0,0
7,20/05/2021,3,2,101,42,59,55,0,0
135,12/05/2021,3,5,61,37,24,67,0,0
268,12/05/2021,3,1,77,73,4,93,0,0
802,09/05/2021,3,1,64,18,46,49,0,0
528,21/05/2021,3,0,119,87,32,60,0,0
464,14/05/2021,3,1,265,19,246,66,0,0
600,14/05/2021,3,1,49,4,45,49,0,0
167,21/05/2021,3,1,83,82,1,90,0,0
650,14/05/2021,3,2,126,11,115,49,0,0
625,22/05/2021,3,0,161,118,43,67,0,0
100,10/05/2021,3,77,147,9,138,49,0,0
397,16/05/2021,3,0,75,5,70,49,0,0
66,16/05/2021,3,0,152,0,152,49,0,0
297,13/05/2021,3,2,74,45,29,55,0,0
873,18/05/2021,3,2,99,58,41,49,0,0
638,08/05/2021,3,21,80,14,66,49,0,0
736,19/05/2021,3,1,104,39,65,49,0,0
560,16/05/2021,3,0,80,30,50,49,0,0
221,10/05/2021,3,0,62,23,39,55,0,0
701,07/05/2021,3,2,60,2,58,49,0,0
440,15/05/2021,3,0,265,8,257,66,0,0
183,14/05/2021,3,1,79,18,61,49,0,0
295,14/05/2021,3,3,102,14,88,49,0,0
145,18/05/2021,3,2,56,28,28,60,0,0
56,19/05/2021,3,4,61,41,20,72,0,0
333,19/05/2021,3,1,56,54,2,127,0,0
362,20/05/2021,3,3,117,109,8,80,0,0
778,12/05/2021,3,3,78,59,19,80,0,0
571,20/05/2021,3,0,161,42,119,49,0,0
39,12/05/2021,3,1,60,42,18,72,0,0
544,07/05/2021,3,1,52,5,47,49,0,0
84,22/05/2021,3,0,20,19,1,138,0,0
476,11/05/2021,3,1,172,24,148,49,0,0
410,21/05/2021,3,0,56,43,13,67,0,0
61,22/05/2021,3,3,97,59,38,55,0,0
418,20/05/2021,3,0,116,30,86,49,0,0
831,23/05/2021,3,1,149,33,116,49,0,0
146,15/05/2021,3,2,39,16,23,49,0,0
676,24/05/2021,3,2,113,82,31,49,0,0
715,11/05/2021,3,4,84,71,13,82,0,0
222,15/05/2021,3,1,76,7,69,49,0,0
250,15/05/2021,3,0,115,49,66,59,0,0
722,13/05/2021,3,0,42,25,17,72,0,0
328,02/05/2021,3,1,97,93,4,63,0,0
210,08/05/2021,3,2,100,100,0,NA,NA,NA
400,14/05/2021,3,2,28,1,27,49,0,0
358,11/05/2021,3,2,91,62,29,67,0,0
815,17/05/2021,3,12,117,82,35,52,0,0
733,22/05/2021,3,1,99,66,33,60,0,0
889,18/05/2021,3,1,123,17,106,45,0,0
934,08/05/2021,3,69,30,0,30,35,0,0
214,10/05/2021,3,4,82,49,33,52,0,0
663,09/05/2021,3,0,148,13,135,49,0,0
580,20/05/2021,3,0,98,86,12,62,0,0
395,25/05/2021,3,2,70,51,19,62,0,0
849,05/05/2021,3,1,83,21,62,49,0,0
771,10/05/2021,3,2,28,17,11,77,0,0
856,20/05/2021,3,1,119,55,64,49,0,0
585,21/05/2021,3,2,58,57,1,113,0,0
344,10/05/2021,3,2,63,16,47,52,0,0
22,12/05/2021,3,0,64,57,7,80,0,0
37,06/05/2021,3,2,79,22,57,49,0,0
237,21/05/2021,3,5,116,63,53,49,0,0
622,14/05/2021,3,6,38,24,14,55,0,0
128,15/05/2021,3,1,20,6,14,49,0,0
862,21/05/2021,3,1,109,92,17,86,0,0
575,14/05/2021,3,1,49,14,35,49,0,0
91,21/05/2021,3,0,80,57,23,55,0,0
753,10/05/2021,3,2,125,37,88,49,0,0
48,16/05/2021,3,0,179,4,175,49,0,0
416,16/05/2021,3,0,34,3,31,49,0,0
720,13/05/2021,3,0,39,20,19,55,0,0
230,12/05/2021,3,0,80,14,66,49,0,0
70,07/05/2021,3,2,37,14,23,49,0,0
736,20/05/2021,3,1,104,59,45,49,0,0
211,15/05/2021,3,3,57,28,29,49,0,0
488,10/05/2021,3,1,65,57,8,74,0,0
111,09/05/2021,3,0,60,24,36,49,0,0
703,14/05/2021,3,0,91,14,77,49,0,0
617,14/05/2021,3,1,43,19,24,49,0,0
554,15/05/2021,3,2,40,5,35,49,0,0
119,18/05/2021,3,2,66,38,28,52,0,0
825,18/05/2021,3,3,143,61,82,49,0,0
79,21/05/2021,3,1,45,30,15,100,0,0
110,18/05/2021,3,1,86,71,15,67,0,0
131,14/05/2021,3,3,46,6,40,49,0,0
776,20/05/2021,3,0,104,44,60,49,0,0
743,12/05/2021,3,1,125,37,88,59,0,0
77,09/05/2021,3,2,101,17,84,49,0,0
432,23/05/2021,3,0,165,7,158,70,0,0
668,11/05/2021,3,0,303,9,294,49,0,0
441,21/05/2021,3,0,168,68,100,80,0,0
144,19/05/2021,3,1,98,53,45,52,0,0
418,18/05/2021,3,0,116,26,90,49,0,0
835,23/05/2021,3,5,99,58,41,52,0,0
63,16/05/2021,3,9,55,4,51,49,0,0
282,24/05/2021,3,28,673,60,613,49,0,0
322,10/05/2021,3,0,100,17,83,49,0,0
310,17/05/2021,3,1,71,63,8,74,0,0
250,16/05/2021,3,0,115,27,88,59,0,0
449,13/05/2021,3,2,93,8,85,66,0,0
359,04/05/2021,3,3,101,59,42,59,0,0
902,07/05/2021,3,2,124,11,113,49,0,0
28,15/05/2021,3,2,126,39,87,49,0,0
828,11/05/2021,3,2,73,19,54,49,0,0
815,18/05/2021,3,12,117,92,25,57,0,0
656,20/05/2021,3,0,115,97,18,62,0,0
858,17/05/2021,3,0,81,73,8,77,0,0
804,09/05/2021,3,3,142,13,129,49,0,0
845,11/05/2021,3,1,119,84,35,67,0,0
140,10/05/2021,3,0,170,73,97,49,0,0
469,18/05/2021,3,4,192,44,148,66,0,0
599,25/05/2021,3,2,151,113,38,107,0,0
573,01/05/2021,3,0,57,17,40,49,0,0
116,08/05/2021,3,0,61,25,36,49,0,0
508,20/05/2021,3,4,76,43,33,49,0,0
646,21/05/2021,3,5,131,107,24,88,0,0
662,11/05/2021,3,1,106,52,54,55,0,0
268,10/05/2021,3,0,78,71,7,85,0,0
195,06/05/2021,3,1,50,20,30,49,0,0
735,21/05/2021,3,1,28,22,6,67,0,0
782,15/05/2021,3,0,20,10,10,49,0,38
163,14/05/2021,3,1,61,12,49,49,0,0
12,22/05/2021,3,2,41,26,15,55,0,0
430,11/05/2021,3,1,88,29,59,55,0,0
572,20/05/2021,3,0,61,52,9,74,0,0
71,11/05/2021,3,1,61,19,42,49,0,0
670,16/05/2021,3,0,108,26,82,49,0,0
416,17/05/2021,3,0,34,9,25,49,0,0
315,15/05/2021,3,0,62,34,28,55,0,0
49,12/05/2021,3,2,146,22,124,49,0,0
705,08/05/2021,3,1,90,5,85,49,0,0
524,21/05/2021,3,1,109,65,44,55,0,0
525,15/05/2021,3,1,74,10,64,49,0,0
765,07/05/2021,3,1,100,39,61,49,0,0
823,12/05/2021,3,1,60,31,29,52,0,0
487,15/05/2021,3,0,39,6,33,49,0,0
193,16/05/2021,3,1,107,11,96,49,0,0
295,15/05/2021,3,3,102,11,91,49,0,0
448,17/05/2021,3,3,150,44,106,66,0,0
399,19/05/2021,3,1,60,61,-1,NA,NA,NA
824,19/05/2021,3,0,339,29,310,55,0,0
110,19/05/2021,3,1,86,68,18,55,0,0
151,14/05/2021,3,8,68,9,59,49,0,0
361,19/05/2021,3,38,27,19,8,80,0,0
743,11/05/2021,3,1,125,41,84,59,0,0
564,08/05/2021,3,3,71,11,60,49,0,0
432,18/05/2021,3,0,165,20,145,66,0,0
107,11/05/2021,3,33,56,36,20,189,0,0
486,21/05/2021,3,0,124,55,69,55,0,0
144,18/05/2021,3,1,98,52,46,49,0,0
658,18/05/2021,3,0,81,55,26,74,0,0
176,23/05/2021,3,4,96,31,65,49,0,0
317,15/05/2021,3,0,80,14,66,49,0,0
419,16/05/2021,3,3,107,24,83,66,0,0
579,10/05/2021,3,0,44,11,33,49,0,0
742,17/05/2021,3,1,73,53,20,57,0,0
854,14/05/2021,3,7,103,12,91,55,0,0
602,13/05/2021,3,0,64,38,26,52,0,0
82,03/05/2021,3,0,96,12,84,55,0,0
902,08/05/2021,3,2,124,8,116,49,0,0
400,15/05/2021,3,2,28,2,26,49,0,0
494,12/05/2021,3,2,137,41,96,49,0,0
815,19/05/2021,3,12,117,98,19,57,0,0
636,21/05/2021,3,0,120,88,32,88,0,0
613,18/05/2021,3,0,56,38,18,70,0,0
934,09/05/2021,3,50,49,0,49,35,0,0
845,12/05/2021,3,1,119,83,36,67,0,0
840,10/05/2021,3,0,312,57,255,49,0,0
425,19/05/2021,3,5,245,45,200,66,0,0
605,25/05/2021,3,14,146,80,66,57,0,0
849,03/05/2021,3,1,83,7,76,49,0,0
606,09/05/2021,3,1,45,6,39,49,0,0
319,21/05/2021,3,6,108,89,19,67,0,0
646,19/05/2021,3,17,119,92,27,57,0,0
933,13/05/2021,3,115,32,1,31,35,0,0
447,10/05/2021,3,0,143,103,40,59,0,0
244,06/05/2021,3,0,200,65,135,49,0,0
155,22/05/2021,3,0,93,66,27,138,0,0
292,16/05/2021,3,0,239,63,176,49,0,0
138,14/05/2021,3,0,98,27,71,49,0,0
433,22/05/2021,3,2,316,205,111,110,0,0
551,11/05/2021,3,0,115,76,39,57,0,0
91,22/05/2021,3,0,80,73,7,74,0,0
89,11/05/2021,3,3,57,31,26,49,0,0
249,15/05/2021,3,2,125,73,52,55,0,0
296,16/05/2021,3,3,57,18,39,49,0,0
548,13/05/2021,3,1,90,40,50,49,0,0
118,12/05/2021,3,2,57,24,33,49,0,0
70,09/05/2021,3,2,37,9,28,49,0,0
721,19/05/2021,3,27,113,112,1,77,0,0
57,16/05/2021,3,1,139,11,128,49,0,0
826,07/05/2021,3,3,95,33,62,49,0,0
878,07/05/2021,3,0,218,11,207,44,0,0
841,15/05/2021,3,0,182,20,162,49,0,0
193,15/05/2021,3,2,106,11,95,49,0,0
665,15/05/2021,3,1,105,24,81,49,0,0
687,17/05/2021,3,2,85,61,24,57,0,0
393,19/05/2021,3,1,59,44,15,62,0,0
114,19/05/2021,3,1,74,73,1,95,0,0
728,20/05/2021,3,1,46,38,8,62,0,0
526,14/05/2021,3,1,37,3,34,49,0,0
571,21/05/2021,3,2,159,99,60,55,0,0
543,12/05/2021,3,1,64,26,38,59,0,0
633,07/05/2021,3,1,49,8,41,49,0,0
84,19/05/2021,3,0,20,20,0,NA,NA,NA
821,11/05/2021,3,1,78,68,10,80,0,0
757,21/05/2021,3,0,117,84,33,82,0,0
185,20/05/2021,3,0,168,59,109,49,0,0
918,20/05/2021,3,0,201,33,168,39,0,0
837,22/05/2021,3,4,322,42,280,100,0,0
576,18/05/2021,3,0,58,25,33,49,0,0
335,16/05/2021,3,4,82,7,75,49,0,0
764,11/05/2021,3,2,67,31,36,55,0,0
772,17/05/2021,3,0,57,48,9,52,0,0
854,15/05/2021,3,3,107,18,89,55,0,0
449,12/05/2021,3,2,93,7,86,66,0,0
359,02/05/2021,3,3,101,13,88,49,0,0
117,09/05/2021,3,1,93,20,73,49,0,0
238,13/05/2021,3,1,65,27,38,55,0,0
828,12/05/2021,3,2,73,27,46,49,0,0
64,17/05/2021,3,3,244,48,196,49,0,0
499,22/05/2021,3,0,31,27,4,74,0,0
504,19/05/2021,3,0,83,22,61,49,0,0
264,08/05/2021,3,1,59,17,42,49,0,0
21,10/05/2021,3,1,59,8,51,49,0,0
635,11/05/2021,3,0,88,45,43,49,0,0
425,17/05/2021,3,3,247,35,212,66,0,0
336,23/05/2021,3,1,73,72,1,112,0,0
50,05/05/2021,3,2,119,33,86,49,0,0
291,08/05/2021,3,2,59,28,31,49,0,0
698,21/05/2021,3,2,114,78,36,63,0,0
157,20/05/2021,3,2,81,69,12,80,0,0
542,10/05/2021,3,4,71,61,10,62,0,0
303,12/05/2021,3,1,64,41,23,72,0,0
802,07/05/2021,3,1,64,21,43,49,0,0
786,14/05/2021,3,2,60,3,57,49,0,0
92,14/05/2021,3,1,121,13,108,49,0,0
213,15/05/2021,3,3,145,136,9,62,0,0
142,21/05/2021,3,1,61,51,10,83,0,0
538,10/05/2021,3,1,43,28,15,57,0,0
205,22/05/2021,3,0,126,73,53,66,0,0
100,11/05/2021,3,77,147,22,125,49,0,0
348,17/05/2021,3,7,133,125,8,70,0,0
784,17/05/2021,3,2,47,35,12,52,0,0
720,14/05/2021,3,0,39,9,30,49,0,0
234,12/05/2021,3,2,60,19,41,49,0,0
711,09/05/2021,3,2,87,11,76,49,0,0
811,20/05/2021,3,3,87,46,41,49,0,0
67,15/05/2021,3,0,52,9,43,49,0,0
47,08/05/2021,3,2,55,21,34,49,0,0
265,11/05/2021,3,1,56,19,37,49,0,0
263,16/05/2021,3,0,66,16,50,49,0,0
848,16/05/2021,3,7,131,14,117,35,0,0
307,15/05/2021,3,1,78,9,69,49,0,0
442,17/05/2021,3,2,156,46,110,49,0,0
56,17/05/2021,3,4,61,32,29,59,0,0
356,20/05/2021,3,2,134,98,36,60,0,0
574,18/05/2021,3,12,75,37,38,49,0,0
817,15/05/2021,3,1,82,12,70,49,0,0
864,21/05/2021,3,2,83,37,46,55,0,0
582,10/05/2021,3,0,53,20,33,55,0,0
633,09/05/2021,3,1,49,13,36,49,0,0
34,18/05/2021,3,3,85,51,34,64,0,0
5,10/05/2021,3,68,21,24,-3,NA,NA,NA
203,20/05/2021,3,0,40,14,26,49,0,0
604,20/05/2021,3,0,82,53,29,49,0,0
383,20/05/2021,3,3,82,82,0,NA,NA,NA
314,23/05/2021,3,2,67,31,36,49,0,0
148,07/05/2021,3,0,25,5,20,49,0,0
347,16/05/2021,3,14,48,15,33,49,0,0
218,12/05/2021,3,2,76,37,39,49,0,0
452,15/05/2021,3,1,59,27,32,55,0,0
33,15/05/2021,3,4,76,35,41,59,0,0
793,15/05/2021,3,2,129,21,108,49,0,0
495,02/05/2021,3,2,83,9,74,49,0,0
807,08/05/2021,3,3,97,14,83,49,0,0
189,13/05/2021,3,0,165,103,62,59,0,0
621,11/05/2021,3,1,59,47,12,72,0,0
460,17/05/2021,3,10,99,30,69,49,0,0
97,21/05/2021,3,4,103,87,16,73,0,0
492,19/05/2021,3,3,34,25,9,63,0,0
535,08/05/2021,3,1,82,4,78,49,0,0
31,10/05/2021,3,1,62,18,44,49,0,0
840,12/05/2021,3,0,312,67,245,49,0,0
469,17/05/2021,3,4,192,46,146,66,0,0
599,24/05/2021,3,1,152,126,26,90,0,0
819,03/05/2021,3,0,80,31,49,55,0,0
645,09/05/2021,3,2,39,12,27,49,0,0
55,20/05/2021,3,1,32,25,7,62,0,0
166,20/05/2021,3,2,64,59,5,65,0,0
616,11/05/2021,3,3,72,45,27,72,0,0
303,10/05/2021,3,2,63,33,30,72,0,0
195,08/05/2021,3,1,50,8,42,49,0,0
237,13/05/2021,3,4,117,22,95,49,0,0
518,14/05/2021,3,1,16,5,11,49,0,0
600,13/05/2021,3,1,49,28,21,55,0,0
209,22/05/2021,3,1,113,112,1,55,0,0
113,11/05/2021,3,1,31,13,18,62,0,0
91,20/05/2021,3,1,79,54,25,52,0,0
89,13/05/2021,3,3,57,24,33,49,0,0
540,17/05/2021,3,1,81,50,31,52,0,0
281,16/05/2021,3,3,80,14,66,49,0,0
747,15/05/2021,3,0,64,31,33,49,0,0
284,11/05/2021,3,1,25,14,11,67,0,0
614,11/05/2021,3,2,80,51,29,60,0,0
159,20/05/2021,3,0,77,57,20,52,0,0
498,15/05/2021,3,0,87,12,75,49,0,0
242,08/05/2021,3,2,136,77,59,49,0,0
265,12/05/2021,3,1,56,22,34,49,0,0
583,14/05/2021,3,1,80,35,45,49,0,0
228,14/05/2021,3,2,40,8,32,49,0,0
35,15/05/2021,3,0,110,15,95,49,0,0
608,17/05/2021,3,9,131,44,87,49,0,0
350,17/05/2021,3,2,58,47,11,57,0,0
783,20/05/2021,3,3,77,76,1,95,0,0
439,20/05/2021,3,5,86,40,46,49,0,0
184,12/05/2021,3,0,51,44,7,82,0,0
287,19/05/2021,3,1,122,70,52,52,0,0
743,10/05/2021,3,1,125,26,99,55,0,0
219,09/05/2021,3,5,72,8,64,49,0,0
626,18/05/2021,3,3,99,76,23,74,0,0
316,11/05/2021,3,1,38,38,0,NA,NA,NA
203,21/05/2021,3,0,40,15,25,66,0,0
185,21/05/2021,3,0,168,77,91,49,0,0
383,09/05/2021,3,3,82,21,61,49,0,0
257,23/05/2021,3,0,44,34,10,67,0,0
148,09/05/2021,3,0,25,0,25,49,0,0
396,17/05/2021,3,1,29,27,2,75,0,0
308,13/05/2021,3,2,46,13,33,49,0,0
275,17/05/2021,3,5,112,64,48,55,0,0
274,14/05/2021,3,2,208,22,186,39,0,0
41,15/05/2021,3,1,83,22,61,49,0,0
495,04/05/2021,3,2,83,15,68,49,0,0
807,09/05/2021,3,3,97,11,86,49,0,0
28,13/05/2021,3,2,126,98,28,72,0,0
343,11/05/2021,3,1,61,32,29,55,0,0
64,18/05/2021,3,3,244,41,203,49,0,0
610,21/05/2021,3,1,66,52,14,67,0,0
586,18/05/2021,3,3,80,52,28,64,0,0
535,09/05/2021,3,1,82,5,77,49,0,0
483,10/05/2021,3,3,96,31,65,49,0,0
877,12/05/2021,3,0,158,26,132,35,0,0
469,20/05/2021,3,4,192,48,144,66,0,0
283,25/05/2021,3,1,75,25,50,64,0,0
379,01/05/2021,3,4,283,67,216,66,0,0
81,08/05/2021,3,1,59,7,52,49,0,0
98,20/05/2021,3,1,94,85,9,85,0,0
123,21/05/2021,3,2,93,21,72,55,0,0
542,12/05/2021,3,4,71,63,8,77,0,0
471,11/05/2021,3,8,112,79,33,72,0,0
244,08/05/2021,3,0,200,57,143,49,0,0
735,14/05/2021,3,0,29,9,20,49,0,0
139,16/05/2021,3,2,57,1,56,49,0,0
128,14/05/2021,3,1,20,10,10,49,0,0
739,22/05/2021,3,2,73,47,26,55,0,0
113,12/05/2021,3,1,31,18,13,57,0,0
631,20/05/2021,3,1,70,50,20,64,0,0
700,13/05/2021,3,5,127,37,90,49,0,0
249,14/05/2021,3,2,125,53,72,49,0,0
239,16/05/2021,3,0,40,15,25,49,0,0
871,15/05/2021,3,2,76,23,53,49,0,0
734,11/05/2021,3,2,59,51,8,59,0,0
70,08/05/2021,3,2,37,15,22,49,0,0
164,20/05/2021,3,0,62,43,19,52,0,0
560,15/05/2021,3,0,80,12,68,49,0,0
759,09/05/2021,3,2,85,25,60,49,0,0
391,12/05/2021,3,1,75,29,46,49,0,0
511,15/05/2021,3,1,75,22,53,49,0,0
228,15/05/2021,3,2,40,9,31,49,0,0
639,15/05/2021,3,0,59,5,54,49,0,0
353,17/05/2021,3,1,51,47,4,72,0,0
350,19/05/2021,3,2,58,37,21,55,0,0
783,21/05/2021,3,3,77,76,1,127,0,0
832,20/05/2021,3,1,99,50,49,49,0,0
259,12/05/2021,3,0,60,42,18,64,0,0
153,20/05/2021,3,1,63,45,18,67,0,0
582,11/05/2021,3,0,53,19,34,55,0,0
323,11/05/2021,3,0,31,23,8,82,0,0
750,18/05/2021,3,2,110,107,3,71,0,0
530,11/05/2021,3,1,59,44,15,72,0,0
531,21/05/2021,3,1,58,34,24,55,0,0
30,04/05/2021,3,1,70,51,19,74,0,0
752,11/05/2021,3,24,20,3,17,79,0,0
837,14/05/2021,3,2,324,6,318,66,0,0
26,07/05/2021,3,2,64,8,56,49,0,0
869,16/05/2021,3,1,59,39,20,64,0,0
403,10/05/2021,3,2,96,37,59,55,0,0
612,15/05/2021,3,1,41,6,35,49,0,0
274,15/05/2021,3,2,208,25,183,39,0,0
775,15/05/2021,3,1,108,21,87,49,0,0
359,01/05/2021,3,3,101,8,93,49,0,0
117,08/05/2021,3,0,94,65,29,52,0,0
423,13/05/2021,3,1,49,29,20,60,0,0
641,11/05/2021,3,0,160,13,147,49,0,0
460,19/05/2021,3,9,100,45,55,49,0,0
733,21/05/2021,3,1,99,30,69,55,0,0
613,17/05/2021,3,0,56,37,19,62,0,0
899,09/05/2021,3,8,97,8,89,49,0,0
618,10/05/2021,3,12,139,63,76,49,0,0
655,10/05/2021,3,0,72,48,24,60,0,0
651,19/05/2021,3,1,77,28,49,49,0,0
336,22/05/2021,3,1,73,67,6,159,0,0
379,05/05/2021,3,4,283,113,170,66,0,0
331,10/05/2021,3,2,92,79,13,64,0,0
337,20/05/2021,3,1,59,34,25,49,0,0
298,21/05/2021,3,2,227,78,149,55,0,0
616,12/05/2021,3,3,72,41,31,64,0,0
8,10/05/2021,3,1,39,18,21,52,0,0
95,07/05/2021,3,1,87,15,72,49,0,0
279,14/05/2021,3,0,57,6,51,49,0,0
754,14/05/2021,3,0,62,5,57,49,0,0
417,14/05/2021,3,0,103,15,88,49,0,0
209,21/05/2021,3,1,113,86,27,55,0,0
430,13/05/2021,3,2,87,24,63,55,0,0
87,21/05/2021,3,44,74,34,40,55,0,0
852,10/05/2021,3,0,80,22,58,49,0,0
833,14/05/2021,3,1,82,24,58,49,0,0
790,16/05/2021,3,1,98,21,77,66,0,0
871,12/05/2021,3,3,75,75,0,NA,NA,NA
364,11/05/2021,3,3,127,119,8,82,0,0
409,11/05/2021,3,1,106,49,57,52,0,0
524,20/05/2021,3,0,110,61,49,49,0,0
226,16/05/2021,3,0,47,21,26,49,0,0
826,09/05/2021,3,2,96,18,78,49,0,0
514,07/05/2021,3,6,228,19,209,49,0,0
216,16/05/2021,3,1,57,6,51,49,0,0
617,15/05/2021,3,1,43,14,29,49,0,0
197,14/05/2021,3,0,118,28,90,49,0,0
652,17/05/2021,3,0,69,42,27,64,0,0
253,17/05/2021,3,1,57,34,23,55,0,0
907,21/05/2021,3,3,77,60,17,80,0,0
728,19/05/2021,3,1,46,37,9,63,0,0
184,14/05/2021,3,0,51,15,36,49,0,0
147,21/05/2021,3,1,79,67,12,67,0,0
134,12/05/2021,3,1,47,29,18,55,0,0
619,07/05/2021,3,0,101,7,94,49,0,0
220,19/05/2021,3,26,77,69,8,62,0,0
107,10/05/2021,3,33,56,36,20,142,0,0
643,19/05/2021,3,2,101,70,31,57,0,0
604,04/05/2021,3,1,81,20,61,55,0,0
60,09/05/2021,3,0,57,12,45,49,0,0
257,14/05/2021,3,1,43,13,30,49,0,0
678,08/05/2021,3,0,44,0,44,NA,NA,NA
867,17/05/2021,3,1,59,59,0,NA,NA,NA
509,10/05/2021,3,1,111,32,79,49,0,0
275,15/05/2021,3,5,112,45,67,49,0,0
274,16/05/2021,3,2,208,23,185,39,0,0
722,14/05/2021,3,0,42,9,33,49,0,0
843,01/05/2021,3,2,64,16,48,49,0,0
304,09/05/2021,3,2,58,3,55,49,0,0
238,15/05/2021,3,1,65,23,42,55,0,0
156,12/05/2021,3,6,142,97,45,67,0,0
99,17/05/2021,3,0,167,68,99,49,0,0
188,20/05/2021,3,5,116,92,24,57,0,0
504,17/05/2021,3,0,83,26,57,49,0,0
272,08/05/2021,3,1,126,18,108,49,0,0
225,12/05/2021,3,13,67,36,31,55,0,0
655,08/05/2021,3,0,72,12,60,49,0,0
260,17/05/2021,3,1,119,60,59,49,0,0
405,24/05/2021,3,1,89,67,22,57,0,0
50,04/05/2021,3,2,119,27,92,49,0,0
645,10/05/2021,3,2,39,24,15,74,0,0
550,21/05/2021,3,1,111,88,23,60,0,0
774,19/05/2021,3,4,101,57,44,49,0,0
129,13/05/2021,3,11,189,62,127,49,0,0
22,10/05/2021,3,0,64,63,1,89,0,0
161,07/05/2021,3,0,61,12,49,49,0,0
565,14/05/2021,3,0,62,11,51,49,0,0
760,14/05/2021,3,1,35,4,31,49,0,0
875,14/05/2021,3,2,90,26,64,49,0,0
496,22/05/2021,3,1,59,52,7,67,0,0
430,10/05/2021,3,1,88,28,60,55,0,0
435,22/05/2021,3,53,67,48,19,52,0,0
710,14/05/2021,3,0,20,11,9,49,0,0
853,14/05/2021,3,4,98,14,84,49,0,0
267,16/05/2021,3,2,81,16,65,49,0,0
169,01/05/2021,3,0,20,9,11,49,0,0
364,10/05/2021,3,3,127,121,6,80,0,0
424,11/05/2021,3,1,27,22,5,79,0,0
90,20/05/2021,3,0,78,43,35,52,0,0
669,16/05/2021,3,0,87,16,71,49,0,0
18,10/05/2021,3,3,89,33,56,49,0,0
514,12/05/2021,3,5,229,33,196,49,0,0
583,15/05/2021,3,2,79,45,34,49,0,0
917,16/05/2021,3,1,105,4,101,35,0,0
270,15/05/2021,3,2,58,15,43,49,0,0
448,18/05/2021,3,3,150,63,87,66,0,0
247,19/05/2021,3,1,92,57,35,55,0,0
637,21/05/2021,3,0,74,70,4,121,0,0
110,20/05/2021,3,1,86,71,15,57,0,0
526,12/05/2021,3,0,38,17,21,59,0,0
153,21/05/2021,3,1,63,61,2,78,0,0
102,11/05/2021,3,0,60,34,26,55,0,0
323,08/05/2021,3,0,31,8,23,49,0,0
385,19/05/2021,3,3,60,51,9,80,0,0
290,10/05/2021,3,3,104,64,40,52,0,0
531,20/05/2021,3,1,58,42,16,52,0,0
144,01/05/2021,3,0,99,31,68,49,0,0
418,09/05/2021,3,0,116,9,107,49,0,0
32,15/05/2021,3,1,104,24,80,49,0,0
678,09/05/2021,3,0,44,0,44,NA,NA,NA
130,17/05/2021,3,3,78,47,31,52,0,0
715,10/05/2021,3,5,83,62,21,64,0,0
275,16/05/2021,3,5,112,35,77,49,0,0
33,14/05/2021,3,4,76,28,48,49,0,0
288,02/05/2021,3,1,59,27,32,49,0,0
78,10/05/2021,3,0,44,33,11,59,0,0
187,13/05/2021,3,1,40,11,29,49,0,0
343,12/05/2021,3,1,61,28,33,55,0,0
466,17/05/2021,3,0,140,37,103,49,0,0
610,20/05/2021,3,1,66,58,8,74,0,0
378,18/05/2021,3,1,83,73,10,77,0,0
272,09/05/2021,3,1,126,20,106,49,0,0
483,11/05/2021,3,3,96,29,67,49,0,0
635,10/05/2021,3,0,88,39,49,49,0,0
694,17/05/2021,3,1,108,39,69,49,0,0
395,23/05/2021,3,3,69,23,46,49,0,0
819,02/05/2021,3,5,75,74,1,62,0,0
351,10/05/2021,3,1,65,26,39,67,0,0
337,21/05/2021,3,0,60,43,17,60,0,0
123,20/05/2021,3,0,95,45,50,49,0,0
129,11/05/2021,3,7,193,42,151,49,0,0
447,11/05/2021,3,0,143,105,38,64,0,0
37,08/05/2021,3,3,78,15,63,49,0,0
478,14/05/2021,3,6,14,7,7,49,0,0
642,14/05/2021,3,2,93,17,76,49,0,0
252,15/05/2021,3,1,263,25,238,49,0,0
467,13/05/2021,3,3,109,1,108,55,0,0
575,13/05/2021,3,1,49,20,29,55,0,0
737,21/05/2021,3,2,40,33,7,67,0,0
122,14/05/2021,3,5,116,32,84,49,0,0
312,16/05/2021,3,3,94,10,84,49,0,0
401,16/05/2021,3,0,79,11,68,49,0,0
747,01/05/2021,3,0,64,8,56,49,0,0
364,12/05/2021,3,3,127,105,22,80,0,0
170,08/05/2021,3,1,104,4,100,49,0,0
164,21/05/2021,3,0,62,40,22,71,0,0
4,15/05/2021,3,1,63,63,0,NA,NA,NA
236,10/05/2021,3,2,117,12,105,49,0,0
660,07/05/2021,3,6,180,18,162,49,0,0
748,14/05/2021,3,4,140,13,127,49,0,0
475,16/05/2021,3,1,98,21,77,49,0,0
372,15/05/2021,3,16,76,24,52,49,0,0
792,18/05/2021,3,0,102,91,11,62,0,0
436,18/05/2021,3,2,204,98,106,49,0,0
360,20/05/2021,3,1,43,20,23,55,0,0
506,19/05/2021,3,1,194,39,155,49,0,0
365,14/05/2021,3,0,68,23,45,55,0,0
153,12/05/2021,3,1,63,33,30,55,0,0
582,12/05/2021,3,3,50,21,29,55,0,0
544,11/05/2021,3,0,53,9,44,49,0,0
285,19/05/2021,3,0,80,52,28,64,0,0
316,10/05/2021,3,1,38,32,6,80,0,0
339,19/05/2021,3,15,579,60,519,49,0,0
61,03/05/2021,3,1,99,7,92,49,0,0
534,11/05/2021,3,0,85,39,46,49,0,0
389,14/05/2021,3,2,124,18,106,49,0,0
678,07/05/2021,3,0,44,0,44,NA,NA,NA
592,17/05/2021,3,7,77,70,7,82,0,0
472,13/05/2021,3,1,233,16,217,66,0,0
772,16/05/2021,3,0,57,14,43,49,0,0
860,15/05/2021,3,12,80,23,57,49,0,0
261,03/05/2021,3,3,99,23,76,49,0,0
212,10/05/2021,3,2,76,72,4,89,0,0
696,13/05/2021,3,1,88,42,46,49,0,0
358,12/05/2021,3,2,91,54,37,67,0,0
485,17/05/2021,3,0,65,39,26,49,0,0
656,21/05/2021,3,0,115,101,14,113,0,0
93,17/05/2021,3,3,138,86,52,49,0,0
934,10/05/2021,3,48,51,3,48,35,0,0
725,10/05/2021,3,0,17,14,3,82,0,0
840,09/05/2021,3,0,312,35,277,49,0,0
578,20/05/2021,3,1,57,38,19,49,0,0
377,25/05/2021,3,0,149,139,10,95,0,0
896,01/05/2021,3,0,82,52,30,52,0,0
773,10/05/2021,3,1,73,39,34,59,0,0
911,21/05/2021,3,0,158,64,94,55,0,0
298,20/05/2021,3,2,227,70,157,49,0,0
129,12/05/2021,3,7,193,47,146,49,0,0
447,12/05/2021,3,0,143,92,51,59,0,0
95,08/05/2021,3,1,87,12,75,49,0,0
735,13/05/2021,3,0,29,8,21,49,0,0
72,15/05/2021,3,2,58,19,39,49,0,0
138,15/05/2021,3,1,97,44,53,49,0,0
142,14/05/2021,3,1,61,9,52,49,0,0
839,11/05/2021,3,2,153,50,103,49,0,0
533,11/05/2021,3,0,91,1,90,49,0,0
100,14/05/2021,3,86,138,9,129,49,0,0
348,16/05/2021,3,5,135,27,108,49,0,0
491,16/05/2021,3,5,174,25,149,49,0,0
726,01/05/2021,3,1,38,18,20,49,0,0
521,11/05/2021,3,1,54,27,27,60,0,0
424,09/05/2021,3,1,27,12,15,49,0,0
149,20/05/2021,3,0,88,67,21,52,0,0
498,09/05/2021,3,0,87,11,76,49,0,0
236,11/05/2021,3,2,117,15,102,49,0,0
371,12/05/2021,3,1,35,14,21,82,0,0
263,14/05/2021,3,0,66,21,45,49,0,0
262,15/05/2021,3,2,49,33,16,49,0,0
674,15/05/2021,3,1,97,8,89,49,0,0
46,17/05/2021,3,2,58,43,15,60,0,0
597,18/05/2021,3,4,97,46,51,49,0,0
293,20/05/2021,3,1,59,27,32,49,0,0
584,20/05/2021,3,0,97,97,0,NA,NA,NA
342,15/05/2021,3,0,114,19,95,49,0,0
607,12/05/2021,3,1,74,38,36,60,0,0
199,11/05/2021,3,2,80,47,33,60,0,0
215,07/05/2021,3,0,46,7,39,49,0,0
699,19/05/2021,3,0,62,40,22,80,0,0
290,09/05/2021,3,3,104,41,63,49,0,0
339,21/05/2021,3,15,579,69,510,49,0,0
144,03/05/2021,3,0,99,17,82,49,0,0
632,11/05/2021,3,0,82,36,46,72,0,0
389,15/05/2021,3,2,124,3,121,49,0,0
678,06/05/2021,3,0,44,0,44,NA,NA,NA
20,16/05/2021,3,1,81,23,58,49,0,0
472,10/05/2021,3,0,234,14,220,66,0,0
861,16/05/2021,3,0,61,24,37,49,0,0
429,14/05/2021,3,3,122,9,113,49,0,0
261,01/05/2021,3,1,101,19,82,49,0,0
212,09/05/2021,3,1,77,57,20,64,0,0
276,14/05/2021,3,1,203,32,171,49,0,0
494,11/05/2021,3,1,138,45,93,49,0,0
99,18/05/2021,3,0,167,90,77,49,0,0
697,21/05/2021,3,2,107,69,38,63,0,0
406,17/05/2021,3,1,38,33,5,72,0,0
264,10/05/2021,3,1,59,52,7,67,0,0
363,11/05/2021,3,4,95,62,33,64,0,0
463,10/05/2021,3,1,162,30,132,55,0,0
661,20/05/2021,3,2,170,36,134,49,0,0
273,25/05/2021,3,0,103,96,7,135,0,0
896,05/05/2021,3,0,82,46,36,52,0,0
606,08/05/2021,3,1,45,8,37,49,0,0
508,21/05/2021,3,0,80,60,20,67,0,0
497,20/05/2021,3,3,190,119,71,49,0,0
344,13/05/2021,3,2,63,17,46,49,0,0
22,11/05/2021,3,0,64,59,5,80,0,0
95,09/05/2021,3,1,87,10,77,49,0,0
628,13/05/2021,3,4,55,32,23,60,0,0
754,15/05/2021,3,0,62,8,54,49,0,0
163,15/05/2021,3,1,61,40,21,49,0,0
167,14/05/2021,3,0,84,16,68,49,0,0
569,11/05/2021,3,0,120,16,104,49,0,0
533,12/05/2021,3,0,91,3,88,49,0,0
171,14/05/2021,3,2,47,7,40,49,0,0
249,17/05/2021,3,2,125,99,26,57,0,0
707,16/05/2021,3,1,39,17,22,49,0,0
649,01/05/2021,3,2,62,16,46,49,0,0
284,12/05/2021,3,1,25,20,5,77,0,0
866,09/05/2021,3,0,100,9,91,49,0,0
90,21/05/2021,3,0,78,51,27,60,0,0
226,10/05/2021,3,0,47,34,13,72,0,0
765,11/05/2021,3,1,100,66,34,64,0,0
701,12/05/2021,3,2,60,28,32,55,0,0
487,16/05/2021,3,0,39,17,22,49,0,0
519,16/05/2021,3,0,64,17,47,49,0,0
919,15/05/2021,3,0,123,18,105,49,0,0
200,17/05/2021,3,6,113,112,1,67,0,0
436,19/05/2021,3,2,204,105,99,49,0,0
712,20/05/2021,3,1,84,27,57,49,0,0
352,19/05/2021,3,0,64,38,26,64,0,0
243,12/05/2021,3,1,126,41,85,49,0,0
332,11/05/2021,3,0,40,21,19,55,0,0
341,12/05/2021,3,16,98,92,6,90,0,0
75,09/05/2021,3,0,81,8,73,49,0,0
84,18/05/2021,3,0,20,17,3,80,0,0
530,09/05/2021,3,2,58,27,31,49,0,0
410,19/05/2021,3,0,56,25,31,49,0,0
842,03/05/2021,3,3,88,33,55,49,0,0
918,11/05/2021,3,0,201,37,164,39,0,0
434,14/05/2021,3,2,58,16,42,49,0,0
26,08/05/2021,3,3,63,10,53,49,0,0
65,16/05/2021,3,1,77,8,69,49,0,0
603,10/05/2021,3,2,82,24,58,55,0,0
52,16/05/2021,3,8,134,58,76,49,0,0
232,14/05/2021,3,3,62,20,42,49,0,0
288,03/05/2021,3,1,59,25,34,49,0,0
117,10/05/2021,3,1,93,33,60,55,0,0
238,14/05/2021,3,1,65,25,40,49,0,0
445,11/05/2021,3,1,168,59,109,49,0,0
99,19/05/2021,3,0,167,101,66,49,0,0
499,21/05/2021,3,0,31,18,13,55,0,0
477,17/05/2021,3,3,117,30,87,49,0,0
804,10/05/2021,3,3,142,26,116,49,0,0
214,12/05/2021,3,4,82,53,29,57,0,0
453,07/05/2021,3,2,136,36,100,55,0,0
694,20/05/2021,3,4,105,57,48,49,0,0
503,25/05/2021,3,0,184,57,127,49,0,0
847,01/05/2021,3,0,197,16,181,35,0,0
291,10/05/2021,3,1,60,27,33,49,0,0
891,20/05/2021,3,1,81,80,1,69,0,0
774,20/05/2021,3,4,101,62,39,49,0,0
616,13/05/2021,3,1,74,42,32,49,0,0
303,11/05/2021,3,2,63,53,10,59,0,0
443,06/05/2021,3,4,86,39,47,49,0,0
279,13/05/2021,3,0,57,28,29,55,0,0
642,16/05/2021,3,2,93,31,62,49,0,0
836,15/05/2021,3,1,100,32,68,49,0,0
394,14/05/2021,3,2,66,9,57,49,0,0
538,14/05/2021,3,1,43,11,32,49,0,0
435,11/05/2021,3,70,50,10,40,52,0,0
278,10/05/2021,3,0,105,5,100,49,0,0
670,17/05/2021,3,7,101,79,22,62,0,0
666,16/05/2021,3,2,64,33,31,49,0,0
297,01/05/2021,3,2,74,31,43,49,0,0
734,10/05/2021,3,2,59,50,9,59,0,0
866,11/05/2021,3,0,100,24,76,55,0,0
524,19/05/2021,3,1,109,63,46,60,0,0
368,11/05/2021,3,1,84,29,55,55,0,0
765,10/05/2021,3,2,99,70,29,72,0,0
391,10/05/2021,3,1,75,21,54,49,0,0
369,16/05/2021,3,25,65,17,48,49,0,0
755,16/05/2021,3,0,87,35,52,49,0,0
270,14/05/2021,3,1,59,12,47,49,0,0
555,17/05/2021,3,0,117,73,44,55,0,0
597,19/05/2021,3,5,96,47,49,49,0,0
79,19/05/2021,3,2,44,36,8,82,0,0
686,19/05/2021,3,0,46,21,25,49,0,0
526,13/05/2021,3,1,37,12,25,49,0,0
648,11/05/2021,3,0,64,42,22,72,0,0
199,12/05/2021,3,1,81,53,28,67,0,0
75,08/05/2021,3,0,81,8,73,49,0,0
432,17/05/2021,3,0,165,15,150,66,0,0
821,09/05/2021,3,2,77,30,47,49,0,0
486,19/05/2021,3,0,124,40,84,49,0,0
144,04/05/2021,3,0,99,27,72,49,0,0
918,09/05/2021,3,0,201,17,184,39,0,0
831,15/05/2021,3,1,149,25,124,49,0,0
576,07/05/2021,3,2,56,8,48,49,0,0
282,16/05/2021,3,28,673,71,602,49,0,0
438,10/05/2021,3,11,85,29,56,115,0,0
227,17/05/2021,3,2,42,30,12,57,0,0
860,14/05/2021,3,12,80,17,63,49,0,0
359,03/05/2021,3,3,101,15,86,49,0,0
493,09/05/2021,3,2,33,7,26,55,0,0
187,15/05/2021,3,1,40,18,22,49,0,0
445,12/05/2021,3,1,168,58,110,49,0,0
723,18/05/2021,3,0,81,58,23,67,0,0
636,22/05/2021,3,0,120,90,30,103,0,0
702,17/05/2021,3,1,49,41,8,74,0,0
83,10/05/2021,3,73,95,59,36,49,0,0
225,11/05/2021,3,13,67,49,18,67,0,0
453,09/05/2021,3,2,136,23,113,55,0,0
421,20/05/2021,3,0,19,19,0,NA,NA,NA
273,24/05/2021,3,0,103,91,12,123,0,0
847,03/05/2021,3,0,197,62,135,35,0,0
331,08/05/2021,3,19,75,19,56,49,0,0
891,21/05/2021,3,1,81,65,16,60,0,0
125,11/05/2021,3,2,34,27,7,72,0,0
662,14/05/2021,3,3,104,23,81,49,0,0
682,11/05/2021,3,2,78,17,61,55,0,0
443,07/05/2021,3,5,85,31,54,49,0,0
237,14/05/2021,3,4,117,29,88,49,0,0
754,16/05/2021,3,0,62,10,52,49,0,0
875,15/05/2021,3,2,90,35,55,49,0,0
12,14/05/2021,3,1,42,4,38,49,0,0
872,14/05/2021,3,1,64,23,41,49,0,0
435,12/05/2021,3,71,49,14,35,52,0,0
278,14/05/2021,3,0,105,6,99,49,0,0
853,17/05/2021,3,2,100,61,39,55,0,0
450,17/05/2021,3,4,180,35,145,49,0,0
548,01/05/2021,3,0,91,77,14,57,0,0
325,12/05/2021,3,0,45,28,17,60,0,0
705,07/05/2021,3,0,91,5,86,49,0,0
811,19/05/2021,3,3,87,40,47,60,0,0
915,11/05/2021,3,4,185,14,171,35,0,0
221,07/05/2021,3,1,61,11,50,49,0,0
823,10/05/2021,3,1,60,38,22,52,0,0
731,16/05/2021,3,5,94,21,73,49,0,0
451,14/05/2021,3,2,81,25,56,66,0,0
659,14/05/2021,3,2,41,16,25,49,0,0
581,17/05/2021,3,60,165,159,6,63,0,0
683,19/05/2021,3,1,65,31,34,49,0,0
217,19/05/2021,3,4,37,22,15,52,0,0
686,18/05/2021,3,0,46,28,18,52,0,0
817,13/05/2021,3,1,82,30,52,49,0,0
648,12/05/2021,3,0,64,40,24,80,0,0
543,11/05/2021,3,1,64,30,34,59,0,0
215,08/05/2021,3,0,46,6,40,49,0,0
886,18/05/2021,3,3,149,74,75,49,0,0
530,10/05/2021,3,1,59,41,18,49,0,0
732,19/05/2021,3,0,60,30,30,49,0,0
842,04/05/2021,3,1,90,36,54,49,0,0
383,10/05/2021,3,4,81,40,41,59,0,0
505,14/05/2021,3,0,84,10,74,49,0,0
240,08/05/2021,3,1,70,29,41,49,0,0
515,16/05/2021,3,4,108,32,76,49,0,0
58,11/05/2021,3,1,66,65,1,55,0,0
127,17/05/2021,3,1,59,39,20,60,0,0
429,15/05/2021,3,3,122,16,106,49,0,0
288,01/05/2021,3,1,59,34,25,49,0,0
78,08/05/2021,3,0,44,12,32,49,0,0
785,15/05/2021,3,1,109,12,97,49,0,0
562,12/05/2021,3,1,67,34,33,49,0,0
868,17/05/2021,3,0,83,20,63,49,0,0
80,20/05/2021,3,2,123,73,50,49,0,0
795,17/05/2021,3,10,95,63,32,55,0,0
112,08/05/2021,3,2,82,14,68,49,0,0
346,10/05/2021,3,5,115,58,57,55,0,0
453,10/05/2021,3,2,136,64,72,55,0,0
421,04/05/2021,3,0,19,17,2,80,0,0
13,25/05/2021,3,0,81,73,8,90,0,0
847,04/05/2021,3,8,189,69,120,35,0,0
81,09/05/2021,3,1,59,4,55,49,0,0
698,20/05/2021,3,2,114,33,81,49,0,0
166,10/05/2021,3,3,63,19,44,49,0,0
616,14/05/2021,3,1,74,18,56,49,0,0
730,07/05/2021,3,2,73,8,65,49,0,0
95,06/05/2021,3,1,87,24,63,49,0,0
458,13/05/2021,3,3,178,78,100,49,0,0
518,15/05/2021,3,1,16,7,9,49,0,0
600,15/05/2021,3,1,49,13,36,49,0,0
527,14/05/2021,3,10,51,8,43,49,0,0
137,10/05/2021,3,24,122,12,110,49,0,0
374,11/05/2021,3,0,56,27,29,64,0,0
89,10/05/2021,3,3,57,20,37,49,0,0
898,17/05/2021,3,1,99,88,11,57,0,0
882,17/05/2021,3,0,130,39,91,39,0,0
315,01/05/2021,3,0,62,47,15,60,0,0
49,11/05/2021,3,2,146,31,115,49,0,0
866,08/05/2021,3,0,100,6,94,49,0,0
561,20/05/2021,3,1,59,48,11,57,0,0
67,09/05/2021,3,1,51,14,37,49,0,0
18,09/05/2021,3,3,89,15,74,49,0,0
1,11/05/2021,3,1,99,90,9,88,0,0
624,14/05/2021,3,1,78,13,65,49,0,0
594,14/05/2021,3,43,64,37,27,49,0,0
372,14/05/2021,3,4,88,24,64,49,0,0
591,17/05/2021,3,0,68,53,15,67,0,0
162,19/05/2021,3,0,122,112,10,62,0,0
360,19/05/2021,3,1,43,23,20,59,0,0
714,18/05/2021,3,0,59,20,39,64,0,0
817,14/05/2021,3,1,82,8,74,49,0,0
571,11/05/2021,3,0,161,11,150,49,0,0
341,09/05/2021,3,2,112,60,52,49,0,0
349,10/05/2021,3,1,89,47,42,55,0,0
294,18/05/2021,3,0,117,97,20,62,0,0
559,10/05/2021,3,44,141,59,82,49,0,0
531,19/05/2021,3,2,57,43,14,62,0,0
850,04/05/2021,3,2,81,28,53,49,0,0
675,10/05/2021,3,1,55,30,25,55,0,0
709,15/05/2021,3,0,83,19,64,49,0,0
576,08/05/2021,3,2,56,10,46,49,0,0
629,16/05/2021,3,2,60,28,32,49,0,0
403,11/05/2021,3,2,96,43,53,55,0,0
612,17/05/2021,3,1,41,26,15,60,0,0
33,16/05/2021,3,3,77,16,61,49,0,0
495,01/05/2021,3,0,85,8,77,49,0,0
493,07/05/2021,3,2,33,6,27,49,0,0
380,13/05/2021,3,2,158,46,112,49,0,0
156,11/05/2021,3,5,143,94,49,60,0,0
868,19/05/2021,3,0,83,47,36,49,0,0
499,20/05/2021,3,0,31,21,10,49,0,0
406,18/05/2021,3,1,38,31,7,80,0,0
248,08/05/2021,3,0,82,31,51,49,0,0
664,12/05/2021,3,3,152,47,105,55,0,0
453,11/05/2021,3,1,137,73,64,55,0,0
24,05/05/2021,3,0,84,53,31,52,0,0
599,11/05/2021,3,2,151,151,0,NA,NA,NA
847,05/05/2021,3,8,189,68,121,35,0,0
116,09/05/2021,3,0,61,19,42,49,0,0
55,21/05/2021,3,2,31,15,16,55,0,0
105,12/05/2021,3,1,74,63,11,90,0,0
756,10/05/2021,3,0,106,70,36,64,0,0
761,07/05/2021,3,0,83,12,71,49,0,0
244,07/05/2021,3,0,200,52,148,49,0,0
528,13/05/2021,3,0,119,55,64,49,0,0
72,14/05/2021,3,2,58,21,37,49,0,0
213,13/05/2021,3,3,145,98,47,49,0,0
496,14/05/2021,3,1,59,8,51,49,0,0
758,14/05/2021,3,1,72,21,51,49,0,0
374,12/05/2021,3,0,56,31,25,64,0,0
615,10/05/2021,3,0,71,22,49,49,0,0
833,17/05/2021,3,1,82,55,27,52,0,0
522,16/05/2021,3,5,57,31,26,57,0,0
871,01/05/2021,3,2,76,25,51,49,0,0
118,10/05/2021,3,3,56,18,38,49,0,0
409,08/05/2021,3,2,105,39,66,49,0,0
587,20/05/2021,3,2,79,59,20,57,0,0
152,09/05/2021,3,1,90,17,73,49,0,0
759,13/05/2021,3,3,84,34,50,49,0,0
371,13/05/2021,3,0,36,12,24,67,0,0
731,20/05/2021,3,4,95,69,26,52,0,0
848,14/05/2021,3,8,130,14,116,35,0,0
307,21/05/2021,3,1,78,68,10,66,0,0
591,24/05/2021,3,0,68,52,16,67,0,0
56,18/05/2021,3,4,61,48,13,72,0,0
846,19/05/2021,3,1,188,28,160,45,0,0
484,20/05/2021,3,0,40,35,5,79,0,0
526,15/05/2021,3,1,37,4,33,49,0,0
361,11/05/2021,3,38,27,16,11,80,0,0
45,10/05/2021,3,5,151,27,124,49,0,0
349,11/05/2021,3,1,89,42,47,59,0,0
84,17/05/2021,3,1,19,17,2,77,0,0
290,21/05/2021,3,2,105,51,54,55,0,0
791,19/05/2021,3,34,94,66,28,57,0,0
604,01/05/2021,3,1,81,16,65,49,0,0
681,10/05/2021,3,2,69,37,32,55,0,0
314,13/05/2021,3,1,68,65,3,180,0,0
812,09/05/2021,3,2,135,18,117,49,0,0
676,16/05/2021,3,3,112,54,58,49,0,0
715,17/05/2021,3,1,87,82,5,82,0,0
481,17/05/2021,3,0,56,24,32,49,0,0
120,16/05/2021,3,2,152,23,129,49,0,0
843,02/05/2021,3,4,62,14,48,49,0,0
902,09/05/2021,3,2,124,6,118,49,0,0
400,13/05/2021,3,2,28,9,19,49,0,0
343,21/05/2021,3,1,61,24,37,55,0,0
520,17/05/2021,3,0,58,44,14,57,0,0
340,22/05/2021,3,16,118,37,81,49,0,0
378,19/05/2021,3,1,83,67,16,74,0,0
535,20/05/2021,3,1,82,47,35,49,0,0
225,17/05/2021,3,11,69,46,23,67,0,0
453,24/05/2021,3,3,135,82,53,55,0,0
580,04/05/2021,3,0,98,48,50,49,0,0
273,11/05/2021,3,0,103,103,0,NA,NA,NA
573,21/05/2021,3,0,57,49,8,67,0,0
116,23/05/2021,3,0,61,58,3,70,0,0
181,21/05/2021,3,0,34,28,6,67,0,0
105,11/05/2021,3,1,74,68,6,85,0,0
68,13/05/2021,3,0,116,8,108,49,0,0
8,08/05/2021,3,1,39,18,21,49,0,0
473,07/05/2021,3,3,47,13,34,49,0,0
318,14/05/2021,3,0,59,18,41,49,0,0
139,15/05/2021,3,2,57,12,45,49,0,0
417,13/05/2021,3,0,103,38,65,49,0,0
496,15/05/2021,3,1,59,12,47,49,0,0
373,18/05/2021,3,1,102,56,46,55,0,0
572,12/05/2021,3,0,61,33,28,55,0,0
700,18/05/2021,3,5,127,39,88,49,0,0
249,22/05/2021,3,2,125,125,0,NA,NA,NA
182,16/05/2021,3,2,78,17,61,49,0,0
720,01/05/2021,3,0,39,6,33,49,0,0
539,15/05/2021,3,2,95,10,85,49,0,0
424,10/05/2021,3,1,27,27,0,NA,NA,NA
721,20/05/2021,3,26,114,101,13,62,0,0
4,10/05/2021,3,1,63,58,5,85,0,0
826,13/05/2021,3,2,96,47,49,49,0,0
878,15/05/2021,3,0,218,7,211,44,0,0
233,21/05/2021,3,3,64,58,6,79,0,0
848,15/05/2021,3,7,131,23,108,35,0,0
627,20/05/2021,3,0,41,24,17,59,0,0
119,24/05/2021,3,2,66,35,31,49,0,0
350,18/05/2021,3,2,58,49,9,74,0,0
783,27/05/2021,3,1,79,56,23,72,0,0
404,18/05/2021,3,0,67,52,15,80,0,0
190,12/05/2021,3,3,77,14,63,49,0,0
361,13/05/2021,3,38,27,23,4,80,0,0
126,17/05/2021,3,1,119,74,45,49,0,0
384,10/05/2021,3,0,101,55,46,55,0,0
76,19/05/2021,3,1,92,89,3,63,0,0
357,21/05/2021,3,1,82,66,16,67,0,0
96,20/05/2021,3,14,55,47,8,62,0,0
185,03/05/2021,3,1,167,16,151,49,0,0
863,11/05/2021,3,9,86,17,69,57,0,0
709,13/05/2021,3,0,83,28,55,55,0,0
146,06/05/2021,3,2,39,29,10,74,0,0
592,26/05/2021,3,1,83,82,1,59,0,0
715,20/05/2021,3,1,87,83,4,82,0,0
691,15/05/2021,3,1,31,30,1,62,0,0
767,21/05/2021,3,1,66,51,15,77,0,0
261,04/05/2021,3,3,99,34,65,49,0,0
807,07/05/2021,3,3,97,14,83,49,0,0
276,21/05/2021,3,1,203,40,163,49,0,0
156,21/05/2021,3,0,148,117,31,81,0,0
868,23/05/2021,3,0,83,24,59,49,0,0
29,15/05/2021,3,0,54,0,54,NA,NA,NA
175,18/05/2021,3,1,119,71,48,49,0,0
264,20/05/2021,3,0,60,35,25,55,0,0
346,17/05/2021,3,3,117,50,67,55,0,0
840,21/05/2021,3,3,309,150,159,49,0,0
694,04/05/2021,3,3,106,37,69,49,0,0
599,08/05/2021,3,2,151,31,120,49,0,0
849,22/05/2021,3,0,84,69,15,60,0,0
291,22/05/2021,3,1,60,42,18,60,0,0
913,21/05/2021,3,0,105,57,48,101,0,0
125,10/05/2021,3,2,34,34,0,NA,NA,NA
115,13/05/2021,3,0,115,17,98,49,0,0
303,08/05/2021,3,1,64,38,26,49,0,0
473,14/05/2021,3,2,48,17,31,49,0,0
528,14/05/2021,3,0,119,26,93,49,0,0
622,20/05/2021,3,1,43,25,18,55,0,0
684,13/05/2021,3,2,96,31,65,49,0,0
467,15/05/2021,3,2,110,7,103,55,0,0
551,19/05/2021,3,0,115,91,24,62,0,0
737,11/05/2021,3,2,40,13,27,49,0,0
745,18/05/2021,3,1,104,61,43,60,0,0
851,22/05/2021,3,0,92,92,0,NA,NA,NA
182,15/05/2021,3,2,78,2,76,49,0,0
297,07/05/2021,3,3,73,30,43,49,0,0
787,15/05/2021,3,4,104,21,83,49,0,0
638,10/05/2021,3,0,101,45,56,59,0,0
587,19/05/2021,3,2,79,73,6,83,0,0
67,10/05/2021,3,1,51,28,23,59,0,0
242,14/05/2021,3,3,135,90,45,49,0,0
391,13/05/2021,3,1,75,33,42,49,0,0
624,21/05/2021,3,2,77,54,23,60,0,0
193,20/05/2021,3,1,107,47,60,49,0,0
372,21/05/2021,3,18,74,74,0,NA,NA,NA
677,24/05/2021,3,0,40,21,19,49,0,0
654,19/05/2021,3,6,53,18,35,66,0,0
637,27/05/2021,3,0,74,49,25,125,0,0
352,18/05/2021,3,0,64,53,11,80,0,0
151,15/05/2021,3,7,69,15,54,49,0,0
864,11/05/2021,3,1,84,24,60,72,0,0
510,17/05/2021,3,1,142,21,121,49,0,0
619,10/05/2021,3,0,101,34,67,55,0,0
220,18/05/2021,3,28,75,72,3,63,0,0
5,21/05/2021,3,5,84,31,53,55,0,0
256,19/05/2021,3,2,107,66,41,52,0,0
850,01/05/2021,3,2,81,25,56,49,0,0
632,10/05/2021,3,0,82,31,51,60,0,0
103,13/05/2021,3,0,161,89,72,55,0,0
148,08/05/2021,3,0,25,3,22,49,0,0
65,27/05/2021,3,0,78,68,10,52,0,0
403,20/05/2021,3,2,96,78,18,67,0,0
742,22/05/2021,3,1,73,57,16,74,0,0
120,20/05/2021,3,2,152,121,31,57,0,0
82,01/05/2021,3,0,96,27,69,49,0,0
304,07/05/2021,3,2,58,7,51,49,0,0
423,21/05/2021,3,1,49,28,21,55,0,0
641,21/05/2021,3,0,160,85,75,55,0,0
815,24/05/2021,3,12,117,71,46,74,0,0
29,14/05/2021,3,0,54,0,54,NA,NA,NA
378,17/05/2021,3,0,84,62,22,52,0,0
104,19/05/2021,3,1,61,59,2,123,0,0
31,17/05/2021,3,1,62,34,28,52,0,0
840,22/05/2021,3,3,309,181,128,49,0,0
651,03/05/2021,3,1,77,6,71,49,0,0
640,08/05/2021,3,4,122,29,93,49,0,0
470,18/05/2021,3,2,78,76,2,82,0,0
773,23/05/2021,3,1,73,56,17,57,0,0
724,25/05/2021,3,1,85,71,14,184,0,0
585,11/05/2021,3,4,56,57,-1,NA,NA,NA
115,14/05/2021,3,0,115,14,101,49,0,0
761,08/05/2021,3,0,83,13,70,49,0,0
37,15/05/2021,3,2,79,13,66,49,0,0
54,16/05/2021,3,1,60,25,35,49,0,0
92,21/05/2021,3,1,121,72,49,55,0,0
875,20/05/2021,3,0,92,80,12,67,0,0
433,15/05/2021,3,1,317,31,286,66,0,0
563,19/05/2021,3,2,68,42,26,60,0,0
737,12/05/2021,3,2,40,9,31,49,0,0
753,19/05/2021,3,7,120,78,42,52,0,0
851,12/05/2021,3,0,92,4,88,49,0,0
784,15/05/2021,3,2,47,7,40,49,0,0
649,07/05/2021,3,3,61,19,42,49,0,0
539,16/05/2021,3,2,95,18,77,49,0,0
638,11/05/2021,3,0,101,50,51,59,0,0
456,14/05/2021,3,4,86,25,61,49,0,0
560,10/05/2021,3,0,80,57,23,57,0,0
704,14/05/2021,3,1,31,4,27,49,0,0
823,18/05/2021,3,1,60,58,2,49,0,0
748,21/05/2021,3,7,137,61,76,55,0,0
228,20/05/2021,3,2,40,22,18,49,0,0
665,21/05/2021,3,1,105,105,0,NA,NA,NA
46,24/05/2021,3,2,58,46,12,67,0,0
253,18/05/2021,3,1,57,28,29,67,0,0
311,25/05/2021,3,0,97,59,38,67,0,0
714,20/05/2021,3,0,59,23,36,55,0,0
190,15/05/2021,3,4,76,25,51,49,0,0
361,12/05/2021,3,38,27,16,11,80,0,0
45,19/05/2021,3,1,155,40,115,49,0,0
619,11/05/2021,3,0,101,38,63,59,0,0
294,19/05/2021,3,7,110,109,1,70,0,0
668,23/05/2021,3,7,296,31,265,49,0,0
643,21/05/2021,3,2,101,71,30,55,0,0
124,04/05/2021,3,2,52,35,17,60,0,0
235,09/05/2021,3,6,151,17,134,49,0,0
103,15/05/2021,3,1,160,143,17,67,0,0
148,06/05/2021,3,0,25,3,22,49,0,0
254,27/05/2021,3,1,77,52,25,55,0,0
403,17/05/2021,3,2,96,44,52,55,0,0
481,20/05/2021,3,0,56,47,9,57,0,0
366,20/05/2021,3,2,78,63,15,72,0,0
82,02/05/2021,3,0,96,23,73,49,0,0
411,10/05/2021,3,2,183,38,145,49,0,0
189,21/05/2021,3,0,165,143,22,57,0,0
641,22/05/2021,3,0,160,157,3,74,0,0
64,23/05/2021,3,3,244,12,232,49,0,0
29,13/05/2021,3,0,54,0,54,NA,NA,NA
537,17/05/2021,3,4,98,98,0,NA,NA,NA
479,19/05/2021,3,1,54,46,8,62,0,0
827,18/05/2021,3,1,69,65,4,79,0,0
840,20/05/2021,3,1,311,113,198,49,0,0
578,03/05/2021,3,2,56,6,50,55,0,0
273,06/05/2021,3,0,103,103,0,NA,NA,NA
801,21/05/2021,3,7,160,143,17,62,0,0
606,23/05/2021,3,1,45,25,20,55,0,0
329,25/05/2021,3,10,97,58,39,57,0,0
125,12/05/2021,3,2,34,34,0,NA,NA,NA
756,11/05/2021,3,0,106,76,30,72,0,0
471,09/05/2021,3,8,112,30,82,49,0,0
802,15/05/2021,3,2,63,27,36,49,0,0
788,17/05/2021,3,2,89,74,15,57,0,0
292,21/05/2021,3,1,238,68,170,55,0,0
417,18/05/2021,3,0,103,63,40,52,0,0
167,17/05/2021,3,4,80,78,2,90,0,0
137,20/05/2021,3,24,122,26,96,49,0,0
246,09/05/2021,3,1,111,11,100,49,0,0
745,20/05/2021,3,1,104,77,27,60,0,0
48,12/05/2021,3,5,174,4,170,49,0,0
707,14/05/2021,3,2,38,20,18,49,0,0
548,08/05/2021,3,1,90,15,75,49,0,0
787,16/05/2021,3,3,105,10,95,49,0,0
780,11/05/2021,3,3,57,37,20,52,0,0
561,15/05/2021,3,1,59,13,46,49,0,0
211,10/05/2021,3,3,57,41,16,55,0,0
47,16/05/2021,3,2,55,14,41,49,0,0
514,15/05/2021,3,6,228,44,184,49,0,0
685,20/05/2021,3,3,137,110,27,67,0,0
193,19/05/2021,3,1,107,47,60,49,0,0
85,19/05/2021,3,7,113,118,-5,NA,NA,NA
145,24/05/2021,3,3,55,34,21,57,0,0
186,19/05/2021,3,1,57,44,13,57,0,0
712,16/05/2021,3,1,84,3,81,49,0,0
598,20/05/2021,3,0,146,134,12,74,0,0
151,13/05/2021,3,7,69,32,37,55,0,0
42,11/05/2021,3,2,97,47,50,55,0,0
743,21/05/2021,3,1,125,72,53,49,0,0
215,10/05/2021,3,0,46,42,4,59,0,0
750,17/05/2021,3,2,110,95,15,62,0,0
290,23/05/2021,3,2,105,36,69,49,0,0
203,22/05/2021,3,0,40,19,21,66,0,0
61,04/05/2021,3,1,99,40,59,55,0,0
675,09/05/2021,3,2,54,10,44,49,0,0
389,13/05/2021,3,2,124,49,75,49,0,0
345,06/05/2021,3,0,101,64,37,64,0,0
130,26/05/2021,3,1,80,46,34,74,0,0
472,17/05/2021,3,6,228,27,201,66,0,0
861,22/05/2021,3,0,61,60,1,169,0,0
767,20/05/2021,3,1,66,54,12,67,0,0
261,16/05/2021,3,3,99,19,80,49,0,0
78,07/05/2021,3,0,44,17,27,49,0,0
238,11/05/2021,3,1,65,32,33,55,0,0
741,21/05/2021,3,0,70,36,34,55,0,0
460,23/05/2021,3,9,100,41,59,49,0,0
549,15/05/2021,3,0,61,0,61,NA,NA,NA
537,18/05/2021,3,4,98,98,0,NA,NA,NA
248,19/05/2021,3,0,82,48,34,60,0,0
21,17/05/2021,3,1,59,25,34,49,0,0
840,23/05/2021,3,3,309,65,244,49,0,0
578,05/05/2021,3,2,56,19,37,55,0,0
599,06/05/2021,3,3,150,71,79,49,0,0
379,22/05/2021,3,3,284,220,64,108,0,0
81,23/05/2021,3,1,59,14,45,49,0,0
844,24/05/2021,3,0,61,17,44,75,0,0
798,12/05/2021,3,1,80,80,0,NA,NA,NA
115,11/05/2021,3,0,115,24,91,49,0,0
682,09/05/2021,3,2,78,8,70,49,0,0
443,16/05/2021,3,10,80,21,59,49,0,0
628,16/05/2021,3,4,55,9,46,49,0,0
422,21/05/2021,3,1,78,31,47,55,0,0
213,19/05/2021,3,3,145,124,21,62,0,0
209,15/05/2021,3,1,113,77,36,60,0,0
569,20/05/2021,3,0,120,70,50,49,0,0
246,12/05/2021,3,1,111,19,92,49,0,0
100,19/05/2021,3,77,147,85,62,52,0,0
540,09/05/2021,3,2,80,9,71,49,0,0
267,15/05/2021,3,2,81,17,64,49,0,0
649,09/05/2021,3,3,61,14,47,49,0,0
284,16/05/2021,3,1,25,10,15,49,0,0
866,10/05/2021,3,0,100,18,82,52,0,0
567,14/05/2021,3,0,61,21,40,49,0,0
915,10/05/2021,3,4,185,14,171,35,0,0
488,16/05/2021,3,3,63,17,46,49,0,0
514,17/05/2021,3,6,228,40,188,49,0,0
748,20/05/2021,3,7,137,77,60,49,0,0
262,20/05/2021,3,1,50,37,13,67,0,0
554,20/05/2021,3,1,41,41,0,NA,NA,NA
581,24/05/2021,3,39,186,166,20,67,0,0
247,18/05/2021,3,1,92,49,43,55,0,0
637,18/05/2021,3,1,73,74,-1,NA,NA,NA
352,20/05/2021,3,0,64,47,17,60,0,0
778,13/05/2021,3,2,79,60,19,72,0,0
332,12/05/2021,3,1,39,20,19,55,0,0
45,20/05/2021,3,1,155,44,111,49,0,0
887,08/05/2021,3,17,306,6,300,39,0,0
385,17/05/2021,3,2,61,40,21,59,0,0
316,23/05/2021,3,1,38,17,21,49,0,0
757,23/05/2021,3,0,117,33,84,49,0,0
61,02/05/2021,3,1,99,3,96,49,0,0
752,09/05/2021,3,24,20,6,14,49,0,0
434,13/05/2021,3,3,57,23,34,49,0,0
63,07/05/2021,3,1,63,5,58,49,0,0
515,27/05/2021,3,5,107,61,46,57,0,0
509,17/05/2021,3,1,111,47,64,49,0,0
691,20/05/2021,3,1,31,29,2,89,0,0
429,20/05/2021,3,3,122,44,78,49,0,0
288,14/05/2021,3,0,60,35,25,49,0,0
330,07/05/2021,3,2,117,23,94,49,0,0
187,11/05/2021,3,1,40,13,27,49,0,0
653,15/05/2021,3,2,113,12,101,49,0,0
101,23/05/2021,3,1,59,33,26,49,0,0
80,23/05/2021,3,1,124,37,87,49,0,0
702,13/05/2021,3,1,49,40,9,74,0,0
535,19/05/2021,3,1,82,42,40,52,0,0
618,17/05/2021,3,10,141,65,76,49,0,0
840,24/05/2021,3,3,309,93,216,49,0,0
425,03/05/2021,3,3,247,17,230,66,0,0
395,06/05/2021,3,2,70,19,51,49,0,0
379,20/05/2021,3,2,285,176,109,66,0,0
771,23/05/2021,3,2,28,21,7,62,0,0
337,25/05/2021,3,0,60,33,27,57,0,0
798,11/05/2021,3,1,80,76,4,95,0,0
756,12/05/2021,3,0,106,73,33,64,0,0
730,09/05/2021,3,2,73,5,68,49,0,0
244,13/05/2021,3,1,199,87,112,49,0,0
155,08/05/2021,3,0,93,11,82,49,0,0
813,21/05/2021,3,1,129,84,45,55,0,0
321,19/05/2021,3,1,39,16,23,49,0,0
209,17/05/2021,3,1,113,59,54,55,0,0
538,18/05/2021,3,1,43,32,11,62,0,0
737,09/05/2021,3,2,40,5,35,49,0,0
753,20/05/2021,3,7,120,100,20,57,0,0
48,11/05/2021,3,5,174,8,166,49,0,0
281,15/05/2021,3,2,81,13,68,49,0,0
720,07/05/2021,3,2,37,5,32,49,0,0
234,15/05/2021,3,3,59,15,44,49,0,0
711,11/05/2021,3,1,88,41,47,59,0,0
524,15/05/2021,3,0,110,21,89,49,0,0
806,10/05/2021,3,2,134,114,20,60,0,0
759,14/05/2021,3,1,86,31,55,49,0,0
111,04/05/2021,3,0,60,60,0,NA,NA,NA
369,20/05/2021,3,4,86,63,23,60,0,0
865,20/05/2021,3,1,84,13,71,49,0,0
674,12/05/2021,3,1,97,2,95,49,0,0
792,24/05/2021,3,0,102,80,22,92,0,0
399,18/05/2021,3,0,61,56,5,59,0,0
293,18/05/2021,3,1,59,35,24,52,0,0
506,18/05/2021,3,0,195,42,153,49,0,0
365,15/05/2021,3,0,68,43,25,55,0,0
332,13/05/2021,3,1,39,20,19,55,0,0
126,19/05/2021,3,3,117,79,38,52,0,0
77,07/05/2021,3,3,100,31,69,49,0,0
34,17/05/2021,3,3,85,55,30,60,0,0
559,23/05/2021,3,45,140,91,49,73,0,0
158,22/05/2021,3,1,23,23,0,NA,NA,NA
289,01/05/2021,3,1,67,40,27,52,0,0
235,10/05/2021,3,5,152,29,123,49,0,0
855,13/05/2021,3,1,175,66,109,49,0,0
317,07/05/2021,3,0,80,14,66,49,0,0
867,20/05/2021,3,1,59,59,0,NA,NA,NA
218,19/05/2021,3,3,75,48,27,49,0,0
227,22/05/2021,3,2,42,30,12,60,0,0
860,20/05/2021,3,7,85,52,33,49,0,0
82,12/05/2021,3,0,96,65,31,72,0,0
78,09/05/2021,3,0,44,13,31,49,0,0
187,12/05/2021,3,1,40,11,29,49,0,0
201,15/05/2021,3,4,134,10,124,49,0,0
334,23/05/2021,3,1,57,28,29,56,0,0
188,24/05/2021,3,9,112,72,40,49,0,0
492,13/05/2021,3,3,34,21,13,52,0,0
112,19/05/2021,3,0,84,75,9,65,0,0
483,18/05/2021,3,3,96,38,58,49,0,0
453,05/05/2021,3,2,136,55,81,55,0,0
469,04/05/2021,3,4,192,38,154,66,0,0
36,05/05/2021,3,1,62,7,55,49,0,0
847,19/05/2021,3,5,192,68,124,35,0,0
81,07/05/2021,3,1,59,3,56,49,0,0
808,25/05/2021,3,2,166,113,53,64,0,0
585,12/05/2021,3,5,55,46,9,80,0,0
135,13/05/2021,3,6,60,61,-1,NA,NA,NA
8,11/05/2021,3,1,39,14,25,49,0,0
244,16/05/2021,3,1,199,35,164,49,0,0
735,08/05/2021,3,0,29,1,28,49,0,0
754,19/05/2021,3,0,62,26,36,49,0,0
600,19/05/2021,3,1,49,33,16,80,0,0
433,17/05/2021,3,2,316,81,235,66,0,0
839,18/05/2021,3,3,152,97,55,49,0,0
749,10/05/2021,3,1,153,10,143,49,0,0
171,19/05/2021,3,3,46,19,27,49,0,0
851,11/05/2021,3,0,92,1,91,49,0,0
182,14/05/2021,3,2,78,4,74,49,0,0
315,10/05/2021,3,0,62,53,9,72,0,0
230,15/05/2021,3,0,80,12,68,49,0,0
717,11/05/2021,3,4,189,68,121,55,0,0
90,14/05/2021,3,0,78,9,69,49,0,0
211,11/05/2021,3,3,57,44,13,60,0,0
47,12/05/2021,3,2,55,48,7,89,0,0
1,04/05/2021,3,2,98,76,22,74,0,0
583,20/05/2021,3,2,79,53,26,52,0,0
617,21/05/2021,3,1,43,31,12,60,0,0
674,11/05/2021,3,1,97,6,91,49,0,0
652,24/05/2021,3,0,69,50,19,72,0,0
15,19/05/2021,3,0,31,23,8,80,0,0
333,18/05/2021,3,1,56,56,0,NA,NA,NA
136,19/05/2021,3,0,128,74,54,49,0,0
184,13/05/2021,3,0,51,40,11,72,0,0
776,11/05/2021,3,0,104,50,54,49,0,0
412,20/05/2021,3,9,92,28,64,49,0,0
619,08/05/2021,3,0,101,9,92,49,0,0
220,17/05/2021,3,29,74,67,7,62,0,0
668,22/05/2021,3,4,299,55,244,49,0,0
818,22/05/2021,3,1,80,80,0,NA,NA,NA
289,04/05/2021,3,1,67,37,30,57,0,0
534,10/05/2021,3,0,85,35,50,49,0,0
505,13/05/2021,3,0,84,32,52,49,0,0
513,07/05/2021,3,1,76,16,60,49,0,0
224,21/05/2021,3,1,56,25,31,55,0,0
509,20/05/2021,3,1,111,34,77,49,0,0
772,20/05/2021,3,0,57,53,4,70,0,0
33,20/05/2021,3,3,77,43,34,49,0,0
843,13/05/2021,3,3,63,47,16,52,0,0
330,09/05/2021,3,2,117,16,101,49,0,0
696,11/05/2021,3,1,88,31,57,49,0,0
455,15/05/2021,3,8,243,8,235,66,0,0
101,24/05/2021,3,1,59,53,6,89,0,0
501,24/05/2021,3,27,206,35,171,49,0,0
537,13/05/2021,3,3,99,92,7,94,0,0
688,18/05/2021,3,4,115,70,45,52,0,0
21,18/05/2021,3,1,59,25,34,49,0,0
663,04/05/2021,3,0,148,10,138,49,0,0
469,05/05/2021,3,4,192,33,159,66,0,0
36,06/05/2021,3,1,62,4,58,49,0,0
847,20/05/2021,3,5,192,64,128,35,0,0
351,07/05/2021,3,1,65,20,45,49,0,0
550,25/05/2021,3,1,111,57,54,49,0,0
774,11/05/2021,3,5,100,29,71,49,0,0
115,12/05/2021,3,0,115,19,96,49,0,0
730,11/05/2021,3,2,73,12,61,49,0,0
802,16/05/2021,3,1,64,17,47,49,0,0
54,08/05/2021,3,1,60,6,54,49,0,0
464,20/05/2021,3,1,265,52,213,66,0,0
138,19/05/2021,3,3,95,56,39,60,0,0
173,16/05/2021,3,3,68,18,50,49,0,0
137,18/05/2021,3,24,122,20,102,49,0,0
91,11/05/2021,3,1,79,24,55,55,0,0
100,20/05/2021,3,77,147,103,44,49,0,0
851,13/05/2021,3,0,92,3,89,49,0,0
281,14/05/2021,3,4,79,10,69,49,0,0
726,10/05/2021,3,0,39,37,2,89,0,0
325,16/05/2021,3,0,45,45,0,NA,NA,NA
170,11/05/2021,3,0,105,40,65,55,0,0
90,15/05/2021,3,0,78,10,68,49,0,0
57,09/05/2021,3,1,139,23,116,49,0,0
18,14/05/2021,3,3,89,18,71,49,0,0
701,04/05/2021,3,2,60,29,31,57,0,0
369,21/05/2021,3,4,86,43,43,58,0,0
848,21/05/2021,3,6,132,30,102,35,0,0
376,11/05/2021,3,2,62,46,16,67,0,0
442,25/05/2021,3,8,150,142,8,74,0,0
512,19/05/2021,3,1,61,29,32,49,0,0
360,16/05/2021,3,1,43,3,40,49,0,0
136,20/05/2021,3,0,128,103,25,57,0,0
259,14/05/2021,3,0,60,32,28,49,0,0
287,12/05/2021,3,3,120,67,53,49,0,0
706,17/05/2021,3,1,73,46,27,52,0,0
215,09/05/2021,3,0,46,14,32,49,0,0
805,18/05/2021,3,1,112,61,51,60,0,0
107,21/05/2021,3,29,60,54,6,85,0,0
791,22/05/2021,3,40,88,95,-7,NA,NA,NA
289,02/05/2021,3,1,67,15,52,49,0,0
235,11/05/2021,3,5,152,40,112,49,0,0
831,13/05/2021,3,0,150,51,99,49,0,0
812,06/05/2021,3,2,135,36,99,49,0,0
254,21/05/2021,3,1,77,39,38,49,0,0
764,20/05/2021,3,2,67,25,42,49,0,0
772,22/05/2021,3,0,57,56,1,129,0,0
429,21/05/2021,3,3,122,59,63,55,0,0
82,13/05/2021,3,0,96,65,31,80,0,0
330,10/05/2021,3,2,117,34,83,49,0,0
189,11/05/2021,3,0,165,129,36,80,0,0
653,14/05/2021,3,2,113,10,103,49,0,0
738,24/05/2021,3,1,123,67,56,55,0,0
733,24/05/2021,3,1,99,41,58,49,0,0
477,14/05/2021,3,4,116,11,105,49,0,0
479,20/05/2021,3,1,54,40,14,57,0,0
363,16/05/2021,3,5,94,45,49,59,0,0
655,04/05/2021,3,0,72,45,27,67,0,0
421,05/05/2021,3,0,19,19,0,NA,NA,NA
36,07/05/2021,3,1,62,19,43,49,0,0
847,21/05/2021,3,6,191,48,143,35,0,0
81,05/05/2021,3,1,59,9,50,49,0,0
319,25/05/2021,3,6,108,63,45,60,0,0
646,10/05/2021,3,13,123,48,75,49,0,0
344,12/05/2021,3,2,63,18,45,49,0,0
761,11/05/2021,3,0,83,20,63,49,0,0
473,13/05/2021,3,2,48,32,16,60,0,0
786,08/05/2021,3,1,61,1,60,49,0,0
464,21/05/2021,3,1,265,63,202,90,0,0
128,20/05/2021,3,1,20,16,4,80,0,0
527,16/05/2021,3,7,54,10,44,49,0,0
430,18/05/2021,3,2,87,59,28,55,0,0
435,10/05/2021,3,69,51,17,34,52,0,0
700,20/05/2021,3,7,125,51,74,49,0,0
540,12/05/2021,3,2,80,33,47,49,0,0
784,14/05/2021,3,3,46,10,36,49,0,0
747,10/05/2021,3,0,64,61,3,82,0,0
364,16/05/2021,3,2,128,60,68,59,0,0
11,11/05/2021,3,1,83,37,46,55,0,0
159,16/05/2021,3,0,77,12,65,49,0,0
806,09/05/2021,3,2,134,46,88,49,0,0
47,14/05/2021,3,2,55,10,45,49,0,0
701,05/05/2021,3,2,60,37,23,57,0,0
685,21/05/2021,3,2,138,124,14,69,0,0
917,12/05/2021,3,2,104,3,101,35,0,0
376,12/05/2021,3,2,62,46,16,67,0,0
444,24/05/2021,3,4,115,69,46,49,0,0
512,17/05/2021,3,1,61,27,34,49,0,0
783,16/05/2021,3,3,77,11,66,49,0,0
484,19/05/2021,3,0,40,34,6,77,0,0
689,13/05/2021,3,0,130,29,101,49,0,0
571,12/05/2021,3,0,161,16,145,49,0,0
543,19/05/2021,3,1,64,60,4,127,0,0
556,07/05/2021,3,1,116,20,96,49,0,0
180,19/05/2021,3,0,41,23,18,52,0,0
38,21/05/2021,3,1,49,45,4,79,0,0
96,22/05/2021,3,14,55,49,6,104,0,0
61,01/05/2021,3,1,99,6,93,49,0,0
418,11/05/2021,3,0,116,29,87,49,0,0
121,14/05/2021,3,0,110,43,67,49,0,0
146,07/05/2021,3,2,39,16,23,49,0,0
867,21/05/2021,3,1,59,58,1,133,0,0
579,17/05/2021,3,0,44,38,6,57,0,0
612,14/05/2021,3,2,40,9,31,49,0,0
860,21/05/2021,3,12,80,54,26,55,0,0
288,13/05/2021,3,0,60,41,19,60,0,0
493,10/05/2021,3,2,33,12,21,49,0,0
189,12/05/2021,3,0,165,133,32,80,0,0
828,13/05/2021,3,1,74,21,53,49,0,0
485,22/05/2021,3,0,65,62,3,NA,NA,NA
501,25/05/2021,3,22,211,44,167,49,0,0
858,14/05/2021,3,0,81,32,49,49,0,0
899,20/05/2021,3,2,103,85,18,57,0,0
845,18/05/2021,3,1,119,88,31,67,0,0
655,05/05/2021,3,0,72,50,22,74,0,0
580,05/05/2021,3,0,98,47,51,49,0,0
405,05/05/2021,3,1,89,35,54,49,0,0
847,22/05/2021,3,6,191,64,127,35,0,0
81,06/05/2021,3,1,59,12,47,49,0,0
698,25/05/2021,3,3,113,68,45,62,0,0
166,11/05/2021,3,3,63,23,40,49,0,0
662,12/05/2021,3,1,106,60,46,55,0,0
800,08/05/2021,3,2,55,8,47,49,0,0
161,13/05/2021,3,0,61,32,29,55,0,0
786,09/05/2021,3,1,61,2,59,49,0,0
622,21/05/2021,3,1,43,25,18,87,0,0
213,20/05/2021,3,4,144,126,18,62,0,0
862,16/05/2021,3,0,110,18,92,49,0,0
563,18/05/2021,3,2,68,37,31,60,0,0
631,11/05/2021,3,1,70,54,16,64,0,0
71,20/05/2021,3,0,62,27,35,49,0,0
397,12/05/2021,3,0,75,39,36,60,0,0
296,15/05/2021,3,3,57,23,34,49,0,0
649,11/05/2021,3,3,61,33,28,59,0,0
325,15/05/2021,3,0,45,10,35,49,0,0
614,10/05/2021,3,2,80,51,29,55,0,0
567,16/05/2021,3,0,61,16,45,49,0,0
368,10/05/2021,3,1,84,31,53,49,0,0
488,14/05/2021,3,3,63,17,46,49,0,0
111,06/05/2021,3,0,60,46,14,74,0,0
731,21/05/2021,3,4,95,62,33,52,0,0
451,12/05/2021,3,2,81,33,48,66,0,0
295,12/05/2021,3,3,102,24,78,49,0,0
448,24/05/2021,3,3,150,55,95,95,0,0
462,17/05/2021,3,4,185,11,174,55,0,0
500,18/05/2021,3,5,74,48,26,57,0,0
598,18/05/2021,3,0,146,145,1,85,0,0
365,13/05/2021,3,0,68,54,14,72,0,0
776,12/05/2021,3,0,104,41,63,49,0,0
134,20/05/2021,3,1,47,33,14,67,0,0
544,08/05/2021,3,1,52,4,48,49,0,0
180,17/05/2021,3,0,41,19,22,49,0,0
316,21/05/2021,3,1,38,30,8,67,0,0
256,22/05/2021,3,1,108,107,1,79,0,0
124,02/05/2021,3,2,52,6,46,49,0,0
752,10/05/2021,3,24,20,8,12,52,0,0
121,15/05/2021,3,0,110,47,63,49,0,0
146,08/05/2021,3,2,39,12,27,49,0,0
65,21/05/2021,3,1,77,47,30,55,0,0
218,20/05/2021,3,0,78,68,10,57,0,0
310,14/05/2021,3,1,71,16,55,49,0,0
854,21/05/2021,3,6,104,26,78,120,0,0
495,13/05/2021,3,2,83,20,63,49,0,0
902,10/05/2021,3,2,124,37,87,49,0,0
423,11/05/2021,3,1,49,23,26,55,0,0
445,14/05/2021,3,1,168,8,160,49,0,0
99,22/05/2021,3,1,166,166,0,NA,NA,NA
97,24/05/2021,3,4,103,87,16,85,0,0
558,14/05/2021,3,0,44,6,38,49,0,0
402,18/05/2021,3,0,155,113,42,52,0,0
346,18/05/2021,3,3,117,70,47,55,0,0
463,02/05/2021,3,0,163,13,150,55,0,0
651,04/05/2021,3,1,77,12,65,49,0,0
283,08/05/2021,3,1,75,12,63,49,0,0
801,18/05/2021,3,7,160,54,106,49,0,0
606,05/05/2021,3,1,45,8,37,49,0,0
313,18/05/2021,3,0,31,27,4,71,0,0
298,11/05/2021,3,2,227,80,147,49,0,0
542,13/05/2021,3,4,71,68,3,62,0,0
8,07/05/2021,3,1,39,17,22,49,0,0
195,13/05/2021,3,1,50,14,36,49,0,0
155,09/05/2021,3,0,93,7,86,49,0,0
72,20/05/2021,3,2,58,47,11,57,0,0
252,20/05/2021,3,1,263,151,112,49,0,0
739,17/05/2021,3,2,73,27,46,49,0,0
758,18/05/2021,3,2,71,65,6,79,0,0
631,12/05/2021,3,1,70,61,9,80,0,0
100,18/05/2021,3,77,147,61,86,62,0,0
853,10/05/2021,3,5,97,31,66,55,0,0
66,14/05/2021,3,0,152,7,145,49,0,0
315,08/05/2021,3,0,62,31,31,55,0,0
873,15/05/2021,3,2,99,10,89,49,0,0
711,10/05/2021,3,1,88,42,46,55,0,0
794,15/05/2021,3,0,137,5,132,55,0,0
437,10/05/2021,3,3,162,57,105,49,0,0
488,15/05/2021,3,3,63,19,44,49,0,0
371,03/05/2021,3,0,36,14,22,55,0,0
511,20/05/2021,3,1,75,45,30,49,0,0
106,12/05/2021,3,1,30,19,11,55,0,0
307,12/05/2021,3,1,78,21,57,49,0,0
687,24/05/2021,3,2,85,52,33,49,0,0
462,19/05/2021,3,4,185,16,169,55,0,0
500,16/05/2021,3,5,74,12,62,49,0,0
136,18/05/2021,3,0,128,70,58,49,0,0
271,15/05/2021,3,0,70,27,43,49,0,0
42,13/05/2021,3,2,97,51,46,49,0,0
39,21/05/2021,3,1,60,45,15,67,0,0
77,10/05/2021,3,3,100,42,58,49,0,0
180,18/05/2021,3,0,41,23,18,52,0,0
530,23/05/2021,3,1,59,52,7,63,0,0
531,22/05/2021,3,1,58,57,1,74,0,0
30,02/05/2021,3,1,70,22,48,49,0,0
383,11/05/2021,3,4,81,37,44,59,0,0
835,15/05/2021,3,5,99,24,75,49,0,0
146,09/05/2021,3,2,39,17,22,49,0,0
592,21/05/2021,3,1,83,84,-1,NA,NA,NA
322,20/05/2021,3,0,100,34,66,49,0,0
772,13/05/2021,3,0,57,31,26,52,0,0
274,20/05/2021,3,2,208,53,155,39,0,0
82,14/05/2021,3,0,96,18,78,49,0,0
330,08/05/2021,3,2,117,25,92,49,0,0
696,12/05/2021,3,1,88,39,49,52,0,0
562,15/05/2021,3,1,67,10,57,49,0,0
172,22/05/2021,3,2,83,83,0,NA,NA,NA
697,24/05/2021,3,2,107,51,56,57,0,0
93,14/05/2021,3,3,138,30,108,49,0,0
272,19/05/2021,3,1,126,66,60,49,0,0
845,17/05/2021,3,0,120,74,46,57,0,0
463,04/05/2021,3,0,163,29,134,55,0,0
421,06/05/2021,3,0,19,13,6,64,0,0
273,05/05/2021,3,0,103,101,2,82,0,0
849,19/05/2021,3,0,84,50,34,49,0,0
645,05/05/2021,3,3,38,20,18,55,0,0
844,18/05/2021,3,0,61,18,43,55,0,0
166,12/05/2021,3,1,65,19,46,49,0,0
135,14/05/2021,3,6,60,58,2,62,0,0
800,07/05/2021,3,2,55,7,48,49,0,0
309,13/05/2021,3,1,15,13,2,74,0,0
178,08/05/2021,3,0,38,14,24,49,0,0
202,21/05/2021,3,0,76,74,2,121,0,0
600,20/05/2021,3,1,49,41,8,67,0,0
173,17/05/2021,3,3,68,44,24,60,0,0
430,20/05/2021,3,2,87,45,42,55,0,0
91,09/05/2021,3,2,78,11,67,49,0,0
89,19/05/2021,3,2,58,47,11,52,0,0
557,11/05/2021,3,1,103,64,39,55,0,0
66,15/05/2021,3,0,152,1,151,49,0,0
315,09/05/2021,3,0,62,24,38,55,0,0
873,16/05/2021,3,3,98,13,85,49,0,0
717,10/05/2021,3,4,189,62,127,55,0,0
524,14/05/2021,3,1,109,27,82,49,0,0
498,10/05/2021,3,0,87,40,47,49,0,0
18,16/05/2021,3,3,89,23,66,49,0,0
878,02/05/2021,3,0,218,3,215,44,0,0
216,20/05/2021,3,1,57,44,13,57,0,0
617,12/05/2021,3,1,43,26,17,80,0,0
627,11/05/2021,3,0,41,7,34,59,0,0
442,24/05/2021,3,8,150,125,25,49,0,0
654,18/05/2021,3,6,53,14,39,66,0,0
311,16/05/2021,3,0,97,29,68,49,0,0
686,20/05/2021,3,0,46,28,18,49,0,0
271,14/05/2021,3,0,70,17,53,49,0,0
147,13/05/2021,3,1,79,38,41,49,0,0
543,21/05/2021,3,1,64,56,8,124,0,0
219,10/05/2021,3,4,73,21,52,49,0,0
699,18/05/2021,3,0,62,47,15,80,0,0
407,23/05/2021,3,1,40,11,29,49,0,0
921,22/05/2021,3,5,170,7,163,39,0,0
604,02/05/2021,3,1,81,11,70,49,0,0
681,11/05/2021,3,2,69,33,36,55,0,0
32,14/05/2021,3,1,104,24,80,49,0,0
812,07/05/2021,3,2,135,16,119,49,0,0
20,21/05/2021,3,2,80,64,16,67,0,0
322,18/05/2021,3,0,100,33,67,49,0,0
127,14/05/2021,3,1,59,4,55,49,0,0
274,21/05/2021,3,2,208,25,183,39,0,0
288,16/05/2021,3,0,60,26,34,49,0,0
210,09/05/2021,3,2,100,50,50,49,0,0
400,11/05/2021,3,2,28,14,14,52,0,0
179,14/05/2021,3,1,91,9,82,49,0,0
723,22/05/2021,3,1,80,80,0,NA,NA,NA
601,24/05/2021,3,4,64,34,30,57,0,0
883,13/05/2021,3,6,98,22,76,45,0,0
272,20/05/2021,3,1,126,67,59,49,0,0
31,16/05/2021,3,1,62,14,48,49,0,0
453,03/05/2021,3,1,137,20,117,55,0,0
425,04/05/2021,3,3,247,40,207,66,0,0
336,06/05/2021,3,1,73,44,29,55,0,0
23,20/05/2021,3,4,60,32,28,49,0,0
771,05/05/2021,3,2,28,19,9,62,0,0
313,19/05/2021,3,0,31,28,3,71,0,0
196,12/05/2021,3,0,138,9,129,49,0,0
129,14/05/2021,3,11,189,98,91,55,0,0
800,09/05/2021,3,2,55,8,47,49,0,0
309,15/05/2021,3,1,15,14,1,57,0,0
279,08/05/2021,3,0,57,10,47,49,0,0
92,19/05/2021,3,1,121,60,61,49,0,0
51,19/05/2021,3,2,78,68,10,74,0,0
12,17/05/2021,3,1,42,34,8,57,0,0
839,20/05/2021,3,5,150,116,34,52,0,0
374,09/05/2021,3,0,56,12,44,49,0,0
745,19/05/2021,3,1,104,58,46,55,0,0
670,10/05/2021,3,6,102,75,27,57,0,0
416,15/05/2021,3,0,34,4,30,49,0,0
297,10/05/2021,3,3,73,39,34,55,0,0
521,16/05/2021,3,1,54,10,44,49,0,0
780,08/05/2021,3,3,57,39,18,49,0,0
736,15/05/2021,3,1,104,7,97,49,0,0
525,10/05/2021,3,1,74,47,27,49,0,0
47,15/05/2021,3,2,55,7,48,49,0,0
878,05/05/2021,3,0,218,17,201,44,0,0
216,21/05/2021,3,1,57,28,29,55,0,0
519,12/05/2021,3,0,64,30,34,60,0,0
35,11/05/2021,3,0,110,35,75,49,0,0
507,24/05/2021,3,3,197,57,140,49,0,0
192,18/05/2021,3,0,86,62,24,62,0,0
114,18/05/2021,3,0,75,73,2,147,0,0
404,20/05/2021,3,0,67,65,2,85,0,0
689,12/05/2021,3,0,130,26,104,49,0,0
287,13/05/2021,3,3,120,70,50,49,0,0
45,17/05/2021,3,1,155,32,123,49,0,0
633,10/05/2021,3,1,49,26,23,49,0,0
285,18/05/2021,3,0,80,50,30,59,0,0
476,21/05/2021,3,0,173,35,138,55,0,0
921,23/05/2021,3,5,170,2,168,45,0,0
289,03/05/2021,3,1,67,19,48,49,0,0
918,10/05/2021,3,0,201,38,163,39,0,0
103,14/05/2021,3,1,160,111,49,49,0,0
812,08/05/2021,3,2,135,21,114,49,0,0
515,21/05/2021,3,7,105,93,12,74,0,0
322,19/05/2021,3,0,100,25,75,49,0,0
52,13/05/2021,3,6,136,105,31,52,0,0
392,20/05/2021,3,0,176,82,94,49,0,0
359,16/05/2021,3,3,101,25,76,49,0,0
117,07/05/2021,3,0,94,56,38,49,0,0
28,11/05/2021,3,2,126,97,29,80,0,0
494,14/05/2021,3,1,138,8,130,49,0,0
520,22/05/2021,3,0,58,58,0,NA,NA,NA
97,25/05/2021,3,4,103,75,28,80,0,0
537,14/05/2021,3,3,99,87,12,62,0,0
83,18/05/2021,3,7,161,130,31,57,0,0
214,16/05/2021,3,4,82,21,61,49,0,0
140,03/05/2021,3,3,167,42,125,49,0,0
425,05/05/2021,3,2,248,49,199,66,0,0
283,07/05/2021,3,1,75,6,69,49,0,0
801,20/05/2021,3,7,160,48,112,49,0,0
351,05/05/2021,3,1,65,26,39,55,0,0
911,19/05/2021,3,0,158,14,144,49,0,0
298,12/05/2021,3,2,227,54,173,49,0,0
9,10/05/2021,3,0,27,25,2,72,0,0
447,08/05/2021,3,0,143,28,115,49,0,0
473,15/05/2021,3,2,48,16,32,49,0,0
735,09/05/2021,3,0,29,3,26,49,0,0
292,20/05/2021,3,0,239,42,197,49,0,0
684,19/05/2021,3,2,96,66,30,52,0,0
816,15/05/2021,3,3,79,63,16,52,0,0
563,20/05/2021,3,2,68,55,13,57,0,0
572,09/05/2021,3,0,61,18,43,49,0,0
122,20/05/2021,3,5,116,102,14,74,0,0
853,09/05/2021,3,5,97,18,79,49,0,0
790,14/05/2021,3,1,98,18,80,66,0,0
720,10/05/2021,3,0,39,9,30,55,0,0
230,16/05/2021,3,0,80,6,74,49,0,0
705,10/05/2021,3,1,90,42,48,49,0,0
721,14/05/2021,3,29,111,43,68,49,0,0
669,10/05/2021,3,0,87,36,51,49,0,0
18,12/05/2021,3,2,90,44,46,55,0,0
265,05/05/2021,3,1,56,10,46,49,0,0
86,20/05/2021,3,1,47,34,13,57,0,0
594,12/05/2021,3,43,64,48,16,80,0,0
295,11/05/2021,3,0,105,17,88,49,0,0
608,24/05/2021,3,12,128,47,81,49,0,0
162,18/05/2021,3,0,122,95,27,62,0,0
797,16/05/2021,3,0,67,21,46,49,0,0
838,19/05/2021,3,3,62,44,18,80,0,0
365,12/05/2021,3,0,68,61,7,90,0,0
571,13/05/2021,3,0,161,17,144,49,0,0
199,21/05/2021,3,1,81,37,44,55,0,0
349,08/05/2021,3,1,89,29,60,49,0,0
143,18/05/2021,3,1,119,80,39,52,0,0
476,22/05/2021,3,0,173,36,137,55,0,0
2,23/05/2021,3,3,56,32,24,49,0,0
604,03/05/2021,3,1,81,12,69,49,0,0
60,11/05/2021,3,0,57,31,26,64,0,0
176,15/05/2021,3,3,97,6,91,49,0,0
240,06/05/2021,3,1,70,40,30,49,0,0
282,20/05/2021,3,29,672,110,562,49,0,0
58,20/05/2021,3,0,67,33,34,55,0,0
691,13/05/2021,3,1,31,13,18,72,0,0
854,20/05/2021,3,0,110,47,63,55,0,0
338,07/05/2021,3,5,395,72,323,49,0,0
777,12/05/2021,3,3,117,60,57,55,0,0
641,13/05/2021,3,0,160,4,156,49,0,0
334,16/05/2021,3,1,57,5,52,49,0,0
188,25/05/2021,3,7,114,79,35,57,0,0
586,14/05/2021,3,3,80,63,17,64,0,0
688,19/05/2021,3,4,115,82,33,52,0,0
225,16/05/2021,3,11,69,11,58,49,0,0
140,01/05/2021,3,2,168,46,122,49,0,0
469,06/05/2021,3,4,192,24,168,66,0,0
336,08/05/2021,3,0,74,36,38,49,0,0
849,20/05/2021,3,0,84,40,44,49,0,0
351,06/05/2021,3,1,65,26,39,55,0,0
856,18/05/2021,3,1,119,50,69,49,0,0
646,12/05/2021,3,16,120,44,76,49,0,0
344,11/05/2021,3,2,63,17,46,49,0,0
8,09/05/2021,3,1,39,8,31,49,0,0
195,16/05/2021,3,2,49,10,39,49,0,0
318,08/05/2021,3,0,59,12,47,49,0,0
760,20/05/2021,3,1,35,20,15,49,0,0
138,20/05/2021,3,0,98,59,39,49,0,0
527,17/05/2021,3,7,54,51,3,65,0,0
575,19/05/2021,3,1,49,40,9,59,0,0
533,10/05/2021,3,0,91,2,89,49,0,0
370,20/05/2021,3,0,40,35,5,62,0,0
48,10/05/2021,3,5,174,5,169,49,0,0
790,15/05/2021,3,1,98,18,80,66,0,0
297,08/05/2021,3,3,73,28,45,49,0,0
49,15/05/2021,3,2,146,33,113,49,0,0
780,10/05/2021,3,3,57,29,28,49,0,0
811,15/05/2021,3,3,87,39,48,49,0,0
669,11/05/2021,3,0,87,37,50,49,0,0
47,13/05/2021,3,2,55,47,8,82,0,0
823,04/05/2021,3,1,60,23,37,49,0,0
583,21/05/2021,3,1,80,31,49,55,0,0
617,13/05/2021,3,1,43,32,11,60,0,0
639,12/05/2021,3,0,59,23,36,49,0,0
444,25/05/2021,3,4,115,74,41,49,0,0
683,18/05/2021,3,1,65,36,29,52,0,0
824,16/05/2021,3,0,339,7,332,55,0,0
431,20/05/2021,3,3,127,91,36,64,0,0
342,13/05/2021,3,0,114,63,51,49,0,0
198,11/05/2021,3,1,134,73,61,59,0,0
510,20/05/2021,3,1,142,31,111,49,0,0
349,09/05/2021,3,1,89,24,65,49,0,0
294,17/05/2021,3,0,117,95,22,65,0,0
174,13/05/2021,3,2,26,5,21,55,0,0
490,23/05/2021,3,5,160,12,148,49,0,0
124,01/05/2021,3,2,52,25,27,49,0,0
632,09/05/2021,3,0,82,11,71,49,0,0
277,13/05/2021,3,6,66,36,30,52,0,0
63,08/05/2021,3,3,61,7,54,49,0,0
781,20/05/2021,3,3,80,49,31,49,0,0
764,07/05/2021,3,2,67,3,64,49,0,0
861,14/05/2021,3,0,61,44,17,60,0,0
108,20/05/2021,3,0,78,44,34,49,0,0
411,07/05/2021,3,0,185,41,144,49,0,0
777,11/05/2021,3,3,117,50,67,55,0,0
741,14/05/2021,3,0,70,14,56,49,0,0
334,14/05/2021,3,1,57,8,49,49,0,0
355,25/05/2021,3,1,98,68,30,67,0,0
492,14/05/2021,3,6,31,15,16,49,0,0
83,20/05/2021,3,8,160,141,19,62,0,0
346,16/05/2021,3,2,118,54,64,49,0,0
457,05/05/2021,3,2,61,24,37,49,0,0
578,06/05/2021,3,2,56,13,43,55,0,0
13,08/05/2021,3,4,77,77,0,NA,NA,NA
50,07/05/2021,3,2,119,12,107,49,0,0
388,06/05/2021,3,1,59,35,24,52,0,0
301,18/05/2021,3,1,100,32,68,49,0,0
497,11/05/2021,3,1,192,38,154,49,0,0
662,13/05/2021,3,2,105,56,49,49,0,0
22,09/05/2021,3,0,64,16,48,49,0,0
59,14/05/2021,3,0,75,3,72,49,0,0
178,09/05/2021,3,0,38,18,20,49,0,0
782,12/05/2021,3,0,20,15,5,147,0,0
427,20/05/2021,3,5,305,57,248,66,0,0
167,15/05/2021,3,0,84,19,65,49,0,0
538,20/05/2021,3,1,43,25,18,52,0,0
625,10/05/2021,3,0,161,46,115,49,0,0
122,18/05/2021,3,5,116,113,3,82,0,0
48,13/05/2021,3,5,174,5,169,49,0,0
522,14/05/2021,3,2,60,47,13,52,0,0
726,08/05/2021,3,0,39,18,21,49,0,0
734,15/05/2021,3,2,59,26,33,49,0,0
11,07/05/2021,3,2,82,17,65,49,0,0
770,15/05/2021,3,4,31,9,22,49,0,0
57,10/05/2021,3,1,139,36,103,49,0,0
221,12/05/2021,3,1,61,26,35,55,0,0
371,01/05/2021,3,1,35,10,25,49,0,0
703,21/05/2021,3,1,90,70,20,67,0,0
228,12/05/2021,3,2,40,12,28,49,0,0
639,11/05/2021,3,0,59,8,51,49,0,0
608,25/05/2021,3,11,129,61,68,49,0,0
247,17/05/2021,3,1,92,54,38,55,0,0
797,18/05/2021,3,0,67,67,0,NA,NA,NA
431,18/05/2021,3,2,128,81,47,59,0,0
271,12/05/2021,3,0,70,32,38,55,0,0
607,11/05/2021,3,1,74,44,30,67,0,0
102,18/05/2021,3,0,60,44,16,67,0,0
556,10/05/2021,3,9,108,30,78,49,0,0
626,17/05/2021,3,3,99,61,38,60,0,0
174,14/05/2021,3,2,26,0,26,49,0,0
490,22/05/2021,3,5,160,26,134,49,0,0
185,02/05/2021,3,2,166,23,143,49,0,0
658,10/05/2021,3,1,80,68,12,55,0,0
835,13/05/2021,3,5,99,52,47,55,0,0
513,08/05/2021,3,1,76,23,53,49,0,0
869,20/05/2021,3,1,59,56,3,91,0,0
438,08/05/2021,3,13,83,14,69,55,0,0
426,14/05/2021,3,11,152,52,100,49,0,0
588,21/05/2021,3,0,59,55,4,87,0,0
338,08/05/2021,3,5,395,60,335,49,0,0
28,12/05/2021,3,2,126,106,20,89,0,0
741,15/05/2021,3,0,70,11,59,49,0,0
723,15/05/2021,3,1,80,23,57,49,0,0
656,25/05/2021,3,0,115,76,39,87,0,0
795,14/05/2021,3,10,95,31,64,49,0,0
688,20/05/2021,3,2,117,83,34,52,0,0
618,18/05/2021,3,9,142,64,78,49,0,0
663,01/05/2021,3,1,147,5,142,49,0,0
260,04/05/2021,3,0,120,38,82,49,0,0
273,08/05/2021,3,0,103,103,0,NA,NA,NA
470,11/05/2021,3,1,79,79,0,NA,NA,NA
606,07/05/2021,3,1,45,4,41,49,0,0
301,19/05/2021,3,1,100,31,69,49,0,0
123,10/05/2021,3,1,94,21,73,49,0,0
68,14/05/2021,3,0,116,6,110,49,0,0
268,09/05/2021,3,1,77,25,52,49,0,0
161,16/05/2021,3,0,61,12,49,49,0,0
318,09/05/2021,3,0,59,17,42,49,0,0
204,12/05/2021,3,0,64,1,63,49,0,0
684,20/05/2021,3,2,96,66,30,52,0,0
390,17/05/2021,3,2,134,56,78,49,0,0
551,20/05/2021,3,0,115,81,34,52,0,0
87,11/05/2021,3,4,114,21,93,49,0,0
278,18/05/2021,3,0,105,33,72,49,0,0
670,13/05/2021,3,6,102,59,43,49,0,0
522,15/05/2021,3,2,60,43,17,52,0,0
871,08/05/2021,3,3,75,21,54,49,0,0
234,16/05/2021,3,3,59,15,44,49,0,0
409,07/05/2021,3,3,104,27,77,49,0,0
587,16/05/2021,3,2,79,18,61,49,0,0
211,09/05/2021,3,3,57,22,35,49,0,0
765,15/05/2021,3,3,98,18,80,49,0,0
660,04/05/2021,3,6,180,28,152,49,0,0
841,20/05/2021,3,0,182,36,146,55,0,0
262,13/05/2021,3,2,49,21,28,55,0,0
307,11/05/2021,3,1,78,29,49,49,0,0
25,20/05/2021,3,3,49,51,-2,NA,NA,NA
654,17/05/2021,3,6,53,11,42,66,0,0
333,17/05/2021,3,1,56,56,0,NA,NA,NA
584,18/05/2021,3,1,96,94,2,85,0,0
689,14/05/2021,3,0,130,12,118,49,0,0
864,12/05/2021,3,1,84,24,60,64,0,0
582,17/05/2021,3,0,53,51,2,85,0,0
75,11/05/2021,3,1,80,18,62,49,0,0
699,17/05/2021,3,0,62,44,18,64,0,0
316,12/05/2021,3,1,38,38,0,NA,NA,NA
830,22/05/2021,3,0,66,52,14,159,0,0
842,02/05/2021,3,3,88,52,36,49,0,0
863,09/05/2021,3,6,89,3,86,49,0,0
837,13/05/2021,3,3,323,39,284,66,0,0
317,08/05/2021,3,0,80,10,70,49,0,0
676,21/05/2021,3,1,114,83,31,60,0,0
715,07/05/2021,3,2,86,86,0,NA,NA,NA
481,13/05/2021,3,0,56,35,21,49,0,0
480,20/05/2021,3,0,28,18,10,57,0,0
411,08/05/2021,3,0,185,60,125,49,0,0
423,12/05/2021,3,1,49,24,25,60,0,0
179,13/05/2021,3,1,91,44,47,55,0,0
19,16/05/2021,3,1,93,17,76,49,0,0
697,23/05/2021,3,2,107,36,71,49,0,0
378,14/05/2021,3,1,83,14,69,49,0,0
248,20/05/2021,3,0,82,64,18,60,0,0
618,16/05/2021,3,12,139,25,114,49,0,0
457,03/05/2021,3,1,62,14,48,49,0,0
680,06/05/2021,3,3,77,23,54,49,0,0
13,06/05/2021,3,5,76,72,4,75,0,0
573,11/05/2021,3,1,56,20,36,55,0,0
388,07/05/2021,3,1,59,6,53,49,0,0
337,18/05/2021,3,1,59,51,8,76,0,0
123,11/05/2021,3,1,94,22,72,49,0,0
135,10/05/2021,3,4,62,46,16,67,0,0
761,10/05/2021,3,0,83,22,61,49,0,0
443,03/05/2021,3,4,86,21,65,49,0,0
528,09/05/2021,3,0,119,24,95,49,0,0
204,13/05/2021,3,0,64,1,63,49,0,0
417,20/05/2021,3,0,103,70,33,49,0,0
394,17/05/2021,3,2,66,37,29,49,0,0
569,18/05/2021,3,0,120,45,75,49,0,0
205,11/05/2021,3,0,126,29,97,49,0,0
278,20/05/2021,3,0,105,27,78,49,0,0
312,09/05/2021,3,2,95,18,77,49,0,0
296,14/05/2021,3,3,57,25,32,49,0,0
548,09/05/2021,3,1,90,18,72,49,0,0
258,16/05/2021,3,1,142,29,113,49,0,0
638,07/05/2021,3,21,80,27,53,49,0,0
770,16/05/2021,3,4,31,6,25,49,0,0
437,09/05/2021,3,3,162,21,141,49,0,0
154,16/05/2021,3,4,100,20,80,49,0,0
660,06/05/2021,3,6,180,21,159,49,0,0
263,20/05/2021,3,0,66,31,35,49,0,0
262,12/05/2021,3,1,50,36,14,60,0,0
372,11/05/2021,3,4,88,77,11,85,0,0
46,19/05/2021,3,2,58,56,2,93,0,0
393,18/05/2021,3,1,59,42,17,57,0,0
43,17/05/2021,3,2,71,50,21,60,0,0
728,18/05/2021,3,1,46,42,4,62,0,0
243,15/05/2021,3,1,126,85,41,55,0,0
17,11/05/2021,3,1,93,89,4,84,0,0
582,21/05/2021,3,0,53,51,2,142,0,0
77,11/05/2021,3,3,100,28,72,49,0,0
34,19/05/2021,3,2,86,42,44,64,0,0
316,13/05/2021,3,1,38,31,7,80,0,0
158,23/05/2021,3,0,24,16,8,52,0,0
850,02/05/2021,3,3,80,20,60,49,0,0
863,10/05/2021,3,7,88,17,71,49,0,0
121,13/05/2021,3,0,110,48,62,55,0,0
345,07/05/2021,3,0,101,12,89,49,0,0
869,21/05/2021,3,1,59,49,10,141,0,0
218,07/05/2021,3,2,76,22,54,49,0,0
426,13/05/2021,3,11,152,77,75,55,0,0
177,20/05/2021,3,0,48,32,16,59,0,0
338,09/05/2021,3,3,397,63,334,49,0,0
895,12/05/2021,3,0,69,42,27,55,0,0
358,13/05/2021,3,2,91,50,41,55,0,0
803,16/05/2021,3,1,68,42,26,49,0,0
499,24/05/2021,3,0,31,11,20,49,0,0
69,13/05/2021,3,1,59,31,28,49,0,0
402,19/05/2021,3,0,155,116,39,57,0,0
31,18/05/2021,3,1,62,40,22,62,0,0
840,04/05/2021,3,1,311,71,240,49,0,0
517,03/05/2021,3,3,55,11,44,49,0,0
13,07/05/2021,3,4,77,74,3,70,0,0
847,07/05/2021,3,8,189,33,156,35,0,0
771,07/05/2021,3,2,28,28,0,NA,NA,NA
55,19/05/2021,3,1,32,17,15,60,0,0
497,12/05/2021,3,1,192,33,159,49,0,0
428,10/05/2021,3,3,89,40,49,55,0,0
730,10/05/2021,3,2,73,16,57,49,0,0
473,03/05/2021,3,4,46,8,38,55,0,0
237,09/05/2021,3,4,117,7,110,49,0,0
754,12/05/2021,3,0,62,16,46,49,0,0
427,11/05/2021,3,6,304,6,298,66,0,0
496,17/05/2021,3,1,59,29,30,49,0,0
551,18/05/2021,3,0,115,98,17,63,0,0
246,11/05/2021,3,1,111,23,88,49,0,0
753,18/05/2021,3,1,126,73,53,52,0,0
540,11/05/2021,3,2,80,39,41,49,0,0
446,14/05/2021,3,8,125,34,91,49,0,0
747,09/05/2021,3,0,64,18,46,49,0,0
118,15/05/2021,3,3,56,19,37,49,0,0
11,08/05/2021,3,1,83,13,70,49,0,0
746,14/05/2021,3,2,58,19,39,49,0,0
525,09/05/2021,3,1,74,14,60,49,0,0
765,14/05/2021,3,3,98,19,79,49,0,0
514,06/05/2021,3,6,228,18,210,49,0,0
487,21/05/2021,3,0,39,20,19,67,0,0
106,13/05/2021,3,1,30,14,16,55,0,0
270,12/05/2021,3,1,59,23,36,59,0,0
119,19/05/2021,3,2,66,41,25,52,0,0
15,17/05/2021,3,0,31,21,10,72,0,0
356,17/05/2021,3,3,133,88,45,60,0,0
431,19/05/2021,3,2,128,78,50,59,0,0
342,14/05/2021,3,1,113,28,85,49,0,0
153,11/05/2021,3,1,63,36,27,60,0,0
45,18/05/2021,3,1,155,40,115,49,0,0
564,11/05/2021,3,3,71,27,44,49,0,0
143,19/05/2021,3,2,118,90,28,52,0,0
38,14/05/2021,3,1,49,9,40,49,0,0
53,23/05/2021,3,0,70,63,7,91,0,0
850,03/05/2021,3,2,81,20,61,49,0,0
60,10/05/2021,3,0,57,21,36,59,0,0
855,14/05/2021,3,1,175,47,128,49,0,0
317,06/05/2021,3,0,80,22,58,49,0,0
396,20/05/2021,3,1,29,22,7,65,0,0
403,08/05/2021,3,2,96,42,54,49,0,0
742,13/05/2021,3,1,73,28,45,49,0,0
623,21/05/2021,3,0,78,60,18,60,0,0
411,09/05/2021,3,0,185,38,147,49,0,0
895,11/05/2021,3,0,69,41,28,55,0,0
445,13/05/2021,3,1,168,55,113,49,0,0
88,15/05/2021,3,1,41,6,35,49,0,0
870,25/05/2021,3,3,43,33,10,67,0,0
889,13/05/2021,3,1,123,7,116,45,0,0
402,20/05/2021,3,0,155,107,48,52,0,0
225,18/05/2021,3,11,69,41,28,67,0,0
635,01/05/2021,3,1,87,13,74,49,0,0
517,05/05/2021,3,2,56,18,38,49,0,0
377,06/05/2021,3,1,148,76,72,55,0,0
847,09/05/2021,3,4,193,29,164,35,0,0
773,06/05/2021,3,1,73,46,27,59,0,0
181,19/05/2021,3,1,33,25,8,72,0,0
196,10/05/2021,3,0,138,3,135,49,0,0
428,12/05/2021,3,6,86,38,48,59,0,0
22,07/05/2021,3,0,64,18,46,49,0,0
95,04/05/2021,3,2,86,41,45,55,0,0
458,08/05/2021,3,3,178,36,142,49,0,0
202,13/05/2021,3,0,76,54,22,72,0,0
266,11/05/2021,3,0,61,45,16,72,0,0
529,17/05/2021,3,3,38,21,17,49,0,0
758,19/05/2021,3,3,70,66,4,85,0,0
87,12/05/2021,3,2,116,22,94,49,0,0
71,18/05/2021,3,1,61,27,34,49,0,0
312,13/05/2021,3,2,95,22,73,49,0,0
707,15/05/2021,3,0,40,16,24,49,0,0
548,10/05/2021,3,1,90,43,47,49,0,0
258,15/05/2021,3,1,142,18,124,49,0,0
614,08/05/2021,3,1,81,17,64,49,0,0
746,15/05/2021,3,2,58,16,42,49,0,0
57,11/05/2021,3,1,139,36,103,49,0,0
154,15/05/2021,3,4,100,22,78,49,0,0
391,06/05/2021,3,0,76,32,44,49,0,0
703,20/05/2021,3,0,91,86,5,77,0,0
228,13/05/2021,3,2,40,12,28,49,0,0
627,12/05/2021,3,0,41,11,30,59,0,0
904,19/05/2021,3,2,272,12,260,66,0,0
162,17/05/2021,3,0,122,90,32,57,0,0
637,17/05/2021,3,2,72,69,3,71,0,0
647,19/05/2021,3,4,89,68,21,52,0,0
778,15/05/2021,3,1,80,53,27,49,0,0
17,12/05/2021,3,1,93,87,6,84,0,0
199,19/05/2021,3,2,80,65,15,67,0,0
323,07/05/2021,3,0,31,6,25,49,0,0
206,19/05/2021,3,16,197,141,56,59,0,0
316,14/05/2021,3,1,38,11,27,49,0,0
441,22/05/2021,3,0,168,70,98,90,0,0
185,04/05/2021,3,3,165,36,129,49,0,0
418,10/05/2021,3,0,116,39,77,49,0,0
837,15/05/2021,3,2,324,7,317,66,0,0
63,09/05/2021,3,3,61,9,52,49,0,0
65,20/05/2021,3,1,77,37,40,49,0,0
308,09/05/2021,3,2,46,2,44,49,0,0
861,13/05/2021,3,0,61,42,19,64,0,0
108,21/05/2021,3,0,78,44,34,55,0,0
304,10/05/2021,3,2,58,30,28,49,0,0
238,12/05/2021,3,1,65,44,21,60,0,0
741,13/05/2021,3,0,70,43,27,49,0,0
19,14/05/2021,3,2,92,9,83,49,0,0
601,23/05/2021,3,3,65,15,50,49,0,0
69,14/05/2021,3,1,59,8,51,49,0,0
804,18/05/2021,3,3,142,41,101,49,0,0
483,16/05/2021,3,4,95,16,79,49,0,0
635,06/05/2021,3,1,87,41,46,49,0,0
517,06/05/2021,3,2,56,25,31,49,0,0
13,05/05/2021,3,4,77,53,24,80,0,0
801,08/05/2021,3,7,160,18,142,49,0,0
116,05/05/2021,3,0,61,45,16,72,0,0
814,19/05/2021,3,1,67,66,1,123,0,0
196,11/05/2021,3,0,138,6,132,49,0,0
428,13/05/2021,3,6,86,42,44,55,0,0
447,07/05/2021,3,0,143,25,118,49,0,0
161,03/05/2021,3,1,60,9,51,55,0,0
628,08/05/2021,3,4,55,9,46,49,0,0
518,12/05/2021,3,1,16,14,2,67,0,0
321,10/05/2021,3,1,39,10,29,49,0,0
862,17/05/2021,3,0,110,50,60,49,0,0
137,19/05/2021,3,24,122,17,105,49,0,0
205,12/05/2021,3,0,126,27,99,49,0,0
370,18/05/2021,3,0,40,29,11,80,0,0
540,13/05/2021,3,2,80,30,50,49,0,0
666,15/05/2021,3,2,64,10,54,49,0,0
726,07/05/2021,3,0,39,9,30,49,0,0
284,15/05/2021,3,1,25,9,16,49,0,0
711,08/05/2021,3,1,88,22,66,49,0,0
149,14/05/2021,3,0,88,5,83,49,0,0
152,10/05/2021,3,1,90,27,63,49,0,0
759,15/05/2021,3,0,87,36,51,49,0,0
701,06/05/2021,3,2,60,26,34,49,0,0
634,21/05/2021,3,0,20,19,1,85,0,0
865,12/05/2021,3,1,84,7,77,49,0,0
665,11/05/2021,3,1,105,44,61,55,0,0
353,19/05/2021,3,1,51,40,11,80,0,0
393,17/05/2021,3,0,60,42,18,57,0,0
797,17/05/2021,3,0,67,66,1,85,0,0
647,20/05/2021,3,2,91,88,3,63,0,0
420,12/05/2021,3,12,57,37,20,67,0,0
198,12/05/2021,3,1,134,80,54,72,0,0
126,21/05/2021,3,3,117,94,23,93,0,0
384,07/05/2021,3,0,101,23,78,49,0,0
626,19/05/2021,3,3,99,64,35,60,0,0
357,14/05/2021,3,1,82,7,75,49,0,0
486,22/05/2021,3,0,124,89,35,60,0,0
30,01/05/2021,3,1,70,27,43,49,0,0
675,11/05/2021,3,1,55,31,24,67,0,0
257,13/05/2021,3,1,43,25,18,55,0,0
513,06/05/2021,3,2,75,23,52,49,0,0
224,20/05/2021,3,1,56,25,31,49,0,0
403,09/05/2021,3,2,96,53,43,49,0,0
275,13/05/2021,3,4,113,65,48,55,0,0
250,21/05/2021,3,0,115,40,75,59,0,0
338,10/05/2021,3,3,397,69,328,49,0,0
305,11/05/2021,3,2,57,16,41,49,0,0
641,14/05/2021,3,0,160,7,153,49,0,0
460,16/05/2021,3,4,105,12,93,49,0,0
870,23/05/2021,3,2,44,21,23,49,0,0
858,13/05/2021,3,0,81,44,37,60,0,0
804,19/05/2021,3,3,142,44,98,49,0,0
21,16/05/2021,3,1,59,8,51,49,0,0
457,01/05/2021,3,0,63,16,47,52,0,0
680,03/05/2021,3,3,77,11,66,49,0,0
336,05/05/2021,3,1,73,54,19,67,0,0
553,06/05/2021,3,23,19,4,15,49,0,0
331,05/05/2021,3,2,92,43,49,60,0,0
459,18/05/2021,3,4,88,50,38,52,0,0
123,12/05/2021,3,0,95,15,80,49,0,0
756,13/05/2021,3,0,106,71,35,64,0,0
471,07/05/2021,3,8,112,45,67,49,0,0
161,04/05/2021,3,1,60,17,43,55,0,0
628,09/05/2021,3,4,55,9,46,49,0,0
72,12/05/2021,3,1,59,43,16,74,0,0
128,11/05/2021,3,1,20,14,6,72,0,0
529,11/05/2021,3,3,38,18,20,52,0,0
575,18/05/2021,3,1,49,37,12,59,0,0
87,09/05/2021,3,3,115,10,105,49,0,0
615,20/05/2021,3,0,71,58,13,57,0,0
557,09/05/2021,3,1,103,24,79,49,0,0
239,14/05/2021,3,0,40,13,27,49,0,0
747,08/05/2021,3,0,64,14,50,49,0,0
118,16/05/2021,3,2,57,9,48,49,0,0
614,07/05/2021,3,2,80,20,60,49,0,0
168,15/05/2021,3,0,48,12,36,49,0,0
437,11/05/2021,3,2,163,74,89,49,0,0
765,12/05/2021,3,1,100,56,44,64,0,0
701,01/05/2021,3,2,60,1,59,49,0,0
841,21/05/2021,3,0,182,38,144,49,0,0
755,12/05/2021,3,0,87,44,43,72,0,0
554,11/05/2021,3,1,41,11,30,49,0,0
353,20/05/2021,3,1,51,37,14,80,0,0
251,18/05/2021,3,0,124,81,43,49,0,0
846,17/05/2021,3,1,188,26,162,45,0,0
838,20/05/2021,3,3,62,58,4,65,0,0
593,13/05/2021,3,7,74,51,23,72,0,0
589,11/05/2021,3,2,141,73,68,55,0,0
39,18/05/2021,3,1,60,40,20,80,0,0
384,08/05/2021,3,0,101,27,74,49,0,0
805,19/05/2021,3,3,110,64,46,60,0,0
407,14/05/2021,3,1,40,3,37,49,0,0
732,22/05/2021,3,0,60,47,13,67,0,0
185,01/05/2021,3,1,167,27,140,49,0,0
658,11/05/2021,3,1,80,26,54,55,0,0
32,13/05/2021,3,1,104,83,21,72,0,0
345,09/05/2021,3,0,101,30,71,49,0,0
20,20/05/2021,3,2,80,77,3,85,0,0
308,08/05/2021,3,1,47,5,42,49,0,0
222,13/05/2021,3,1,76,18,58,49,0,0
250,20/05/2021,3,0,115,55,60,59,0,0
212,08/05/2021,3,1,77,60,17,82,0,0
305,12/05/2021,3,5,54,15,39,49,0,0
414,15/05/2021,3,21,165,39,126,49,0,0
868,14/05/2021,3,0,83,10,73,49,0,0
636,23/05/2021,3,0,120,51,69,53,0,0
504,13/05/2021,3,0,83,18,65,49,0,0
272,18/05/2021,3,1,126,72,54,49,0,0
827,16/05/2021,3,1,69,43,26,49,0,0
877,01/05/2021,3,0,158,24,134,35,0,0
680,04/05/2021,3,3,77,21,56,49,0,0
395,05/05/2021,3,2,70,28,42,52,0,0
573,08/05/2021,3,1,56,8,48,49,0,0
331,06/05/2021,3,3,91,39,52,55,0,0
724,18/05/2021,3,2,84,83,1,129,0,0
774,10/05/2021,3,4,101,29,72,49,0,0
115,10/05/2021,3,0,115,23,92,49,0,0
682,08/05/2021,3,2,78,11,67,49,0,0
161,05/05/2021,3,1,60,17,43,55,0,0
528,08/05/2021,3,0,119,28,91,49,0,0
518,13/05/2021,3,1,16,12,4,67,0,0
321,11/05/2021,3,1,39,10,29,49,0,0
142,12/05/2021,3,2,60,52,8,90,0,0
575,20/05/2021,3,1,49,38,11,67,0,0
435,09/05/2021,3,66,54,9,45,49,0,0
71,19/05/2021,3,0,62,26,36,49,0,0
768,11/05/2021,3,1,86,24,62,49,0,0
267,14/05/2021,3,2,81,20,61,49,0,0
169,09/05/2021,3,0,20,2,18,49,0,0
364,15/05/2021,3,3,127,96,31,64,0,0
409,09/05/2021,3,2,105,23,82,49,0,0
811,14/05/2021,3,3,87,35,52,49,0,0
560,09/05/2021,3,0,80,20,60,49,0,0
154,12/05/2021,3,5,99,39,60,49,0,0
265,03/05/2021,3,1,56,4,52,49,0,0
440,20/05/2021,3,0,265,44,221,66,0,0
594,13/05/2021,3,43,64,41,23,64,0,0
307,13/05/2021,3,2,77,21,56,49,0,0
555,19/05/2021,3,0,117,72,45,64,0,0
269,19/05/2021,3,0,80,10,70,49,0,0
846,18/05/2021,3,1,188,33,155,45,0,0
439,18/05/2021,3,3,88,24,64,49,0,0
420,13/05/2021,3,7,62,34,28,55,0,0
153,13/05/2021,3,1,63,35,28,55,0,0
134,21/05/2021,3,1,47,44,3,91,0,0
75,10/05/2021,3,0,81,18,63,49,0,0
432,19/05/2021,3,0,165,17,148,66,0,0
679,12/05/2021,3,2,87,72,15,85,0,0
732,23/05/2021,3,0,60,20,40,49,0,0
144,02/05/2021,3,0,99,20,79,49,0,0
658,09/05/2021,3,1,80,17,63,49,0,0
176,13/05/2021,3,3,97,38,59,49,0,0
576,09/05/2021,3,2,56,12,44,49,0,0
419,20/05/2021,3,2,108,61,47,66,0,0
579,07/05/2021,3,0,44,10,34,49,0,0
52,14/05/2021,3,8,134,45,89,49,0,0
623,20/05/2021,3,0,78,48,30,49,0,0
493,08/05/2021,3,3,32,5,27,55,0,0
785,12/05/2021,3,1,109,44,65,49,0,0
641,15/05/2021,3,0,160,17,143,49,0,0
485,16/05/2021,3,0,65,8,57,49,0,0
733,25/05/2021,3,0,100,28,72,49,0,0
558,13/05/2021,3,0,44,19,25,49,0,0
112,20/05/2021,3,0,84,51,33,49,0,0
208,18/05/2021,3,0,60,33,27,64,0,0
453,02/05/2021,3,0,138,15,123,55,0,0
260,05/05/2021,3,0,120,31,89,49,0,0
283,05/05/2021,3,1,75,24,51,55,0,0
849,08/05/2021,3,1,83,17,66,49,0,0
552,07/05/2021,3,14,170,23,147,49,0,0
181,18/05/2021,3,1,33,33,0,NA,NA,NA
298,10/05/2021,3,2,227,61,166,49,0,0
129,10/05/2021,3,7,193,47,146,49,0,0
268,07/05/2021,3,1,77,35,42,49,0,0
37,05/05/2021,3,2,79,36,43,49,0,0
565,09/05/2021,3,0,62,23,39,49,0,0
464,12/05/2021,3,1,265,22,243,66,0,0
128,12/05/2021,3,1,20,8,12,64,0,0
529,12/05/2021,3,3,38,18,20,52,0,0
113,07/05/2021,3,1,31,1,30,49,0,0
749,11/05/2021,3,5,149,8,141,49,0,0
710,09/05/2021,3,0,20,4,16,49,0,0
898,11/05/2021,3,1,99,47,52,49,0,0
446,15/05/2021,3,8,125,39,86,49,0,0
297,09/05/2021,3,3,73,14,59,49,0,0
49,16/05/2021,3,9,139,29,110,49,0,0
717,09/05/2021,3,3,190,27,163,49,0,0
164,14/05/2021,3,0,62,18,44,49,0,0
669,09/05/2021,3,0,87,11,76,49,0,0
759,16/05/2021,3,0,87,23,64,49,0,0
514,04/05/2021,3,6,228,29,199,49,0,0
263,21/05/2021,3,0,66,27,39,55,0,0
519,13/05/2021,3,0,64,26,38,55,0,0
554,13/05/2021,3,1,41,15,26,49,0,0
677,19/05/2021,3,0,40,23,17,57,0,0
474,19/05/2021,3,0,112,69,43,52,0,0
311,17/05/2021,3,0,97,58,39,55,0,0
832,18/05/2021,3,1,99,39,60,49,0,0
420,14/05/2021,3,2,67,34,33,55,0,0
864,13/05/2021,3,1,84,35,49,55,0,0
39,05/05/2021,3,1,60,38,22,80,0,0
544,10/05/2021,3,0,53,9,44,49,0,0
143,17/05/2021,3,2,118,63,55,49,0,0
107,14/05/2021,3,29,60,31,29,49,0,0
441,23/05/2021,3,0,168,32,136,60,0,0
30,03/05/2021,3,1,70,31,39,55,0,0
681,09/05/2021,3,2,69,14,55,49,0,0
277,14/05/2021,3,5,67,14,53,49,0,0
576,06/05/2021,3,2,56,16,40,55,0,0
335,21/05/2021,3,2,84,40,44,49,0,0
322,08/05/2021,3,0,100,11,89,49,0,0
326,14/05/2021,3,5,76,22,54,49,0,0
392,21/05/2021,3,0,176,101,75,55,0,0
212,07/05/2021,3,1,77,57,20,72,0,0
380,11/05/2021,3,2,158,46,112,49,0,0
201,13/05/2021,3,4,134,16,118,49,0,0
172,14/05/2021,3,2,83,27,56,49,0,0
355,23/05/2021,3,1,98,46,52,49,0,0
613,13/05/2021,3,0,56,18,38,49,0,0
934,12/05/2021,3,50,49,0,49,35,0,0
21,07/05/2021,3,1,59,0,59,49,0,0
463,06/05/2021,3,0,163,28,135,55,0,0
651,05/05/2021,3,1,77,11,66,49,0,0
377,05/05/2021,3,1,148,100,48,57,0,0
50,11/05/2021,3,2,119,31,88,49,0,0
291,06/05/2021,3,1,60,32,28,49,0,0
329,18/05/2021,3,10,97,25,72,49,0,0
497,10/05/2021,3,1,192,31,161,49,0,0
662,10/05/2021,3,1,106,58,48,49,0,0
303,07/05/2021,3,1,64,39,25,49,0,0
195,04/05/2021,3,1,50,20,30,49,0,0
279,09/05/2021,3,0,57,11,46,49,0,0
72,13/05/2021,3,2,58,34,24,52,0,0
600,12/05/2021,3,1,49,30,19,64,0,0
12,11/05/2021,3,1,42,9,33,49,0,0
538,08/05/2021,3,1,43,2,41,49,0,0
625,09/05/2021,3,0,161,12,149,49,0,0
89,09/05/2021,3,3,57,8,49,49,0,0
768,13/05/2021,3,1,86,30,56,49,0,0
491,15/05/2021,3,5,174,36,138,49,0,0
871,10/05/2021,3,3,75,75,0,NA,NA,NA
734,16/05/2021,3,2,59,28,31,49,0,0
780,09/05/2021,3,3,57,16,41,49,0,0
27,15/05/2021,3,0,78,78,0,NA,NA,NA
806,11/05/2021,3,3,133,113,20,67,0,0
221,15/05/2021,3,1,61,16,45,49,0,0
111,05/05/2021,3,1,59,57,2,94,0,0
233,13/05/2021,3,4,63,45,18,57,0,0
917,13/05/2021,3,2,104,3,101,35,0,0
554,12/05/2021,3,1,41,10,31,49,0,0
231,19/05/2021,3,0,41,27,14,79,0,0
474,18/05/2021,3,0,112,70,42,52,0,0
465,17/05/2021,3,3,264,107,157,55,0,0
832,19/05/2021,3,1,99,35,64,49,0,0
190,13/05/2021,3,4,76,26,50,49,0,0
413,12/05/2021,3,1,115,36,79,49,0,0
39,06/05/2021,3,1,60,28,32,55,0,0
75,07/05/2021,3,0,81,5,76,49,0,0
886,17/05/2021,3,1,151,74,77,49,0,0
290,13/05/2021,3,3,104,60,44,49,0,0
2,22/05/2021,3,3,56,47,9,67,0,0
124,03/05/2021,3,2,52,14,38,55,0,0
534,09/05/2021,3,0,85,12,73,49,0,0
709,14/05/2021,3,0,83,18,65,49,0,0
26,06/05/2021,3,1,65,36,29,55,0,0
419,21/05/2021,3,4,106,51,55,90,0,0
579,09/05/2021,3,0,44,5,39,49,0,0
612,13/05/2021,3,2,40,8,32,55,0,0
177,21/05/2021,3,0,48,13,35,55,0,0
210,10/05/2021,3,3,99,84,15,57,0,0
276,12/05/2021,3,1,203,52,151,49,0,0
562,13/05/2021,3,1,67,33,34,49,0,0
815,14/05/2021,3,12,117,26,91,49,0,0
859,25/05/2021,3,1,84,10,74,49,0,0
613,14/05/2021,3,0,56,16,40,49,0,0
934,11/05/2021,3,48,51,3,48,35,0,0
21,09/05/2021,3,1,59,5,54,49,0,0
655,02/05/2021,3,0,72,8,64,49,0,0
680,05/05/2021,3,3,77,27,50,49,0,0
605,08/05/2021,3,3,157,28,129,49,0,0
50,09/05/2021,3,2,119,19,100,49,0,0
388,05/05/2021,3,1,59,49,10,62,0,0
716,18/05/2021,3,0,104,72,32,84,0,0
646,11/05/2021,3,13,123,56,67,49,0,0
616,10/05/2021,3,3,72,46,26,49,0,0
447,09/05/2021,3,0,143,53,90,49,0,0
309,04/05/2021,3,0,16,16,0,NA,NA,NA
54,09/05/2021,3,1,60,14,46,49,0,0
622,12/05/2021,3,6,38,21,17,60,0,0
51,12/05/2021,3,2,78,48,30,67,0,0
496,11/05/2021,3,1,59,23,36,49,0,0
758,06/05/2021,3,0,73,33,40,55,0,0
749,12/05/2021,3,5,149,7,142,49,0,0
753,06/05/2021,3,2,125,24,101,49,0,0
833,13/05/2021,3,1,82,48,34,49,0,0
401,15/05/2021,3,0,79,15,64,49,0,0
747,11/05/2021,3,0,64,64,0,NA,NA,NA
118,08/05/2021,3,4,55,22,33,49,0,0
70,10/05/2021,3,2,37,11,26,49,0,0
713,16/05/2021,3,1,60,60,0,NA,NA,NA
152,11/05/2021,3,1,90,23,67,55,0,0
242,16/05/2021,3,1,137,42,95,49,0,0
823,02/05/2021,3,1,60,48,12,57,0,0
86,12/05/2021,3,1,47,35,12,74,0,0
451,13/05/2021,3,2,81,30,51,66,0,0
197,11/05/2021,3,0,118,39,79,49,0,0
25,19/05/2021,3,1,51,46,5,79,0,0
186,17/05/2021,3,1,57,42,15,57,0,0
824,17/05/2021,3,0,339,25,314,55,0,0
439,19/05/2021,3,3,88,30,58,49,0,0
190,14/05/2021,3,4,76,19,57,49,0,0
413,13/05/2021,3,1,115,49,66,49,0,0
134,08/05/2021,3,1,47,25,22,49,0,0
349,07/05/2021,3,1,89,25,64,49,0,0
857,19/05/2021,3,1,209,68,141,49,0,0
357,13/05/2021,3,1,82,47,35,55,0,0
643,22/05/2021,3,2,101,97,4,74,0,0
842,01/05/2021,3,3,88,55,33,59,0,0
681,16/05/2021,3,2,69,17,52,49,0,0
835,14/05/2021,3,5,99,26,73,49,0,0
63,06/05/2021,3,2,62,20,42,49,0,0
629,21/05/2021,3,2,60,49,11,67,0,0
58,07/05/2021,3,3,64,60,4,62,0,0
227,13/05/2021,3,3,41,11,30,49,0,0
177,12/05/2021,3,0,48,22,26,64,0,0
807,10/05/2021,3,3,97,21,76,55,0,0
400,12/05/2021,3,2,28,8,20,49,0,0
156,14/05/2021,3,3,145,67,78,49,0,0
101,15/05/2021,3,1,59,22,37,49,0,0
188,23/05/2021,3,8,113,35,78,49,0,0
504,14/05/2021,3,0,83,9,74,49,0,0
264,11/05/2021,3,2,58,49,9,67,0,0
225,08/05/2021,3,10,70,4,66,49,0,0
655,03/05/2021,3,0,72,19,53,49,0,0
260,06/05/2021,3,0,120,38,82,49,0,0
640,06/05/2021,3,0,126,35,91,49,0,0
819,10/05/2021,3,1,79,79,0,NA,NA,NA
773,05/05/2021,3,1,73,59,14,80,0,0
808,18/05/2021,3,1,167,136,31,67,0,0
774,12/05/2021,3,4,101,48,53,49,0,0
428,14/05/2021,3,6,86,31,55,49,0,0
761,09/05/2021,3,0,83,12,71,49,0,0
59,04/05/2021,3,0,75,9,66,49,0,0
237,08/05/2021,3,5,116,32,84,49,0,0
622,13/05/2021,3,6,38,26,12,60,0,0
684,12/05/2021,3,2,96,25,71,49,0,0
496,12/05/2021,3,1,59,20,39,49,0,0
872,07/05/2021,3,1,64,32,32,49,0,0
205,09/05/2021,3,0,126,15,111,49,0,0
71,07/05/2021,3,2,60,2,58,49,0,0
768,10/05/2021,3,1,86,23,63,49,0,0
401,14/05/2021,3,0,79,20,59,49,0,0
871,11/05/2021,3,3,75,75,0,NA,NA,NA
873,08/05/2021,3,4,97,15,82,49,0,0
70,11/05/2021,3,2,37,12,25,49,0,0
587,14/05/2021,3,2,79,15,64,49,0,0
657,10/05/2021,3,0,48,33,15,59,0,0
236,20/05/2021,3,2,117,11,106,49,0,0
371,04/05/2021,3,0,36,15,21,82,0,0
634,12/05/2021,3,0,20,20,0,NA,NA,NA
475,12/05/2021,3,1,98,47,51,55,0,0
665,18/05/2021,3,0,106,52,54,55,0,0
200,19/05/2021,3,5,114,104,10,77,0,0
15,24/05/2021,3,0,31,26,5,82,0,0
43,16/05/2021,3,1,72,13,59,49,0,0
506,20/05/2021,3,1,194,54,140,49,0,0
131,15/05/2021,3,3,46,9,37,49,0,0
864,15/05/2021,3,1,84,18,66,49,0,0
543,08/05/2021,3,1,64,9,55,49,0,0
556,19/05/2021,3,0,117,96,21,62,0,0
886,19/05/2021,3,7,145,81,64,49,0,0
290,14/05/2021,3,2,105,58,47,49,0,0
327,23/05/2021,3,16,52,42,10,77,0,0
850,11/05/2021,3,5,78,50,28,52,0,0
863,17/05/2021,3,6,89,34,55,49,0,0
257,15/05/2021,3,1,43,15,28,49,0,0
26,09/05/2021,3,3,63,7,56,49,0,0
789,20/05/2021,3,0,72,52,20,60,0,0
58,16/05/2021,3,0,67,34,33,49,0,0
310,13/05/2021,3,2,70,48,22,60,0,0
108,12/05/2021,3,0,78,23,55,49,0,0
304,13/05/2021,3,2,58,26,32,49,0,0
276,11/05/2021,3,1,203,54,149,49,0,0
179,17/05/2021,3,1,91,45,46,55,0,0
172,15/05/2021,3,2,83,36,47,49,0,0
501,23/05/2021,3,29,204,56,148,49,0,0
858,20/05/2021,3,0,81,63,18,67,0,0
112,14/05/2021,3,0,84,43,41,49,0,0
346,08/05/2021,3,6,114,39,75,49,0,0
877,04/05/2021,3,0,158,42,116,35,0,0
260,23/05/2021,3,1,119,72,47,58,0,0
395,07/05/2021,3,2,70,12,58,49,0,0
819,08/05/2021,3,0,80,52,28,62,0,0
771,14/05/2021,3,2,28,17,11,49,0,0
55,18/05/2021,3,1,32,18,14,60,0,0
7,10/05/2021,3,2,101,63,38,55,0,0
756,14/05/2021,3,0,106,47,59,49,0,0
8,23/05/2021,3,1,39,22,17,57,0,0
59,05/05/2021,3,0,75,7,68,49,0,0
565,08/05/2021,3,0,62,21,41,49,0,0
202,12/05/2021,3,1,75,55,20,72,0,0
427,10/05/2021,3,6,304,5,299,66,0,0
167,11/05/2021,3,0,84,81,3,95,0,0
872,06/05/2021,3,1,64,54,10,80,0,0
631,09/05/2021,3,1,70,14,56,49,0,0
71,06/05/2021,3,3,59,10,49,49,0,0
898,09/05/2021,3,0,100,17,83,49,0,0
416,14/05/2021,3,0,34,6,28,49,0,0
297,05/05/2021,3,4,72,34,38,55,0,0
787,13/05/2021,3,1,107,24,83,49,0,0
614,17/05/2021,3,1,81,59,22,60,0,0
721,15/05/2021,3,29,111,57,54,49,0,0
67,19/05/2021,3,1,51,19,32,59,0,0
236,18/05/2021,3,2,117,17,100,49,0,0
878,04/05/2021,3,0,218,16,202,44,0,0
86,13/05/2021,3,1,47,37,10,63,0,0
848,12/05/2021,3,6,132,18,114,35,0,0
197,16/05/2021,3,0,118,13,105,49,0,0
581,19/05/2021,3,49,176,150,26,80,0,0
825,24/05/2021,3,4,142,56,86,52,0,0
114,16/05/2021,3,0,75,29,46,49,0,0
574,20/05/2021,3,11,76,36,40,49,0,0
593,15/05/2021,3,5,76,29,47,49,0,0
17,16/05/2021,3,1,93,12,81,49,0,0
412,05/05/2021,3,7,94,16,78,49,0,0
384,20/05/2021,3,0,101,97,4,84,0,0
76,17/05/2021,3,1,92,73,19,52,0,0
5,12/05/2021,3,5,84,47,37,60,0,47
791,23/05/2021,3,41,87,38,49,49,0,0
289,10/05/2021,3,1,67,29,38,52,0,0
235,17/05/2021,3,4,153,29,124,49,0,0
277,20/05/2021,3,5,67,49,18,57,0,0
240,07/05/2021,3,1,70,33,37,49,0,0
419,18/05/2021,3,3,107,69,38,66,0,0
58,15/05/2021,3,0,67,27,40,49,0,0
326,13/05/2021,3,6,75,54,21,74,0,0
480,12/05/2021,3,0,28,12,16,49,0,0
411,13/05/2021,3,1,184,30,154,49,0,0
570,17/05/2021,3,0,149,70,79,49,0,0
562,17/05/2021,3,17,51,31,20,52,0,0
460,15/05/2021,3,2,107,41,66,49,0,0
29,12/05/2021,3,0,54,0,54,NA,NA,NA
492,20/05/2021,3,3,34,28,6,57,0,0
248,14/05/2021,3,0,82,29,53,49,0,0
483,08/05/2021,3,3,96,16,80,49,0,0
663,03/05/2021,3,0,148,8,140,49,0,0
425,21/05/2021,3,6,244,61,183,90,0,0
273,12/05/2021,3,0,103,103,0,NA,NA,NA
379,09/05/2021,3,4,283,60,223,66,0,0
291,12/05/2021,3,1,60,30,30,49,0,0
698,18/05/2021,3,2,114,40,74,49,0,0
774,16/05/2021,3,4,101,12,89,49,0,0
115,17/05/2021,3,0,115,22,93,49,0,0
303,21/05/2021,3,1,64,36,28,55,0,0
95,12/05/2021,3,1,87,36,51,55,0,0
458,09/05/2021,3,3,178,49,129,49,0,0
139,17/05/2021,3,2,57,22,35,49,0,0
600,11/05/2021,3,1,49,32,17,64,0,0
467,12/05/2021,3,3,109,4,105,55,0,0
575,06/05/2021,3,1,49,10,39,55,0,0
631,17/05/2021,3,1,70,46,24,59,0,0
89,06/05/2021,3,3,57,15,42,49,0,0
300,10/05/2021,3,0,210,111,99,49,0,0
522,21/05/2021,3,4,58,39,19,68,0,0
649,05/05/2021,3,3,61,42,19,64,0,0
873,13/05/2021,3,3,98,42,56,49,0,0
170,17/05/2021,3,1,104,76,28,49,0,0
229,16/05/2021,3,4,52,26,26,49,0,0
57,17/05/2021,3,1,139,60,79,49,0,0
221,20/05/2021,3,0,62,31,31,55,0,0
111,01/05/2021,3,0,60,20,40,49,0,0
583,12/05/2021,3,1,80,41,39,55,0,0
106,17/05/2021,3,1,30,24,6,74,0,0
376,16/05/2021,3,0,64,19,45,49,0,0
200,20/05/2021,3,6,113,95,18,74,0,0
825,25/05/2021,3,3,143,61,82,52,0,0
356,16/05/2021,3,7,129,33,96,49,0,0
404,21/05/2021,3,0,67,62,5,122,0,0
184,24/05/2021,3,0,51,40,11,97,0,0
147,16/05/2021,3,1,79,9,70,49,0,0
412,06/05/2021,3,4,97,21,76,49,0,0
556,20/05/2021,3,0,117,98,19,57,0,0
432,20/05/2021,3,0,165,18,147,66,0,0
5,13/05/2021,3,5,84,40,44,55,0,0
486,23/05/2021,3,0,124,30,94,49,0,0
30,10/05/2021,3,1,70,48,22,72,0,0
675,17/05/2021,3,1,55,44,11,79,0,0
855,21/05/2021,3,7,169,115,54,52,0,0
240,09/05/2021,3,1,70,16,54,49,0,0
779,18/05/2021,3,0,104,44,60,55,0,0
579,15/05/2021,3,0,44,11,33,49,0,0
772,18/05/2021,3,0,57,51,6,87,0,0
33,12/05/2021,3,5,75,38,37,67,0,0
117,13/05/2021,3,1,93,49,44,55,0,0
696,17/05/2021,3,0,89,54,35,49,0,0
621,17/05/2021,3,0,60,45,15,67,0,0
738,15/05/2021,3,1,123,12,111,49,0,0
29,11/05/2021,3,0,54,0,54,NA,NA,NA
477,21/05/2021,3,3,117,29,88,55,0,0
83,15/05/2021,3,24,144,51,93,49,0,0
845,08/05/2021,3,1,119,8,111,49,0,0
663,05/05/2021,3,0,148,19,129,49,0,0
469,21/05/2021,3,4,192,47,145,95,0,0
599,12/05/2021,3,2,151,140,11,71,0,0
23,10/05/2021,3,2,62,46,16,57,0,0
552,12/05/2021,3,16,168,33,135,49,0,0
181,23/05/2021,3,0,34,15,19,49,0,0
298,17/05/2021,3,2,227,78,149,49,0,0
9,17/05/2021,3,0,27,27,0,NA,NA,NA
303,19/05/2021,3,2,63,58,5,88,0,0
473,12/05/2021,3,1,49,34,15,59,0,0
786,18/05/2021,3,2,60,22,38,49,0,0
622,18/05/2021,3,1,43,43,0,NA,NA,NA
51,11/05/2021,3,2,78,58,20,74,0,0
433,12/05/2021,3,2,316,67,249,66,0,0
137,06/05/2021,3,23,123,6,117,49,0,0
572,17/05/2021,3,0,61,41,20,60,0,0
89,08/05/2021,3,3,57,7,50,49,0,0
833,09/05/2021,3,0,83,24,59,49,0,0
491,22/05/2021,3,5,174,173,1,77,0,0
649,06/05/2021,3,3,61,35,26,59,0,0
873,14/05/2021,3,3,98,15,83,49,0,0
780,17/05/2021,3,1,59,32,27,49,0,0
456,16/05/2021,3,5,85,31,54,49,0,0
657,17/05/2021,3,0,48,33,15,59,0,0
826,17/05/2021,3,2,96,85,11,57,0,0
265,01/05/2021,3,1,56,33,23,49,0,0
233,12/05/2021,3,3,64,48,16,80,0,0
193,18/05/2021,3,1,107,50,57,49,0,0
659,16/05/2021,3,1,42,13,29,49,0,0
448,20/05/2021,3,2,151,59,92,66,0,0
512,23/05/2021,3,1,61,14,47,49,0,0
907,16/05/2021,3,2,78,14,64,49,0,0
584,21/05/2021,3,0,97,96,1,107,0,0
259,24/05/2021,3,0,60,40,20,155,0,0
332,15/05/2021,3,0,40,9,31,49,0,0
412,07/05/2021,3,6,95,11,84,49,0,0
77,17/05/2021,3,0,103,91,12,57,0,0
857,20/05/2021,3,0,210,68,142,49,0,0
559,13/05/2021,3,60,125,77,48,49,0,0
818,23/05/2021,3,1,80,75,5,106,0,0
30,12/05/2021,3,1,70,47,23,72,0,0
681,17/05/2021,3,2,69,65,4,74,0,0
389,21/05/2021,3,2,124,67,57,55,0,0
345,23/05/2021,3,0,101,49,52,52,0,0
515,19/05/2021,3,6,106,56,50,52,0,0
322,16/05/2021,3,0,100,6,94,49,0,0
275,19/05/2021,3,2,115,75,40,64,0,0
274,13/05/2021,3,2,208,17,191,39,0,0
78,11/05/2021,3,0,44,37,7,85,0,0
777,17/05/2021,3,3,117,73,44,49,0,0
201,17/05/2021,3,4,134,44,90,49,0,0
723,16/05/2021,3,1,80,17,63,49,0,0
29,10/05/2021,3,0,54,0,54,NA,NA,NA
537,20/05/2021,3,3,99,93,6,89,0,0
688,15/05/2021,3,4,115,34,81,49,0,0
725,08/05/2021,3,0,17,5,12,55,0,0
463,01/05/2021,3,0,163,20,143,55,0,0
425,22/05/2021,3,11,239,65,174,100,0,0
405,11/05/2021,3,1,89,68,21,62,0,0
847,08/05/2021,3,6,191,31,160,35,0,0
331,12/05/2021,3,2,92,74,18,90,0,0
844,16/05/2021,3,0,61,2,59,55,0,0
774,18/05/2021,3,4,101,36,65,49,0,0
933,09/05/2021,3,115,32,0,32,35,0,0
682,18/05/2021,3,1,79,35,44,67,0,0
195,12/05/2021,3,1,50,16,34,57,0,0
458,19/05/2021,3,3,178,109,69,49,0,0
202,18/05/2021,3,0,76,76,0,NA,NA,NA
128,10/05/2021,3,1,20,13,7,64,0,0
394,11/05/2021,3,4,64,16,48,49,0,0
113,06/05/2021,3,1,31,16,15,49,0,0
625,08/05/2021,3,0,161,10,151,49,0,0
370,07/05/2021,3,1,39,8,31,49,0,0
397,09/05/2021,3,0,75,7,68,49,0,0
522,22/05/2021,3,5,57,50,7,89,0,0
720,06/05/2021,3,2,37,17,20,55,0,0
284,14/05/2021,3,1,25,6,19,49,0,0
705,17/05/2021,3,1,90,60,30,52,0,0
561,16/05/2021,3,1,59,8,51,49,0,0
669,18/05/2021,3,0,87,48,39,52,0,0
826,18/05/2021,3,2,96,73,23,52,0,0
391,01/05/2021,3,2,74,10,64,49,0,0
369,12/05/2021,3,5,85,45,40,60,0,0
262,18/05/2021,3,1,50,47,3,79,0,0
197,17/05/2021,3,0,118,22,96,49,0,0
46,20/05/2021,3,1,59,35,24,67,0,0
683,23/05/2021,3,1,65,21,44,49,0,0
217,17/05/2021,3,2,39,18,21,49,0,0
714,21/05/2021,3,0,59,35,24,78,0,0
184,23/05/2021,3,0,51,29,22,52,0,0
648,15/05/2021,3,0,64,13,51,49,0,0
706,07/05/2021,3,2,72,15,57,49,0,0
384,19/05/2021,3,0,101,94,7,80,0,0
385,20/05/2021,3,2,61,61,0,NA,NA,NA
668,14/05/2021,3,4,299,15,284,49,0,0
643,26/05/2021,3,2,101,73,28,57,0,0
61,12/05/2021,3,1,99,43,56,59,0,0
383,17/05/2021,3,3,82,61,21,72,0,0
709,19/05/2021,3,0,83,54,29,67,0,0
63,22/05/2021,3,7,57,44,13,67,0,0
335,18/05/2021,3,4,82,38,44,60,0,0
472,16/05/2021,3,7,227,17,210,66,0,0
127,18/05/2021,3,1,59,44,15,82,0,0
429,12/05/2021,3,3,122,24,98,49,0,0
807,12/05/2021,3,3,97,42,55,59,0,0
785,17/05/2021,3,2,108,67,41,49,0,0
445,17/05/2021,3,2,167,51,116,49,0,0
460,14/05/2021,3,7,102,26,76,49,0,0
29,09/05/2021,3,0,54,0,54,NA,NA,NA
858,21/05/2021,3,0,81,81,0,NA,NA,NA
899,13/05/2021,3,5,100,29,71,49,0,0
208,08/05/2021,3,0,60,7,53,49,0,0
877,02/05/2021,3,0,158,22,136,35,0,0
694,24/05/2021,3,4,105,44,61,49,0,0
336,12/05/2021,3,1,73,43,30,59,0,0
23,06/05/2021,3,3,61,27,34,49,0,0
645,13/05/2021,3,2,39,22,17,60,0,0
814,16/05/2021,3,1,67,10,57,49,0,0
798,17/05/2021,3,1,80,78,2,95,0,0
933,08/05/2021,3,114,33,0,33,35,0,0
8,21/05/2021,3,1,39,24,15,58,0,0
802,11/05/2021,3,2,63,44,19,72,0,0
786,19/05/2021,3,2,60,36,24,49,0,0
782,18/05/2021,3,0,20,20,0,NA,NA,NA
600,10/05/2021,3,1,49,36,13,67,0,0
142,11/05/2021,3,1,61,60,1,161,0,0
113,09/05/2021,3,1,31,3,28,49,0,0
87,06/05/2021,3,2,116,21,95,49,0,0
122,07/05/2021,3,7,114,28,86,49,0,0
851,10/05/2021,3,0,92,6,86,49,0,0
790,22/05/2021,3,1,98,70,28,105,0,0
649,02/05/2021,3,2,62,14,48,49,0,0
118,13/05/2021,3,2,57,28,29,49,0,0
780,19/05/2021,3,1,59,39,20,57,0,0
547,14/05/2021,3,0,74,23,51,49,0,0
560,19/05/2021,3,0,80,67,13,115,0,0
221,17/05/2021,3,1,61,29,32,55,0,0
660,01/05/2021,3,6,180,20,160,49,0,0
685,12/05/2021,3,5,135,74,61,59,0,0
451,17/05/2021,3,2,81,78,3,78,0,0
295,18/05/2021,3,3,102,22,80,49,0,0
444,20/05/2021,3,4,115,71,44,49,0,0
597,24/05/2021,3,4,97,44,53,49,0,0
500,17/05/2021,3,5,74,32,42,49,0,0
404,22/05/2021,3,0,67,60,7,144,0,0
689,24/05/2021,3,0,130,100,30,63,0,0
153,14/05/2021,3,1,63,15,48,49,0,0
102,05/05/2021,3,0,60,17,43,55,0,0
75,20/05/2021,3,0,81,63,18,52,0,0
385,13/05/2021,3,2,61,11,50,59,0,0
821,13/05/2021,3,1,78,58,20,64,0,0
791,26/05/2021,3,37,91,66,25,57,0,0
30,13/05/2021,3,1,70,39,31,64,0,0
918,16/05/2021,3,0,201,27,174,39,0,0
176,20/05/2021,3,0,100,33,67,49,0,0
63,20/05/2021,3,7,57,41,16,57,0,0
515,18/05/2021,3,5,107,63,44,49,0,0
218,15/05/2021,3,3,75,24,51,49,0,0
612,18/05/2021,3,1,41,25,16,60,0,0
232,13/05/2021,3,3,62,40,22,55,0,0
807,13/05/2021,3,3,97,44,53,55,0,0
380,16/05/2021,3,1,159,31,128,49,0,0
494,17/05/2021,3,2,137,66,71,49,0,0
815,15/05/2021,3,12,117,40,77,49,0,0
549,13/05/2021,3,0,61,0,61,NA,NA,NA
889,16/05/2021,3,1,123,10,113,45,0,0
83,14/05/2021,3,45,123,49,74,49,0,0
225,07/05/2021,3,11,69,3,66,49,0,0
877,03/05/2021,3,0,158,34,124,35,0,0
661,24/05/2021,3,4,168,52,116,49,0,0
395,09/05/2021,3,1,71,9,62,49,0,0
23,07/05/2021,3,2,62,18,44,49,0,0
773,13/05/2021,3,1,73,42,31,59,0,0
301,17/05/2021,3,1,100,25,75,49,0,0
585,16/05/2021,3,2,58,37,21,52,0,0
68,07/05/2021,3,0,116,2,114,49,0,0
8,22/05/2021,3,1,39,37,2,85,0,0
161,12/05/2021,3,0,61,22,39,55,0,0
458,20/05/2021,3,3,178,126,52,49,0,0
622,17/05/2021,3,1,43,37,6,74,0,0
138,11/05/2021,3,3,95,50,45,55,0,0
173,12/05/2021,3,1,70,53,17,74,0,0
538,09/05/2021,3,1,43,5,38,49,0,0
205,06/05/2021,3,1,125,25,100,49,0,0
615,08/05/2021,3,0,71,16,55,49,0,0
768,09/05/2021,3,2,85,16,69,49,0,0
401,21/05/2021,3,0,79,61,18,67,0,0
297,03/05/2021,3,2,74,19,55,49,0,0
539,13/05/2021,3,2,95,19,76,49,0,0
70,20/05/2021,3,1,38,31,7,63,0,0
27,16/05/2021,3,0,78,39,39,49,0,0
669,19/05/2021,3,0,87,54,33,52,0,0
242,20/05/2021,3,5,133,102,31,57,0,0
514,02/05/2021,3,6,228,28,200,49,0,0
731,12/05/2021,3,4,95,62,33,62,0,0
848,17/05/2021,3,5,133,24,109,35,0,0
372,17/05/2021,3,17,75,68,7,72,0,0
119,20/05/2021,3,2,66,41,25,49,0,0
269,24/05/2021,3,1,79,29,50,49,0,0
907,17/05/2021,3,3,77,52,25,49,0,0
728,21/05/2021,3,0,47,36,11,67,0,0
190,23/05/2021,3,6,74,40,34,49,0,0
287,14/05/2021,3,1,122,59,63,49,0,0
582,05/05/2021,3,0,53,18,35,55,0,0
215,17/05/2021,3,0,46,34,12,59,0,0
750,14/05/2021,3,79,33,31,2,77,0,0
530,13/05/2021,3,1,59,48,11,57,0,0
757,24/05/2021,3,0,117,103,14,95,0,0
124,11/05/2021,3,1,53,31,22,55,0,0
60,17/05/2021,3,0,57,31,26,59,0,0
314,21/05/2021,3,1,68,40,28,55,0,0
26,23/05/2021,3,2,64,10,54,49,0,0
65,19/05/2021,3,1,77,45,32,49,0,0
509,15/05/2021,3,1,111,18,93,49,0,0
742,19/05/2021,3,1,73,45,28,57,0,0
366,12/05/2021,3,0,80,72,8,85,0,0
210,13/05/2021,3,2,100,78,22,62,0,0
570,16/05/2021,3,0,149,13,136,49,0,0
741,17/05/2021,3,0,70,28,42,49,0,0
172,16/05/2021,3,2,83,20,63,49,0,0
549,14/05/2021,3,0,61,0,61,NA,NA,NA
702,15/05/2021,3,1,49,14,35,49,0,0
688,14/05/2021,3,4,115,20,95,49,0,0
827,09/05/2021,3,1,69,26,43,49,0,0
453,01/05/2021,3,0,138,19,119,55,0,0
24,25/05/2021,3,0,84,76,8,74,0,0
468,11/05/2021,3,1,95,35,60,49,0,0
23,09/05/2021,3,2,62,30,32,49,0,0
645,12/05/2021,3,3,38,26,12,59,0,0
856,16/05/2021,3,1,119,4,115,49,0,0
105,17/05/2021,3,3,72,64,8,72,0,0
68,09/05/2021,3,0,116,2,114,49,0,0
268,18/05/2021,3,1,77,66,11,82,0,0
195,10/05/2021,3,1,50,17,33,52,0,0
735,20/05/2021,3,0,29,21,8,49,0,0
139,18/05/2021,3,2,57,28,29,52,0,0
875,12/05/2021,3,1,91,67,24,64,0,0
209,11/05/2021,3,1,113,44,69,55,0,0
137,07/05/2021,3,24,122,11,111,49,0,0
737,06/05/2021,3,2,40,11,29,49,0,0
710,08/05/2021,3,0,20,2,18,49,0,0
348,09/05/2021,3,51,89,34,55,49,0,0
446,21/05/2021,3,7,126,69,57,49,0,0
871,05/05/2021,3,3,75,39,36,49,0,0
258,14/05/2021,3,2,141,16,125,49,0,0
170,20/05/2021,3,1,104,81,23,57,0,0
168,16/05/2021,3,0,48,15,33,49,0,0
498,17/05/2021,3,0,87,37,50,49,0,0
826,20/05/2021,3,2,96,88,8,63,0,0
660,02/05/2021,3,6,180,21,159,49,0,0
369,13/05/2021,3,4,86,46,40,55,0,0
106,18/05/2021,3,1,30,22,8,67,0,0
665,17/05/2021,3,0,106,47,59,55,0,0
652,19/05/2021,3,0,69,61,8,80,0,0
251,24/05/2021,3,4,120,55,65,49,0,0
293,17/05/2021,3,1,59,34,25,49,0,0
714,22/05/2021,3,0,59,39,20,95,0,0
778,23/05/2021,3,2,79,69,10,90,0,0
864,16/05/2021,3,1,84,15,69,49,0,0
543,05/05/2021,3,1,64,22,42,55,0,0
619,17/05/2021,3,0,101,51,50,55,0,0
84,14/05/2021,3,0,20,11,9,55,0,0
407,13/05/2021,3,1,40,6,34,49,0,0
757,25/05/2021,3,0,117,108,9,110,0,0
124,12/05/2021,3,1,53,27,26,55,0,0
632,17/05/2021,3,0,82,29,53,55,0,0
434,19/05/2021,3,2,58,25,33,49,0,0
576,20/05/2021,3,1,57,42,15,57,0,0
676,18/05/2021,3,3,112,68,44,57,0,0
715,15/05/2021,3,5,83,24,59,49,0,0
861,11/05/2021,3,0,61,45,16,64,0,0
177,13/05/2021,3,0,48,16,32,59,0,0
338,12/05/2021,3,3,397,103,294,49,0,0
777,16/05/2021,3,3,117,20,97,49,0,0
156,16/05/2021,3,3,145,22,123,49,0,0
815,16/05/2021,3,12,117,41,76,49,0,0
733,14/05/2021,3,0,100,5,95,49,0,0
175,15/05/2021,3,1,119,7,112,49,0,0
272,13/05/2021,3,1,126,48,78,49,0,0
827,07/05/2021,3,1,69,38,31,55,0,0
463,05/05/2021,3,0,163,33,130,55,0,0
578,22/05/2021,3,0,58,41,17,60,0,0
605,11/05/2021,3,1,159,49,110,49,0,0
801,09/05/2021,3,7,160,18,142,49,0,0
116,11/05/2021,3,0,61,44,17,59,0,0
55,16/05/2021,3,1,32,5,27,49,0,0
798,16/05/2021,3,1,80,44,36,49,0,0
68,06/05/2021,3,0,116,5,111,49,0,0
800,18/05/2021,3,2,55,27,28,49,0,0
161,11/05/2021,3,0,61,15,46,55,0,0
237,20/05/2021,3,5,116,34,82,49,0,0
813,18/05/2021,3,1,129,124,5,85,0,0
427,12/05/2021,3,5,305,4,301,66,0,0
390,11/05/2021,3,3,133,41,92,49,0,0
373,07/05/2021,3,2,101,8,93,49,0,0
246,07/05/2021,3,3,109,19,90,49,0,0
710,06/05/2021,3,0,20,7,13,55,0,0
540,10/05/2021,3,2,80,34,46,49,0,0
666,21/05/2021,3,2,64,56,8,74,0,0
315,04/05/2021,3,0,62,37,25,60,0,0
49,13/05/2021,3,2,146,26,120,49,0,0
409,20/05/2021,3,1,106,72,34,57,0,0
229,15/05/2021,3,5,51,22,29,49,0,0
226,18/05/2021,3,0,47,45,2,90,0,0
759,19/05/2021,3,3,84,57,27,52,0,0
391,03/05/2021,3,2,74,10,64,49,0,0
685,13/05/2021,3,4,136,76,60,55,0,0
917,09/05/2021,3,2,104,1,103,35,0,0
270,17/05/2021,3,1,59,36,23,59,0,0
555,20/05/2021,3,0,117,78,39,55,0,0
474,25/05/2021,3,0,112,48,64,49,0,0
356,18/05/2021,3,2,134,104,30,67,0,0
598,22/05/2021,3,0,146,141,5,144,0,0
131,24/05/2021,3,3,46,23,23,57,0,0
607,16/05/2021,3,1,74,11,63,49,0,0
743,05/05/2021,3,1,125,37,88,55,0,0
619,19/05/2021,3,0,101,50,51,59,0,0
285,14/05/2021,3,0,80,14,66,49,0,0
668,13/05/2021,3,0,303,18,285,49,0,0
441,26/05/2021,3,0,168,54,114,80,0,0
124,13/05/2021,3,1,53,24,29,55,0,0
658,17/05/2021,3,0,81,57,24,67,0,0
709,21/05/2021,3,0,83,70,13,87,0,0
146,21/05/2021,3,1,40,35,5,88,0,0
779,19/05/2021,3,0,104,54,50,55,0,0
764,15/05/2021,3,2,67,14,53,49,0,0
742,11/05/2021,3,1,73,45,28,52,0,0
854,13/05/2021,3,0,110,13,97,55,0,0
411,12/05/2021,3,0,185,26,159,49,0,0
187,17/05/2021,3,2,39,12,27,49,0,0
653,17/05/2021,3,2,113,40,73,49,0,0
64,14/05/2021,3,3,244,3,241,49,0,0
859,13/05/2021,3,1,84,16,68,49,0,0
889,15/05/2021,3,1,123,5,118,45,0,0
535,13/05/2021,3,1,82,28,54,49,0,0
363,07/05/2021,3,4,95,84,11,72,0,0
140,06/05/2021,3,0,170,91,79,49,0,0
580,24/05/2021,3,0,98,84,14,62,0,0
605,12/05/2021,3,1,159,47,112,49,0,0
849,11/05/2021,3,1,83,42,41,49,0,0
388,12/05/2021,3,1,59,38,21,67,0,0
698,16/05/2021,3,2,114,16,98,49,0,0
497,17/05/2021,3,4,189,80,109,49,0,0
68,08/05/2021,3,0,116,3,113,49,0,0
22,23/05/2021,3,0,64,24,40,49,0,0
244,11/05/2021,3,0,200,54,146,49,0,0
478,19/05/2021,3,0,20,19,1,90,0,0
72,18/05/2021,3,2,58,37,21,60,0,0
321,12/05/2021,3,1,39,9,30,49,0,0
739,12/05/2021,3,2,73,25,48,49,0,0
373,08/05/2021,3,2,101,7,94,49,0,0
87,08/05/2021,3,2,116,8,108,49,0,0
710,07/05/2021,3,0,20,3,17,49,0,0
898,10/05/2021,3,1,99,38,61,49,0,0
182,22/05/2021,3,2,78,58,20,60,0,0
747,03/05/2021,3,0,64,20,44,59,0,0
230,13/05/2021,3,0,80,13,67,49,0,0
638,20/05/2021,3,1,100,69,31,72,0,0
673,16/05/2021,3,0,123,23,100,49,0,0
657,18/05/2021,3,0,48,33,15,64,0,0
154,19/05/2021,3,4,100,69,31,52,0,0
514,03/05/2021,3,6,228,24,204,49,0,0
731,13/05/2021,3,4,95,64,31,52,0,0
865,09/05/2021,3,1,84,2,82,49,0,0
627,17/05/2021,3,0,41,19,22,59,0,0
792,20/05/2021,3,0,102,76,26,52,0,0
253,24/05/2021,3,1,57,38,19,60,0,0
43,18/05/2021,3,2,71,54,17,85,0,0
686,22/05/2021,3,0,46,42,4,77,0,0
190,24/05/2021,3,6,74,50,24,57,0,0
198,14/05/2021,3,1,134,24,110,49,0,0
743,06/05/2021,3,1,125,35,90,55,0,0
556,17/05/2021,3,0,117,64,53,49,0,0
432,14/05/2021,3,0,165,4,161,66,0,0
476,12/05/2021,3,1,172,23,149,49,0,0
732,25/05/2021,3,0,60,33,27,57,0,0
604,06/05/2021,3,0,82,20,62,49,0,0
60,15/05/2021,3,0,57,29,28,49,0,0
121,11/05/2021,3,0,110,106,4,90,0,0
513,21/05/2021,3,1,76,49,27,55,0,0
676,19/05/2021,3,4,111,81,30,57,0,0
58,14/05/2021,3,1,66,36,30,49,0,0
127,12/05/2021,3,1,59,18,41,59,0,0
392,12/05/2021,3,0,176,53,123,49,0,0
338,13/05/2021,3,3,397,113,284,49,0,0
305,17/05/2021,3,12,47,28,19,49,0,0
445,16/05/2021,3,1,168,11,157,49,0,0
64,15/05/2021,3,3,244,1,243,49,0,0
340,14/05/2021,3,17,117,6,111,49,0,0
586,15/05/2021,3,3,80,60,20,64,0,0
272,15/05/2021,3,1,126,19,107,49,0,0
725,09/05/2021,3,0,17,9,8,55,0,0
655,06/05/2021,3,0,72,38,34,49,0,0
578,23/05/2021,3,0,58,24,34,49,0,0
36,12/05/2021,3,1,62,21,41,49,0,0
23,11/05/2021,3,2,62,43,19,52,0,0
351,12/05/2021,3,1,65,30,35,67,0,0
724,17/05/2021,3,2,84,84,0,NA,NA,NA
646,17/05/2021,3,17,119,60,59,49,0,0
344,06/05/2021,3,0,65,25,40,49,0,0
546,23/05/2021,3,8,144,51,93,49,0,0
37,02/05/2021,3,4,77,5,72,49,0,0
565,18/05/2021,3,0,62,48,14,93,0,0
204,17/05/2021,3,0,64,7,57,49,0,0
138,10/05/2021,3,4,94,41,53,49,0,0
467,10/05/2021,3,3,109,2,107,55,0,0
538,06/05/2021,3,1,43,12,31,49,0,0
737,08/05/2021,3,2,40,2,38,49,0,0
615,09/05/2021,3,0,71,8,63,49,0,0
833,10/05/2021,3,0,83,33,50,49,0,0
296,22/05/2021,3,3,57,20,37,55,0,0
747,04/05/2021,3,0,64,51,13,59,0,0
284,13/05/2021,3,1,25,12,13,57,0,0
170,18/05/2021,3,1,104,85,19,74,0,0
811,16/05/2021,3,3,87,43,44,49,0,0
657,19/05/2021,3,0,48,44,4,85,0,0
242,19/05/2021,3,4,134,89,45,52,0,0
660,03/05/2021,3,6,180,23,157,49,0,0
624,12/05/2021,3,2,77,31,46,49,0,0
193,11/05/2021,3,1,107,30,77,49,0,0
35,16/05/2021,3,0,110,16,94,49,0,0
145,20/05/2021,3,3,55,32,23,55,0,0
350,24/05/2021,3,2,58,47,11,62,0,0
360,17/05/2021,3,1,43,12,31,55,0,0
352,21/05/2021,3,0,64,42,22,60,0,0
593,24/05/2021,3,25,56,46,10,168,0,0
589,14/05/2021,3,5,138,17,121,49,0,0
102,06/05/2021,3,0,60,14,46,55,0,0
75,19/05/2021,3,0,81,49,32,49,0,0
432,13/05/2021,3,0,165,2,163,66,0,0
668,12/05/2021,3,0,303,10,293,49,0,0
732,24/05/2021,3,0,60,47,13,52,0,0
850,06/05/2021,3,4,79,28,51,49,0,0
418,15/05/2021,3,0,116,9,107,49,0,0
32,11/05/2021,3,1,104,104,0,NA,NA,NA
148,22/05/2021,3,0,25,24,1,74,0,0
282,19/05/2021,3,28,673,67,606,49,0,0
509,14/05/2021,3,1,111,23,88,49,0,0
691,12/05/2021,3,1,31,18,13,82,0,0
623,12/05/2021,3,0,78,17,61,49,0,0
330,13/05/2021,3,2,117,38,79,49,0,0
276,16/05/2021,3,1,203,48,155,49,0,0
653,16/05/2021,3,2,113,13,100,49,0,0
64,16/05/2021,3,3,244,7,237,49,0,0
610,14/05/2021,3,1,66,10,56,49,0,0
883,15/05/2021,3,6,98,25,73,45,0,0
248,13/05/2021,3,0,82,40,42,55,0,0
827,08/05/2021,3,1,69,68,1,80,0,0
663,06/05/2021,3,0,148,25,123,49,0,0
421,23/05/2021,3,0,19,19,0,NA,NA,NA
283,09/05/2021,3,0,76,10,66,49,0,0
379,11/05/2021,3,3,284,102,182,66,0,0
81,11/05/2021,3,1,59,15,44,49,0,0
814,17/05/2021,3,1,67,67,0,NA,NA,NA
774,17/05/2021,3,4,101,23,78,49,0,0
9,09/05/2021,3,0,27,9,18,49,0,0
761,23/05/2021,3,2,81,28,53,49,0,0
161,01/05/2021,3,1,60,15,45,49,0,0
279,19/05/2021,3,0,57,33,24,67,0,0
754,18/05/2021,3,0,62,20,42,49,0,0
836,10/05/2021,3,3,98,39,59,49,0,0
467,11/05/2021,3,3,109,4,105,55,0,0
575,07/05/2021,3,1,49,6,43,49,0,0
374,06/05/2021,3,0,56,22,34,49,0,0
615,06/05/2021,3,0,71,27,44,49,0,0
833,11/05/2021,3,0,83,45,38,49,0,0
296,21/05/2021,3,1,59,14,45,55,0,0
649,03/05/2021,3,3,61,13,48,59,0,0
364,14/05/2021,3,3,127,92,35,59,0,0
170,19/05/2021,3,1,104,70,34,67,0,0
149,16/05/2021,3,0,88,17,71,49,0,0
498,18/05/2021,3,0,87,41,46,49,0,0
765,19/05/2021,3,1,100,72,28,72,0,0
265,04/05/2021,3,1,56,12,44,49,0,0
748,12/05/2021,3,4,140,56,84,49,0,0
617,11/05/2021,3,1,43,26,17,72,0,0
639,16/05/2021,3,0,59,6,53,49,0,0
442,19/05/2021,3,8,150,52,98,49,0,0
399,25/05/2021,3,6,55,50,5,85,0,0
846,16/05/2021,3,1,188,21,167,45,0,0
439,21/05/2021,3,4,87,65,22,49,0,0
420,23/05/2021,3,1,68,49,19,94,0,0
17,15/05/2021,3,1,93,18,75,49,0,0
582,06/05/2021,3,0,53,15,38,55,0,0
215,19/05/2021,3,0,46,37,9,72,0,0
805,14/05/2021,3,2,111,29,82,49,0,0
38,12/05/2021,3,1,49,35,14,57,0,0
441,25/05/2021,3,0,168,38,130,80,0,0
604,07/05/2021,3,0,82,14,68,49,0,0
658,15/05/2021,3,0,81,43,38,49,0,0
314,11/05/2021,3,1,68,68,0,NA,NA,NA
810,23/05/2021,3,0,389,26,363,60,0,0
867,18/05/2021,3,1,59,59,0,NA,NA,NA
509,16/05/2021,3,1,111,20,91,49,0,0
612,12/05/2021,3,2,40,8,32,55,0,0
588,12/05/2021,3,0,59,55,4,72,0,57
902,13/05/2021,3,2,124,55,69,49,0,0
276,17/05/2021,3,1,203,75,128,49,0,0
828,16/05/2021,3,1,74,16,58,49,0,0
868,16/05/2021,3,4,79,4,75,49,0,0
870,14/05/2021,3,5,41,22,19,49,0,0
477,15/05/2021,3,4,116,8,108,49,0,0
104,13/05/2021,3,1,61,48,13,80,0,0
363,08/05/2021,3,4,95,94,1,80,0,0
877,05/05/2021,3,0,158,43,115,35,0,0
421,07/05/2021,3,0,19,15,4,72,0,0
283,11/05/2021,3,0,76,33,43,59,0,0
470,06/05/2021,3,1,79,76,3,59,0,0
81,14/05/2021,3,1,59,4,55,49,0,0
724,16/05/2021,3,3,83,53,30,52,0,0
196,18/05/2021,3,0,138,22,116,49,0,0
542,08/05/2021,3,4,71,29,42,49,0,0
800,23/05/2021,3,2,55,17,38,49,0,0
802,01/05/2021,3,1,64,34,30,49,0,0
565,20/05/2021,3,0,62,49,13,80,0,0
760,17/05/2021,3,3,33,15,18,49,0,0
684,11/05/2021,3,2,96,22,74,49,0,0
529,10/05/2021,3,3,38,15,23,49,0,0
551,08/05/2021,3,1,114,6,108,49,0,0
631,06/05/2021,3,2,69,35,34,59,0,0
89,07/05/2021,3,3,57,8,49,49,0,0
768,12/05/2021,3,1,86,27,59,49,0,0
239,21/05/2021,3,0,40,22,18,60,0,0
649,04/05/2021,3,3,61,41,20,59,0,0
258,13/05/2021,3,1,142,51,91,55,0,0
70,19/05/2021,3,1,38,36,2,77,0,0
746,16/05/2021,3,2,58,18,40,49,0,0
4,08/05/2021,3,1,63,62,1,90,0,0
826,19/05/2021,3,2,96,71,25,57,0,0
391,04/05/2021,3,2,74,28,46,49,0,0
583,13/05/2021,3,1,80,44,36,49,0,0
917,11/05/2021,3,2,104,13,91,35,0,0
35,17/05/2021,3,0,110,50,60,49,0,0
231,20/05/2021,3,0,41,29,12,62,0,0
393,24/05/2021,3,1,59,40,19,57,0,0
783,17/05/2021,3,3,77,51,26,64,0,0
832,21/05/2021,3,2,98,43,55,55,0,0
151,24/05/2021,3,6,70,63,7,80,0,0
589,15/05/2021,3,5,138,29,109,49,0,0
341,05/05/2021,3,2,112,85,27,60,0,0
556,18/05/2021,3,0,117,81,36,52,0,0
385,14/05/2021,3,2,61,9,52,49,0,0
290,12/05/2021,3,3,104,52,52,55,0,0
830,26/05/2021,3,0,66,39,27,156,0,0
144,05/05/2021,3,1,98,21,77,49,0,0
418,16/05/2021,3,0,116,11,105,49,0,0
257,11/05/2021,3,1,43,36,7,94,0,0
317,21/05/2021,3,0,80,58,22,91,0,0
779,15/05/2021,3,0,104,14,90,49,0,0
715,16/05/2021,3,5,83,33,50,49,0,0
52,11/05/2021,3,3,139,89,50,72,0,0
854,12/05/2021,3,0,110,14,96,55,0,0
117,01/05/2021,3,0,94,94,0,NA,NA,NA
28,16/05/2021,3,2,126,48,78,49,0,0
414,17/05/2021,3,21,165,80,85,49,0,0
88,14/05/2021,3,1,41,9,32,49,0,0
340,15/05/2021,3,17,117,7,110,49,0,0
613,15/05/2021,3,0,56,14,42,49,0,0
934,05/05/2021,3,66,33,9,24,35,0,0
725,07/05/2021,3,0,17,4,13,55,0,0
877,06/05/2021,3,0,158,34,124,35,0,0
421,11/05/2021,3,0,19,18,1,85,0,0
599,10/05/2021,3,2,151,151,0,NA,NA,NA
470,07/05/2021,3,1,79,58,21,57,0,0
645,14/05/2021,3,2,39,13,26,49,0,0
891,16/05/2021,3,2,80,31,49,49,0,0
123,07/05/2021,3,1,94,1,93,49,0,0
542,06/05/2021,3,4,71,47,24,52,0,0
303,04/05/2021,3,1,64,42,22,72,0,0
95,02/05/2021,3,1,87,21,66,49,0,0
628,19/05/2021,3,4,55,39,16,72,0,0
92,17/05/2021,3,1,121,55,66,49,0,0
417,11/05/2021,3,0,103,40,63,49,0,0
862,12/05/2021,3,3,107,42,65,49,0,0
563,08/05/2021,3,1,69,8,61,49,0,0
91,06/05/2021,3,1,79,27,52,49,0,0
753,07/05/2021,3,2,125,7,118,49,0,0
898,13/05/2021,3,1,99,41,58,49,0,0
491,21/05/2021,3,5,174,142,32,60,0,0
720,03/05/2021,3,0,39,15,24,55,0,0
49,14/05/2021,3,2,146,19,127,49,0,0
705,18/05/2021,3,1,90,51,39,49,0,0
713,14/05/2021,3,1,60,59,1,82,0,0
226,06/05/2021,3,0,47,27,20,55,0,0
18,18/05/2021,3,2,90,70,20,77,0,0
514,05/05/2021,3,6,228,21,207,49,0,0
511,13/05/2021,3,2,74,38,36,49,0,0
451,11/05/2021,3,2,81,42,39,66,0,0
919,17/05/2021,3,0,123,53,70,49,0,0
448,19/05/2021,3,3,150,71,79,66,0,0
247,24/05/2021,3,4,89,45,44,55,0,0
907,18/05/2021,3,3,77,57,20,60,0,0
832,22/05/2021,3,2,98,63,35,60,0,0
778,25/05/2021,3,2,79,78,1,147,0,0
776,15/05/2021,3,0,104,23,81,49,0,0
134,06/05/2021,3,1,47,29,18,52,0,0
619,20/05/2021,3,0,101,65,36,55,0,0
857,13/05/2021,3,2,208,26,182,49,0,0
476,14/05/2021,3,1,172,13,159,49,0,0
486,24/05/2021,3,0,124,32,92,49,0,0
30,07/05/2021,3,1,70,32,38,49,0,0
534,16/05/2021,3,0,85,13,72,49,0,0
257,12/05/2021,3,1,43,35,8,90,0,0
317,20/05/2021,3,0,80,66,14,85,0,0
65,15/05/2021,3,1,77,7,70,49,0,0
472,15/05/2021,3,1,233,12,221,66,0,0
222,12/05/2021,3,1,76,19,57,49,0,0
274,12/05/2021,3,2,208,23,185,39,0,0
807,03/05/2021,3,3,97,13,84,55,0,0
785,16/05/2021,3,2,108,31,77,49,0,0
641,17/05/2021,3,0,160,15,145,49,0,0
101,14/05/2021,3,1,59,26,33,49,0,0
601,15/05/2021,3,3,65,31,34,49,0,0
69,16/05/2021,3,1,59,11,48,49,0,0
264,06/05/2021,3,1,59,28,31,55,0,0
363,09/05/2021,3,4,95,60,35,59,0,0
463,03/05/2021,3,0,163,10,153,55,0,0
461,11/05/2021,3,0,122,10,112,66,0,0
13,12/05/2021,3,3,78,63,15,95,0,0
819,11/05/2021,3,1,79,71,8,72,0,0
291,04/05/2021,3,1,60,30,30,49,0,0
329,17/05/2021,3,10,97,37,60,49,0,0
125,07/05/2021,3,2,34,11,23,49,0,0
135,07/05/2021,3,4,62,42,20,115,0,0
303,03/05/2021,3,1,64,33,31,59,0,0
161,02/05/2021,3,1,60,14,46,49,0,0
788,20/05/2021,3,2,89,82,7,62,0,0
292,18/05/2021,3,2,237,36,201,49,0,0
417,10/05/2021,3,0,103,49,54,49,0,0
167,12/05/2021,3,0,84,72,12,85,0,0
575,08/05/2021,3,1,49,8,41,49,0,0
246,06/05/2021,3,3,109,25,84,49,0,0
852,07/05/2021,3,1,79,32,47,49,0,0
312,10/05/2021,3,2,95,32,63,49,0,0
416,22/05/2021,3,0,34,31,3,74,0,0
548,04/05/2021,3,0,91,44,47,55,0,0
118,07/05/2021,3,5,54,18,36,49,0,0
705,19/05/2021,3,1,90,39,51,49,0,0
229,14/05/2021,3,1,55,23,32,49,0,0
498,07/05/2021,3,0,87,16,71,49,0,0
18,19/05/2021,3,2,90,65,25,74,0,0
660,05/05/2021,3,6,180,33,147,49,0,0
748,13/05/2021,3,4,140,62,78,49,0,0
848,09/05/2021,3,6,132,9,123,35,0,0
35,18/05/2021,3,0,110,44,66,49,0,0
904,20/05/2021,3,5,269,12,257,66,0,0
393,23/05/2021,3,1,59,29,30,49,0,0
465,16/05/2021,3,14,253,48,205,49,0,0
838,22/05/2021,3,3,62,55,7,106,0,0
342,24/05/2021,3,0,114,41,73,49,0,0
42,16/05/2021,3,3,96,14,82,49,0,0
134,07/05/2021,3,1,47,32,15,52,0,0
75,17/05/2021,3,0,81,30,51,49,0,0
294,14/05/2021,3,1,116,92,24,52,0,0
821,12/05/2021,3,1,78,68,10,80,0,0
339,24/05/2021,3,15,579,63,516,49,0,0
144,07/05/2021,3,1,98,33,65,49,0,0
418,17/05/2021,3,0,116,25,91,49,0,0
314,12/05/2021,3,1,68,38,30,60,0,0
317,22/05/2021,3,0,80,73,7,133,0,0
254,15/05/2021,3,1,77,7,70,49,0,0
603,14/05/2021,3,1,83,20,63,49,0,0
691,11/05/2021,3,1,31,23,8,72,0,0
120,12/05/2021,3,2,152,76,76,59,0,0
212,02/05/2021,3,2,76,64,12,80,0,0
238,17/05/2021,3,1,65,32,33,55,0,0
201,16/05/2021,3,4,134,7,127,49,0,0
738,14/05/2021,3,1,123,19,104,49,0,0
355,13/05/2021,3,3,96,36,60,55,0,0
93,15/05/2021,3,3,138,28,110,49,0,0
535,05/05/2021,3,1,82,28,54,49,0,0
483,07/05/2021,3,3,96,14,82,49,0,0
655,01/05/2021,3,0,72,10,62,49,0,0
651,07/05/2021,3,1,77,9,68,49,0,0
13,10/05/2021,3,3,78,57,21,62,0,0
573,06/05/2021,3,0,57,27,30,49,0,0
331,01/05/2021,3,22,72,43,29,49,0,0
329,16/05/2021,3,9,98,7,91,49,0,0
774,08/05/2021,3,7,98,17,81,49,0,0
616,06/05/2021,3,1,74,29,45,49,0,0
22,05/05/2021,3,0,64,52,12,72,0,0
195,02/05/2021,3,1,50,5,45,49,0,0
237,19/05/2021,3,5,116,30,86,49,0,0
422,18/05/2021,3,1,78,45,33,49,0,0
252,11/05/2021,3,3,261,86,175,49,0,0
173,11/05/2021,3,1,70,45,25,60,0,0
575,09/05/2021,3,1,49,5,44,49,0,0
435,06/05/2021,3,67,53,27,26,49,0,0
71,08/05/2021,3,2,60,4,56,49,0,0
249,11/05/2021,3,2,125,98,27,49,0,0
66,22/05/2021,3,0,152,113,39,60,0,0
297,04/05/2021,3,3,73,35,38,55,0,0
284,06/05/2021,3,1,25,8,17,49,0,0
866,18/05/2021,3,0,100,38,62,55,0,0
149,15/05/2021,3,0,88,14,74,49,0,0
657,07/05/2021,3,0,48,13,35,49,0,0
18,20/05/2021,3,3,89,66,23,57,0,0
265,06/05/2021,3,1,56,14,42,49,0,0
487,12/05/2021,3,4,35,14,21,49,0,0
106,09/05/2021,3,1,30,11,19,49,0,0
919,18/05/2021,3,1,122,72,50,49,0,0
608,19/05/2021,3,9,131,56,75,49,0,0
474,24/05/2021,3,0,112,49,63,49,0,0
566,16/05/2021,3,1,74,15,59,49,0,0
362,21/05/2021,3,5,115,71,44,98,0,0
342,23/05/2021,3,0,114,26,88,49,0,0
287,15/05/2021,3,1,122,87,35,52,0,0
341,06/05/2021,3,2,112,75,37,55,0,0
544,20/05/2021,3,0,53,21,32,49,0,0
84,13/05/2021,3,0,20,14,6,90,0,0
107,13/05/2021,3,29,60,46,14,80,0,0
490,24/05/2021,3,5,160,16,144,49,0,0
144,08/05/2021,3,1,98,26,72,49,0,0
918,17/05/2021,3,0,201,54,147,39,0,0
277,12/05/2021,3,4,68,33,35,76,0,0
810,22/05/2021,3,0,389,56,333,90,0,0
335,14/05/2021,3,4,82,6,76,49,0,0
403,15/05/2021,3,2,96,16,80,49,0,0
426,11/05/2021,3,6,157,72,85,55,0,0
860,12/05/2021,3,12,80,35,45,49,0,0
304,01/05/2021,3,5,55,6,49,49,0,0
187,16/05/2021,3,1,40,9,31,49,0,0
494,16/05/2021,3,2,137,23,114,49,0,0
723,14/05/2021,3,1,80,19,61,49,0,0
97,13/05/2021,3,8,99,53,46,59,0,0
406,16/05/2021,3,1,38,10,28,49,0,0
535,07/05/2021,3,1,82,5,77,49,0,0
483,09/05/2021,3,3,96,16,80,49,0,0
457,02/05/2021,3,0,63,13,50,49,0,0
578,08/05/2021,3,1,57,8,49,49,0,0
336,11/05/2021,3,2,72,67,5,90,0,0
801,07/05/2021,3,7,160,16,144,49,0,0
116,02/05/2021,3,0,61,25,36,49,0,0
508,16/05/2021,3,22,58,10,48,49,0,0
125,08/05/2021,3,2,34,7,27,49,0,0
542,07/05/2021,3,4,71,25,46,49,0,0
303,02/05/2021,3,1,64,29,35,49,0,0
37,01/05/2021,3,1,80,23,57,49,0,0
735,18/05/2021,3,0,29,16,13,52,0,0
3,17/05/2021,3,8,105,55,50,49,0,0
213,12/05/2021,3,3,145,96,49,49,0,0
739,11/05/2021,3,2,73,25,48,52,0,0
758,08/05/2021,3,0,73,27,46,49,0,0
631,07/05/2021,3,2,69,13,56,49,0,0
852,08/05/2021,3,0,80,48,32,49,0,0
300,09/05/2021,3,0,210,67,143,49,0,0
66,21/05/2021,3,0,152,52,100,55,0,0
720,05/05/2021,3,2,37,20,17,55,0,0
284,07/05/2021,3,1,25,2,23,49,0,0
638,17/05/2021,3,0,101,72,29,64,0,0
164,16/05/2021,3,0,62,19,43,49,0,0
226,08/05/2021,3,0,47,12,35,49,0,0
488,20/05/2021,3,2,64,46,18,67,0,0
823,06/05/2021,3,1,60,26,34,49,0,0
216,13/05/2021,3,1,57,27,30,49,0,0
617,09/05/2021,3,1,43,5,38,49,0,0
85,18/05/2021,3,7,113,113,0,NA,NA,NA
591,19/05/2021,3,0,68,56,12,85,0,0
512,24/05/2021,3,1,61,25,36,49,0,0
566,17/05/2021,3,1,74,38,36,49,0,0
647,21/05/2021,3,3,90,82,8,74,0,0
365,24/05/2021,3,0,68,67,1,117,0,0
332,14/05/2021,3,0,40,8,32,49,0,0
45,05/05/2021,3,9,147,23,124,49,0,0
544,17/05/2021,3,0,53,8,45,49,0,0
750,13/05/2021,3,28,84,53,31,52,0,0
357,12/05/2021,3,1,82,58,24,60,0,0
339,25/05/2021,3,15,579,50,529,49,0,0
61,06/05/2021,3,1,99,22,77,49,0,0
534,17/05/2021,3,0,85,31,54,49,0,0
835,11/05/2021,3,5,99,83,16,80,0,0
513,20/05/2021,3,1,76,36,40,49,0,0
130,15/05/2021,3,3,78,9,69,49,0,0
603,15/05/2021,3,1,83,15,68,49,0,0
52,10/05/2021,3,25,117,97,20,52,0,0
120,13/05/2021,3,2,152,88,64,49,0,0
330,01/05/2021,3,2,117,19,98,49,0,0
238,16/05/2021,3,1,65,24,41,49,0,0
358,16/05/2021,3,1,92,12,80,49,0,0
19,15/05/2021,3,1,93,12,81,49,0,0
601,13/05/2021,3,5,63,37,26,49,0,0
69,15/05/2021,3,1,59,13,46,49,0,0
688,07/05/2021,3,4,115,26,89,49,0,0
208,09/05/2021,3,0,60,4,56,49,0,0
635,03/05/2021,3,0,88,34,54,49,0,0
517,08/05/2021,3,1,57,18,39,49,0,0
405,10/05/2021,3,1,89,58,31,52,0,0
50,06/05/2021,3,2,119,19,100,49,0,0
552,02/05/2021,3,9,175,16,159,49,0,0
301,16/05/2021,3,1,100,17,83,49,0,0
125,09/05/2021,3,2,34,7,27,49,0,0
616,07/05/2021,3,1,74,21,53,49,0,0
8,05/05/2021,3,1,39,12,27,49,0,0
59,02/05/2021,3,0,75,4,71,49,0,0
155,19/05/2021,3,0,93,80,13,77,0,0
422,17/05/2021,3,1,78,39,39,49,0,0
252,12/05/2021,3,3,261,97,164,49,0,0
12,10/05/2021,3,1,42,10,32,49,0,0
839,08/05/2021,3,4,151,45,106,49,0,0
625,07/05/2021,3,0,161,13,148,49,0,0
71,09/05/2021,3,2,60,10,50,49,0,0
670,09/05/2021,3,0,108,35,73,49,0,0
450,21/05/2021,3,3,181,132,49,49,0,0
548,05/05/2021,3,0,91,54,37,55,0,0
49,06/05/2021,3,2,146,17,129,49,0,0
711,17/05/2021,3,0,89,75,14,67,0,0
721,16/05/2021,3,29,111,35,76,49,0,0
67,07/05/2021,3,1,51,9,42,49,0,0
759,20/05/2021,3,2,85,60,25,52,0,0
111,03/05/2021,3,0,60,28,32,55,0,0
487,13/05/2021,3,4,35,14,21,49,0,0
755,09/05/2021,3,0,87,19,68,49,0,0
627,08/05/2021,3,0,41,4,37,49,0,0
133,19/05/2021,3,2,62,33,29,49,0,0
436,24/05/2021,3,2,204,74,130,49,0,0
712,17/05/2021,3,1,84,12,72,49,0,0
506,21/05/2021,3,2,193,120,73,55,0,0
689,23/05/2021,3,0,130,88,42,65,0,0
648,14/05/2021,3,0,64,14,50,49,0,0
102,07/05/2021,3,0,60,18,42,49,0,0
215,20/05/2021,3,0,46,33,13,72,0,0
206,13/05/2021,3,17,196,126,70,59,0,0
476,13/05/2021,3,1,172,28,144,49,0,0
490,26/05/2021,3,5,160,33,127,49,0,0
61,07/05/2021,3,1,99,12,87,49,0,0
752,07/05/2021,3,18,26,3,23,49,0,0
176,11/05/2021,3,4,96,36,60,49,0,0
810,21/05/2021,3,0,389,42,347,80,0,0
592,15/05/2021,3,2,82,12,70,49,0,0
438,04/05/2021,3,29,67,43,24,123,0,0
326,10/05/2021,3,4,77,49,28,67,0,0
250,13/05/2021,3,0,115,94,21,72,0,0
807,01/05/2021,3,2,98,14,84,49,0,0
423,16/05/2021,3,1,49,8,41,49,0,0
562,16/05/2021,3,1,67,6,61,49,0,0
88,16/05/2021,3,1,41,9,32,49,0,0
656,13/05/2021,3,0,115,45,70,49,0,0
702,16/05/2021,3,1,49,8,41,49,0,0
934,07/05/2021,3,71,28,1,27,35,0,0
618,07/05/2021,3,14,137,10,127,49,0,0
140,04/05/2021,3,0,170,94,76,49,0,0
694,07/05/2021,3,4,105,15,90,49,0,0
13,11/05/2021,3,3,78,71,7,89,0,0
573,07/05/2021,3,0,57,15,42,49,0,0
291,03/05/2021,3,1,60,17,43,49,0,0
911,16/05/2021,3,0,158,3,155,49,0,0
123,09/05/2021,3,1,94,14,80,49,0,0
135,08/05/2021,3,4,62,2,60,49,0,0
8,06/05/2021,3,1,39,11,28,49,0,0
309,02/05/2021,3,0,16,7,9,49,0,0
178,20/05/2021,3,0,38,33,5,80,0,0
754,17/05/2021,3,0,62,28,34,49,0,0
417,12/05/2021,3,0,103,38,65,49,0,0
862,11/05/2021,3,3,107,38,69,49,0,0
430,08/05/2021,3,3,86,17,69,55,0,0
572,08/05/2021,3,0,61,15,46,49,0,0
171,09/05/2021,3,2,47,8,39,49,0,0
249,13/05/2021,3,2,125,77,48,49,0,0
446,22/05/2021,3,7,126,78,48,49,0,0
315,06/05/2021,3,0,62,33,29,55,0,0
539,06/05/2021,3,2,95,24,71,49,0,0
711,19/05/2021,3,0,89,70,19,80,0,0
713,15/05/2021,3,1,60,58,2,154,0,0
67,08/05/2021,3,1,51,17,34,49,0,0
765,17/05/2021,3,1,100,48,52,59,0,0
823,05/05/2021,3,1,60,29,31,52,0,0
624,13/05/2021,3,1,78,36,42,49,0,0
106,10/05/2021,3,1,30,15,15,55,0,0
639,09/05/2021,3,0,59,6,53,49,0,0
792,19/05/2021,3,0,102,92,10,62,0,0
654,14/05/2021,3,6,53,4,49,66,0,0
114,17/05/2021,3,0,75,69,6,80,0,0
832,14/05/2021,3,1,99,15,84,49,0,0
526,24/05/2021,3,1,37,37,0,NA,NA,NA
198,15/05/2021,3,1,134,20,114,49,0,0
412,08/05/2021,3,6,95,6,89,49,0,0
75,18/05/2021,3,0,81,40,41,49,0,0
886,14/05/2021,3,4,148,66,82,49,0,0
5,14/05/2021,3,4,85,26,59,49,0,0
818,17/05/2021,3,1,80,80,0,NA,NA,NA
185,07/05/2021,3,1,167,17,150,49,0,0
675,06/05/2021,3,2,54,33,21,52,0,0
434,11/05/2021,3,3,57,32,25,49,0,0
26,21/05/2021,3,4,62,32,30,55,0,0
867,15/05/2021,3,1,59,18,41,49,0,0
438,05/05/2021,3,32,64,45,19,85,0,0
861,10/05/2021,3,0,61,48,13,64,0,0
588,13/05/2021,3,0,59,42,17,67,0,0
304,02/05/2021,3,5,55,4,51,49,0,0
696,16/05/2021,3,1,88,13,75,49,0,0
343,17/05/2021,3,1,61,34,27,49,0,0
101,16/05/2021,3,1,59,23,36,49,0,0
697,13/05/2021,3,1,108,32,76,49,0,0
406,15/05/2021,3,1,38,18,20,49,0,0
899,06/05/2021,3,5,100,16,84,49,0,0
618,08/05/2021,3,16,135,32,103,49,0,0
140,05/05/2021,3,0,170,97,73,49,0,0
580,08/05/2021,3,4,94,13,81,49,0,0
405,12/05/2021,3,1,89,60,29,52,0,0
849,07/05/2021,3,1,83,12,71,49,0,0
291,01/05/2021,3,1,60,53,7,62,0,0
319,17/05/2021,3,1,113,86,27,52,0,0
123,08/05/2021,3,1,94,3,91,49,0,0
344,08/05/2021,3,1,64,13,51,49,0,0
730,01/05/2021,3,2,73,5,68,49,0,0
95,01/05/2021,3,1,87,20,67,49,0,0
788,11/05/2021,3,2,89,6,83,49,0,0
642,18/05/2021,3,2,93,39,54,49,0,0
836,12/05/2021,3,3,98,32,66,49,0,0
816,11/05/2021,3,3,79,58,21,64,0,0
430,06/05/2021,3,2,87,45,42,55,0,0
631,08/05/2021,3,2,69,11,58,49,0,0
370,09/05/2021,3,1,39,5,34,49,0,0
249,09/05/2021,3,1,126,58,68,49,0,0
882,21/05/2021,3,0,130,29,101,39,0,0
871,03/05/2021,3,3,75,13,62,49,0,0
734,06/05/2021,3,2,59,39,20,59,0,0
711,20/05/2021,3,0,89,76,13,74,0,0
456,15/05/2021,3,5,85,36,49,49,0,0
437,08/05/2021,3,3,162,29,133,49,0,0
154,17/05/2021,3,3,101,67,34,49,0,0
878,01/05/2021,3,0,218,11,207,44,0,0
703,12/05/2021,3,0,91,54,37,55,0,0
865,11/05/2021,3,1,84,10,74,49,0,0
627,09/05/2021,3,0,41,5,36,49,0,0
809,19/05/2021,3,4,97,65,32,49,0,0
462,16/05/2021,3,4,185,0,185,55,0,0
712,18/05/2021,3,1,84,14,70,49,0,0
404,14/05/2021,3,0,67,20,47,49,0,0
271,25/05/2021,3,1,69,70,-1,NA,NA,NA
413,15/05/2021,3,2,114,21,93,49,0,0
582,08/05/2021,3,0,53,28,25,49,0,0
384,18/05/2021,3,0,101,87,14,80,0,0
143,13/05/2021,3,0,120,52,68,49,0,0
559,12/05/2021,3,53,132,78,54,52,0,0
818,18/05/2021,3,1,80,80,0,NA,NA,NA
30,08/05/2021,3,1,70,23,47,49,0,0
918,08/05/2021,3,0,201,20,181,39,0,0
709,11/05/2021,3,0,83,17,66,55,0,0
26,22/05/2021,3,3,63,44,19,60,0,0
419,14/05/2021,3,3,107,23,84,66,0,0
715,05/05/2021,3,2,86,84,2,95,0,0
275,11/05/2021,3,4,113,75,38,72,0,0
623,13/05/2021,3,0,78,15,63,49,0,0
493,03/05/2021,3,2,33,7,26,49,0,0
380,17/05/2021,3,1,159,59,100,49,0,0
621,16/05/2021,3,0,60,11,49,49,0,0
738,16/05/2021,3,1,123,15,108,49,0,0
97,14/05/2021,3,5,102,18,84,49,0,0
175,16/05/2021,3,1,119,23,96,49,0,0
248,07/05/2021,3,0,82,28,54,49,0,0
618,09/05/2021,3,14,137,28,109,49,0,0
140,02/05/2021,3,2,168,37,131,49,0,0
680,07/05/2021,3,3,77,32,45,49,0,0
395,12/05/2021,3,1,71,41,30,57,0,0
819,06/05/2021,3,0,80,49,31,55,0,0
351,03/05/2021,3,1,65,15,50,55,0,0
508,17/05/2021,3,12,68,34,34,52,0,0
105,09/05/2021,3,1,74,12,62,49,0,0
428,08/05/2021,3,4,88,29,59,49,0,0
730,02/05/2021,3,2,73,6,67,49,0,0
309,01/05/2021,3,0,16,9,7,49,0,0
788,12/05/2021,3,2,89,5,84,49,0,0
292,17/05/2021,3,2,237,49,188,49,0,0
51,10/05/2021,3,2,78,52,26,60,0,0
816,12/05/2021,3,3,79,66,13,72,0,0
373,06/05/2021,3,2,101,41,60,55,0,0
435,07/05/2021,3,67,53,11,42,49,0,0
753,09/05/2021,3,2,125,15,110,49,0,0
300,11/05/2021,3,1,209,117,92,49,0,0
882,22/05/2021,3,0,130,67,63,39,0,0
871,04/05/2021,3,3,75,38,37,49,0,0
258,07/05/2021,3,1,142,26,116,49,0,0
866,20/05/2021,3,0,100,76,24,52,0,0
736,16/05/2021,3,1,104,12,92,49,0,0
915,07/05/2021,3,3,186,6,180,35,0,0
18,17/05/2021,3,3,89,89,0,NA,NA,NA
823,03/05/2021,3,1,60,14,46,49,0,0
511,12/05/2021,3,0,76,37,39,49,0,0
193,09/05/2021,3,2,106,13,93,49,0,0
659,09/05/2021,3,2,41,3,38,49,0,0
687,19/05/2021,3,2,85,53,32,52,0,0
253,14/05/2021,3,1,57,13,44,49,0,0
465,18/05/2021,3,3,264,115,149,55,0,0
352,15/05/2021,3,0,64,9,55,49,0,0
271,11/05/2021,3,0,70,32,38,55,0,0
198,16/05/2021,3,1,134,19,115,49,0,0
126,06/05/2021,3,1,119,41,78,49,0,0
544,18/05/2021,3,0,53,15,38,49,0,0
180,13/05/2021,3,0,41,22,19,49,0,0
38,13/05/2021,3,1,49,29,20,55,0,0
667,18/05/2021,3,0,10,0,10,NA,NA,NA
124,08/05/2021,3,1,53,12,41,49,0,0
752,08/05/2021,3,18,26,2,24,52,0,0
709,12/05/2021,3,0,83,19,64,55,0,0
240,22/05/2021,3,1,70,63,7,77,0,0
419,15/05/2021,3,3,107,36,71,66,0,0
603,04/05/2021,3,5,79,39,40,49,0,0
310,11/05/2021,3,1,71,51,20,60,0,0
232,12/05/2021,3,3,62,41,21,60,0,0
902,01/05/2021,3,2,124,6,118,49,0,0
305,09/05/2021,3,2,57,5,52,49,0,0
741,16/05/2021,3,0,70,22,48,49,0,0
99,14/05/2021,3,0,167,31,136,49,0,0
97,15/05/2021,3,5,102,24,78,49,0,0
93,16/05/2021,3,3,138,19,119,49,0,0
248,05/05/2021,3,0,82,50,32,60,0,0
346,07/05/2021,3,6,114,53,61,49,0,0
457,04/05/2021,3,2,61,29,32,49,0,0
661,11/05/2021,3,4,168,17,151,49,0,0
336,10/05/2021,3,1,73,63,10,80,0,0
379,07/05/2021,3,4,283,61,222,66,0,0
351,04/05/2021,3,1,65,33,32,55,0,0
808,17/05/2021,3,11,157,123,34,67,0,0
774,07/05/2021,3,5,100,14,86,49,0,0
662,08/05/2021,3,3,104,14,90,49,0,0
761,02/05/2021,3,2,81,7,74,49,0,0
473,01/05/2021,3,3,47,22,25,49,0,0
54,11/05/2021,3,1,60,40,20,55,0,0
642,17/05/2021,3,2,93,41,52,49,0,0
163,11/05/2021,3,1,61,40,21,64,0,0
209,10/05/2021,3,1,113,42,71,55,0,0
430,07/05/2021,3,3,86,20,66,55,0,0
87,07/05/2021,3,2,116,9,107,49,0,0
745,07/05/2021,3,2,103,15,88,49,0,0
249,12/05/2021,3,1,126,86,40,49,0,0
450,22/05/2021,3,3,181,163,18,67,0,0
297,02/05/2021,3,2,74,29,45,49,0,0
230,07/05/2021,3,0,80,58,22,57,0,0
866,17/05/2021,3,0,100,42,58,49,0,0
794,14/05/2021,3,0,137,6,131,55,0,0
915,08/05/2021,3,5,184,6,178,35,0,0
704,02/05/2021,3,1,31,3,28,49,0,0
514,01/05/2021,3,6,228,33,195,49,0,0
440,13/05/2021,3,0,265,18,247,66,0,0
262,09/05/2021,3,2,49,18,31,49,0,0
639,10/05/2021,3,0,59,6,53,49,0,0
145,19/05/2021,3,2,56,26,30,55,0,0
253,15/05/2021,3,1,57,14,43,49,0,0
79,17/05/2021,3,2,44,33,11,85,0,0
728,15/05/2021,3,0,47,13,34,49,0,0
526,11/05/2021,3,0,38,24,14,59,0,0
42,15/05/2021,3,3,96,17,79,49,0,0
39,07/05/2021,3,1,60,25,35,49,0,0
619,18/05/2021,3,0,101,60,41,64,0,0
805,13/05/2021,3,3,110,37,73,49,0,0
821,14/05/2021,3,1,78,35,43,49,0,0
667,17/05/2021,3,0,10,0,10,NA,NA,NA
289,08/05/2021,3,1,67,16,51,49,0,0
534,06/05/2021,3,0,85,25,60,49,0,0
257,10/05/2021,3,1,43,43,0,NA,NA,NA
146,20/05/2021,3,1,40,39,1,83,0,0
781,15/05/2021,3,4,79,64,15,57,0,0
308,04/05/2021,3,2,46,12,34,49,0,0
481,11/05/2021,3,0,56,47,9,128,0,0
33,13/05/2021,3,5,75,28,47,49,0,0
78,03/05/2021,3,0,44,13,31,59,0,0
305,08/05/2021,3,2,57,7,50,49,0,0
201,08/05/2021,3,2,136,4,132,49,0,0
803,14/05/2021,3,0,69,42,27,49,0,0
636,15/05/2021,3,1,119,50,69,49,0,0
492,16/05/2021,3,3,34,11,23,49,0,0
104,05/05/2021,3,2,60,59,1,95,0,0
214,09/05/2021,3,4,82,13,69,49,0,0
457,06/05/2021,3,2,61,22,39,49,0,0
425,08/05/2021,3,3,247,14,233,66,0,0
377,10/05/2021,3,0,149,73,76,55,0,0
379,10/05/2021,3,3,284,91,193,66,0,0
331,03/05/2021,3,11,83,36,47,55,0,0
891,17/05/2021,3,2,80,71,9,73,0,0
157,08/05/2021,3,1,82,28,54,49,0,0
129,09/05/2021,3,11,189,31,158,49,0,0
730,04/05/2021,3,2,73,14,59,49,0,0
443,01/05/2021,3,4,86,33,53,49,0,0
178,12/05/2021,3,1,37,20,17,64,0,0
3,18/05/2021,3,8,105,50,55,49,0,0
163,12/05/2021,3,1,61,42,19,72,0,0
433,11/05/2021,3,2,316,68,248,66,0,0
430,09/05/2021,3,3,86,19,67,55,0,0
737,07/05/2021,3,2,40,4,36,49,0,0
745,08/05/2021,3,2,103,16,87,49,0,0
300,12/05/2021,3,1,209,121,88,49,0,0
66,12/05/2021,3,1,151,4,147,49,0,0
871,02/05/2021,3,2,76,14,62,49,0,0
873,06/05/2021,3,3,98,33,65,49,0,0
829,20/05/2021,3,0,150,15,135,49,0,0
27,14/05/2021,3,0,78,56,22,52,0,0
4,06/05/2021,3,2,62,55,7,74,0,0
704,03/05/2021,3,1,31,1,30,49,0,0
371,02/05/2021,3,0,36,13,23,49,0,0
634,13/05/2021,3,0,20,17,3,94,0,0
917,10/05/2021,3,2,104,10,94,35,0,0
674,10/05/2021,3,1,97,3,94,49,0,0
581,20/05/2021,3,46,179,175,4,63,0,0
350,14/05/2021,3,5,55,16,39,49,0,0
783,18/05/2021,3,3,77,50,27,72,0,0
484,15/05/2021,3,0,40,8,32,49,0,0
526,09/05/2021,3,0,38,10,28,49,0,0
413,16/05/2021,3,2,114,26,88,49,0,0
126,07/05/2021,3,1,119,26,93,49,0,0
77,20/05/2021,3,0,103,103,0,NA,NA,NA
76,14/05/2021,3,1,92,26,66,49,0,0
407,12/05/2021,3,1,40,7,33,49,0,0
256,18/05/2021,3,2,107,51,56,49,0,0
185,05/05/2021,3,3,165,28,137,49,0,0
752,06/05/2021,3,18,26,12,14,49,0,0
121,10/05/2021,3,0,110,90,20,74,0,0
148,20/05/2021,3,0,25,22,3,62,0,0
396,14/05/2021,3,1,29,12,17,49,0,0
403,05/05/2021,3,2,96,64,32,55,0,0
52,12/05/2021,3,9,133,103,30,72,0,0
429,13/05/2021,3,3,122,34,88,49,0,0
78,01/05/2021,3,0,44,16,28,49,0,0
400,08/05/2021,3,2,28,0,28,49,0,0
358,08/05/2021,3,2,91,10,81,49,0,0
466,16/05/2021,3,0,140,12,128,49,0,0
80,13/05/2021,3,2,123,48,75,49,0,0
586,16/05/2021,3,3,80,38,42,59,0,0
104,06/05/2021,3,2,60,51,9,80,0,0
346,09/05/2021,3,5,115,32,83,49,0,0
635,02/05/2021,3,1,87,19,68,49,0,0
421,10/05/2021,3,0,19,19,0,NA,NA,NA
283,12/05/2021,3,0,76,26,50,59,0,0
849,06/05/2021,3,1,83,23,60,49,0,0
116,03/05/2021,3,0,61,16,45,55,0,0
181,17/05/2021,3,1,33,31,2,67,0,0
798,08/05/2021,3,1,80,32,48,49,0,0
542,09/05/2021,3,4,71,21,50,49,0,0
800,04/05/2021,3,2,55,21,34,49,0,0
244,02/05/2021,3,0,200,73,127,49,0,0
237,11/05/2021,3,4,117,23,94,49,0,0
72,17/05/2021,3,2,58,40,18,52,0,0
266,12/05/2021,3,0,61,45,16,72,0,0
390,10/05/2021,3,2,134,26,108,49,0,0
551,06/05/2021,3,0,115,40,75,49,0,0
91,08/05/2021,3,2,78,15,63,49,0,0
370,08/05/2021,3,1,39,9,30,49,0,0
898,12/05/2021,3,1,99,52,47,49,0,0
491,12/05/2021,3,5,174,26,148,49,0,0
297,06/05/2021,3,4,72,42,30,49,0,0
325,07/05/2021,3,1,44,18,26,49,0,0
638,18/05/2021,3,0,101,77,24,80,0,0
794,16/05/2021,3,0,137,9,128,55,0,0
57,08/05/2021,3,1,139,24,115,49,0,0
879,04/05/2021,3,3,161,9,152,39,0,0
1,01/05/2021,3,2,98,20,78,49,0,0
703,13/05/2021,3,0,91,64,27,60,0,0
594,11/05/2021,3,43,64,58,6,93,0,0
376,08/05/2021,3,2,62,29,33,49,0,0
652,20/05/2021,3,1,68,67,1,80,0,0
512,14/05/2021,3,2,60,8,52,49,0,0
637,16/05/2021,3,1,73,29,44,49,0,0
714,15/05/2021,3,0,59,6,53,49,0,0
190,09/05/2021,3,4,76,8,68,49,0,0
361,10/05/2021,3,38,27,17,10,80,0,0
134,05/05/2021,3,1,47,26,21,49,0,0
77,18/05/2021,3,0,103,103,0,NA,NA,NA
180,14/05/2021,3,0,41,10,31,49,0,0
530,14/05/2021,3,1,59,47,12,52,0,0
490,18/05/2021,3,6,159,26,133,49,0,0
185,08/05/2021,3,2,166,27,139,49,0,0
863,07/05/2021,3,8,87,6,81,49,0,0
103,12/05/2021,3,0,161,73,88,59,0,0
26,02/05/2021,3,0,66,6,60,49,0,0
515,14/05/2021,3,5,107,41,66,49,0,0
764,06/05/2021,3,2,67,17,50,49,0,0
275,12/05/2021,3,4,113,72,41,64,0,0
860,13/05/2021,3,12,80,34,46,49,0,0
493,02/05/2021,3,2,33,7,26,55,0,0
777,08/05/2021,3,2,118,19,99,49,0,0
455,10/05/2021,3,8,243,4,239,66,0,0
803,15/05/2021,3,0,69,52,17,52,0,0
188,13/05/2021,3,3,118,73,45,49,0,0
537,15/05/2021,3,3,99,88,11,67,0,0
934,06/05/2021,3,71,28,7,21,35,0,0
664,08/05/2021,3,5,150,44,106,49,0,0
663,02/05/2021,3,1,147,12,135,49,0,0
421,08/05/2021,3,0,19,19,0,NA,NA,NA
377,11/05/2021,3,0,149,90,59,64,0,0
23,08/05/2021,3,2,62,23,39,49,0,0
291,02/05/2021,3,1,60,39,21,52,0,0
716,17/05/2021,3,0,104,68,36,60,0,0
7,09/05/2021,3,2,101,20,81,49,0,0
344,09/05/2021,3,2,63,7,56,49,0,0
730,06/05/2021,3,2,73,8,65,49,0,0
443,02/05/2021,3,4,86,27,59,49,0,0
318,10/05/2021,3,0,59,39,20,80,0,0
813,17/05/2021,3,1,129,106,23,57,0,0
684,10/05/2021,3,3,95,19,76,49,0,0
394,10/05/2021,3,4,64,7,57,49,0,0
569,06/05/2021,3,0,120,17,103,49,0,0
435,08/05/2021,3,67,53,10,43,49,0,0
370,06/05/2021,3,1,39,17,22,49,0,0
300,13/05/2021,3,1,209,123,86,49,0,0
784,13/05/2021,3,3,46,21,25,49,0,0
871,06/05/2021,3,2,76,31,45,49,0,0
873,07/05/2021,3,3,98,14,84,49,0,0
829,17/05/2021,3,0,150,6,144,49,0,0
159,14/05/2021,3,0,77,21,56,49,0,0
368,08/05/2021,3,1,84,26,58,49,0,0
826,05/05/2021,3,3,95,30,65,55,0,0
701,02/05/2021,3,2,60,2,58,49,0,0
841,13/05/2021,3,0,182,19,163,55,0,0
848,11/05/2021,3,4,134,18,116,35,0,0
372,08/05/2021,3,4,88,41,47,49,0,0
809,20/05/2021,3,3,98,77,21,57,0,0
597,15/05/2021,3,4,97,18,79,49,0,0
566,18/05/2021,3,1,74,42,32,57,0,0
728,14/05/2021,3,2,45,17,28,49,0,0
243,10/05/2021,3,1,126,30,96,49,0,0
361,09/05/2021,3,38,27,18,9,80,0,0
199,05/05/2021,3,2,80,40,40,49,0,0
77,19/05/2021,3,0,103,103,0,NA,NA,NA
34,13/05/2021,3,3,85,49,36,60,0,0
107,12/05/2021,3,29,60,47,13,59,0,0
327,18/05/2021,3,16,52,45,7,80,0,0
842,08/05/2021,3,1,90,57,33,59,0,0
60,08/05/2021,3,0,57,6,51,49,0,0
32,10/05/2021,3,1,104,103,1,90,0,0
678,04/05/2021,3,0,44,0,44,NA,NA,NA
781,14/05/2021,3,5,78,45,33,49,0,0
58,04/05/2021,3,1,66,46,20,74,0,0
275,10/05/2021,3,6,111,61,50,55,0,0
767,12/05/2021,3,0,67,49,18,67,0,0
210,01/05/2021,3,3,99,99,0,NA,NA,NA
423,09/05/2021,3,3,47,12,35,49,0,0
621,08/05/2021,3,1,59,15,44,49,0,0
466,15/05/2021,3,0,140,17,123,49,0,0
636,13/05/2021,3,0,120,70,50,49,0,0
477,16/05/2021,3,4,116,8,108,49,0,0
83,07/05/2021,3,36,132,27,105,49,0,0
845,07/05/2021,3,1,119,8,111,49,0,0
840,05/05/2021,3,1,311,72,239,49,0,0
651,08/05/2021,3,1,77,9,68,49,0,0
377,12/05/2021,3,0,149,103,46,72,0,0
470,08/05/2021,3,1,79,28,51,49,0,0
388,04/05/2021,3,1,59,45,14,57,0,0
550,16/05/2021,3,2,110,7,103,49,0,0
157,09/05/2021,3,1,82,11,71,49,0,0
428,09/05/2021,3,5,87,24,63,49,0,0
800,06/05/2021,3,2,55,19,36,49,0,0
473,02/05/2021,3,5,45,18,27,49,0,0
155,11/05/2021,3,0,93,33,60,55,0,0
202,17/05/2021,3,0,76,72,4,72,0,0
163,10/05/2021,3,1,61,42,19,64,0,0
173,10/05/2021,3,3,68,45,23,60,0,0
839,06/05/2021,3,4,151,49,102,49,0,0
572,07/05/2021,3,0,61,6,55,49,0,0
122,09/05/2021,3,5,116,22,94,49,0,0
348,10/05/2021,3,5,135,83,52,75,0,0
66,13/05/2021,3,0,152,3,149,49,0,0
548,06/05/2021,3,0,91,45,46,49,0,0
521,07/05/2021,3,1,54,9,45,49,0,0
829,18/05/2021,3,0,150,25,125,49,0,0
164,15/05/2021,3,0,62,24,38,49,0,0
525,06/05/2021,3,3,72,44,28,52,0,0
488,06/05/2021,3,3,63,45,18,67,0,0
371,06/05/2021,3,7,29,12,17,74,0,0
216,12/05/2021,3,0,58,27,31,49,0,0
519,11/05/2021,3,0,64,41,23,67,0,0
554,09/05/2021,3,2,40,4,36,49,0,0
591,20/05/2021,3,0,68,66,2,112,0,0
269,16/05/2021,3,2,78,5,73,49,0,0
217,16/05/2021,3,1,40,12,28,49,0,0
362,14/05/2021,3,5,115,73,42,59,0,0
190,11/05/2021,3,4,76,11,65,49,0,0
147,09/05/2021,3,0,80,12,68,49,0,0
199,07/05/2021,3,2,80,13,67,49,0,0
219,02/05/2021,3,5,72,2,70,49,0,0
220,13/05/2021,3,27,76,27,49,49,0,0
559,14/05/2021,3,45,140,30,110,49,0,0
53,18/05/2021,3,0,70,70,0,NA,NA,NA
30,06/05/2021,3,1,70,44,26,60,0,0
534,08/05/2021,3,0,85,8,77,49,0,0
103,11/05/2021,3,1,160,78,82,59,0,0
678,05/05/2021,3,0,44,0,44,NA,NA,NA
224,15/05/2021,3,1,56,14,42,49,0,0
509,05/05/2021,3,1,111,28,83,49,0,0
310,10/05/2021,3,1,71,40,31,55,0,0
480,13/05/2021,3,0,28,16,12,49,0,0
117,02/05/2021,3,1,93,93,0,NA,NA,NA
777,09/05/2021,3,2,118,10,108,49,0,0
179,09/05/2021,3,1,91,13,78,49,0,0
520,15/05/2021,3,0,58,14,44,49,0,0
499,14/05/2021,3,0,31,10,21,49,0,0
378,15/05/2021,3,0,84,15,69,49,0,0
402,07/05/2021,3,0,155,21,134,49,0,0
31,09/05/2021,3,1,62,8,54,49,0,0
840,06/05/2021,3,1,311,81,230,49,0,0
260,08/05/2021,3,0,120,30,90,49,0,0
273,09/05/2021,3,0,103,83,20,72,0,0
573,09/05/2021,3,1,56,11,45,49,0,0
645,03/05/2021,3,3,38,13,25,55,0,0
319,16/05/2021,3,1,113,36,77,49,0,0
105,07/05/2021,3,1,74,12,62,49,0,0
616,09/05/2021,3,3,72,23,49,49,0,0
761,01/05/2021,3,2,81,17,64,49,0,0
59,01/05/2021,3,0,75,6,69,49,0,0
565,11/05/2021,3,0,62,60,2,117,0,0
464,17/05/2021,3,1,265,35,230,66,0,0
875,11/05/2021,3,2,90,73,17,72,0,0
167,10/05/2021,3,0,84,73,11,72,0,0
538,07/05/2021,3,1,43,6,37,49,0,0
91,07/05/2021,3,1,79,14,65,49,0,0
753,08/05/2021,3,2,125,4,121,49,0,0
557,10/05/2021,3,1,103,66,37,60,0,0
882,12/05/2021,3,0,130,25,105,39,0,0
726,06/05/2021,3,0,39,9,30,59,0,47
234,06/05/2021,3,2,60,13,47,49,0,0
424,03/05/2021,3,1,27,2,25,49,0,0
567,15/05/2021,3,0,61,35,26,49,0,0
211,06/05/2021,3,5,55,23,32,55,0,0
826,06/05/2021,3,3,95,32,63,55,0,0
111,02/05/2021,3,0,60,20,40,49,0,0
263,12/05/2021,3,0,66,25,41,49,0,0
475,09/05/2021,3,1,98,18,80,49,0,0
919,09/05/2021,3,0,123,4,119,49,0,0
677,20/05/2021,3,0,40,32,8,57,0,0
436,16/05/2021,3,2,204,23,181,49,0,0
293,16/05/2021,3,1,59,23,36,49,0,0
362,15/05/2021,3,5,115,82,33,64,0,0
243,11/05/2021,3,1,126,41,85,49,0,0
776,09/05/2021,3,0,104,9,95,49,0,0
341,07/05/2021,3,2,112,38,74,49,0,0
633,02/05/2021,3,2,48,3,45,49,0,0
626,13/05/2021,3,2,100,55,45,55,0,0
174,12/05/2021,3,2,26,12,14,67,0,0
757,18/05/2021,3,0,117,117,0,NA,NA,NA
632,08/05/2021,3,0,82,11,71,49,0,0
277,10/05/2021,3,4,68,44,24,62,0,0
678,01/05/2021,3,0,44,0,44,NA,NA,NA
515,15/05/2021,3,4,108,44,64,49,0,0
322,05/05/2021,3,0,100,12,88,49,0,0
426,10/05/2021,3,6,157,70,87,55,0,0
250,12/05/2021,3,0,115,92,23,72,0,0
117,03/05/2021,3,0,94,15,79,55,0,0
785,09/05/2021,3,2,108,12,96,49,0,0
641,10/05/2021,3,0,160,7,153,49,0,0
99,16/05/2021,3,0,167,23,144,49,0,0
501,14/05/2021,3,26,207,10,197,49,0,0
558,16/05/2021,3,0,44,7,37,49,0,0
272,05/05/2021,3,1,126,36,90,49,0,0
845,09/05/2021,3,1,119,35,84,49,0,0
840,01/05/2021,3,1,311,51,260,49,0,0
461,10/05/2021,3,0,122,5,117,66,0,0
273,10/05/2021,3,0,103,101,2,95,0,0
896,09/05/2021,3,0,82,28,54,49,0,0
773,03/05/2021,3,1,73,22,51,59,0,0
459,16/05/2021,3,4,88,31,57,49,0,0
497,07/05/2021,3,1,192,39,153,49,0,0
662,09/05/2021,3,3,104,20,84,49,0,0
471,04/05/2021,3,8,112,48,64,55,0,0
244,01/05/2021,3,0,200,110,90,49,0,0
735,10/05/2021,3,0,29,8,21,49,0,0
518,17/05/2021,3,1,16,13,3,74,0,0
266,10/05/2021,3,0,61,54,7,67,0,0
209,12/05/2021,3,1,113,79,34,60,0,0
758,07/05/2021,3,0,73,26,47,49,0,0
374,07/05/2021,3,0,56,12,44,49,0,0
745,09/05/2021,3,2,103,16,87,49,0,0
348,11/05/2021,3,5,135,88,47,107,0,0
416,12/05/2021,3,0,34,2,32,49,0,0
118,06/05/2021,3,3,56,23,33,49,0,0
705,04/05/2021,3,0,91,23,68,49,0,0
673,15/05/2021,3,0,123,22,101,49,0,0
806,06/05/2021,3,2,134,84,50,55,0,0
18,02/05/2021,3,2,90,17,73,49,0,0
371,24/05/2021,3,0,36,17,19,111,0,0
487,19/05/2021,3,4,35,24,11,62,0,0
106,11/05/2021,3,1,30,19,11,60,0,0
35,08/05/2021,3,0,110,14,96,49,0,0
444,21/05/2021,3,4,115,88,27,52,0,0
825,16/05/2021,3,3,143,19,124,49,0,0
333,16/05/2021,3,1,56,37,19,60,0,0
647,15/05/2021,3,2,91,62,29,52,0,0
184,11/05/2021,3,0,51,41,10,80,0,0
332,18/05/2021,3,0,40,26,14,55,0,0
543,07/05/2021,3,1,64,8,56,49,0,0
219,04/05/2021,3,6,71,12,59,49,0,0
626,14/05/2021,3,4,98,22,76,49,0,0
357,15/05/2021,3,1,82,11,71,49,0,0
441,18/05/2021,3,0,168,17,151,55,0,0
918,06/05/2021,3,0,201,37,164,39,0,0
103,10/05/2021,3,1,160,58,102,55,0,0
678,02/05/2021,3,0,44,0,44,NA,NA,NA
629,15/05/2021,3,2,60,28,32,49,0,0
764,12/05/2021,3,2,67,18,49,55,0,0
326,11/05/2021,3,6,75,46,29,55,0,0
108,13/05/2021,3,0,78,18,60,49,0,0
210,17/05/2021,3,2,100,98,2,62,0,0
238,08/05/2021,3,1,65,27,38,49,0,0
621,09/05/2021,3,1,59,17,42,49,0,0
520,14/05/2021,3,0,58,11,47,49,0,0
601,14/05/2021,3,6,62,28,34,49,0,0
537,23/05/2021,3,3,99,68,31,72,0,0
899,08/05/2021,3,6,99,16,83,49,0,0
225,13/05/2021,3,13,67,32,35,55,0,0
840,02/05/2021,3,1,311,70,241,49,0,0
425,07/05/2021,3,3,247,18,229,66,0,0
283,10/05/2021,3,0,76,22,54,55,0,0
50,02/05/2021,3,2,119,11,108,49,0,0
81,02/05/2021,3,1,59,4,55,49,0,0
808,16/05/2021,3,11,157,46,111,49,0,0
585,07/05/2021,3,6,54,17,37,49,0,0
756,07/05/2021,3,0,106,62,44,49,0,0
22,04/05/2021,3,0,64,64,0,NA,NA,NA
802,02/05/2021,3,1,64,20,44,49,0,0
279,10/05/2021,3,0,57,17,40,55,0,0
782,10/05/2021,3,0,20,16,4,147,0,0
875,10/05/2021,3,0,92,63,29,55,0,0
394,20/05/2021,3,0,68,35,33,49,0,0
839,17/05/2021,3,3,152,83,69,49,0,0
205,08/05/2021,3,1,125,18,107,49,0,0
615,17/05/2021,3,0,71,34,37,49,0,0
898,19/05/2021,3,1,99,94,5,63,0,0
882,13/05/2021,3,0,130,35,95,39,0,0
521,10/05/2021,3,1,54,25,29,49,0,0
705,06/05/2021,3,0,91,13,78,49,0,0
90,16/05/2021,3,0,78,10,68,49,0,0
915,06/05/2021,3,4,185,18,167,35,0,0
18,04/05/2021,3,2,90,43,47,55,0,0
514,21/05/2021,3,3,231,112,119,55,0,0
583,18/05/2021,3,2,79,61,18,67,0,0
262,10/05/2021,3,2,49,38,11,67,0,0
270,08/05/2021,3,1,59,40,19,49,0,0
133,22/05/2021,3,2,62,11,51,55,0,0
56,14/05/2021,3,2,63,12,51,49,0,0
360,22/05/2021,3,1,43,37,6,63,0,0
110,14/05/2021,3,1,86,15,71,49,0,0
420,09/05/2021,3,11,58,30,28,49,0,0
776,17/05/2021,3,0,104,39,65,49,0,0
199,15/05/2021,3,0,82,29,53,49,0,0
219,05/05/2021,3,6,71,12,59,49,0,0
206,14/05/2021,3,17,196,52,144,55,0,0
316,16/05/2021,3,1,38,12,26,49,0,0
732,18/05/2021,3,0,60,38,22,62,0,0
383,06/05/2021,3,4,81,25,56,59,0,0
277,16/05/2021,3,4,68,17,51,49,0,0
678,03/05/2021,3,0,44,0,44,NA,NA,NA
130,21/05/2021,3,3,78,77,1,91,0,0
403,13/05/2021,3,3,95,47,48,55,0,0
426,12/05/2021,3,6,157,73,84,55,0,0
33,17/05/2021,3,2,78,40,38,49,0,0
78,17/05/2021,3,0,44,38,6,92,0,0
696,08/05/2021,3,1,88,3,85,49,0,0
179,10/05/2021,3,1,91,37,54,55,0,0
868,21/05/2021,3,0,83,62,21,74,0,0
656,14/05/2021,3,0,115,15,100,49,0,0
795,23/05/2021,3,7,98,47,51,49,0,0
248,09/05/2021,3,0,82,18,64,49,0,0
827,13/05/2021,3,1,69,48,21,55,0,0
840,03/05/2021,3,1,311,41,270,49,0,0
425,09/05/2021,3,3,247,21,226,66,0,0
283,14/05/2021,3,0,76,13,63,49,0,0
573,02/05/2021,3,0,57,7,50,49,0,0
351,02/05/2021,3,1,65,25,40,49,0,0
459,17/05/2021,3,4,88,50,38,49,0,0
497,13/05/2021,3,1,192,48,144,49,0,0
129,20/05/2021,3,13,187,92,95,49,0,0
303,01/05/2021,3,1,64,64,0,NA,NA,NA
244,05/05/2021,3,0,200,83,117,49,0,0
565,10/05/2021,3,0,62,49,13,80,0,0
204,10/05/2021,3,0,64,0,64,49,0,0
138,12/05/2021,3,3,95,47,48,55,0,0
862,20/05/2021,3,1,109,72,37,49,0,0
137,15/05/2021,3,24,122,26,96,49,0,0
631,15/05/2021,3,1,70,6,64,49,0,0
700,17/05/2021,3,5,127,47,80,49,0,0
48,18/05/2021,3,1,178,13,165,49,0,0
446,16/05/2021,3,5,128,27,101,49,0,0
787,10/05/2021,3,1,107,20,87,49,0,0
711,05/05/2021,3,1,88,42,46,59,0,0
524,16/05/2021,3,0,110,26,84,49,0,0
67,06/05/2021,3,1,51,21,30,59,0,0
47,05/05/2021,3,2,55,45,10,93,0,0
878,20/05/2021,3,0,218,8,210,44,0,0
685,18/05/2021,3,2,138,86,52,64,0,0
262,16/05/2021,3,3,48,26,22,49,0,0
639,08/05/2021,3,1,58,32,26,49,0,0
46,21/05/2021,3,5,55,31,24,49,0,0
462,14/05/2021,3,4,185,5,180,55,0,0
360,23/05/2021,3,1,43,20,23,49,0,0
647,17/05/2021,3,4,89,77,12,127,0,0
593,10/05/2021,3,5,76,78,-2,NA,NA,NA
607,18/05/2021,3,1,74,54,20,74,0,0
510,15/05/2021,3,2,141,6,135,49,0,0
887,04/05/2021,3,2,321,14,307,39,0,0
143,15/05/2021,3,0,120,18,102,49,0,0
476,16/05/2021,3,1,172,7,165,49,0,0
203,18/05/2021,3,0,40,20,20,52,0,0
632,06/05/2021,3,0,82,36,46,55,0,0
389,16/05/2021,3,2,124,8,116,49,0,0
148,05/05/2021,3,0,25,5,20,49,0,0
789,21/05/2021,3,0,72,48,24,80,0,0
509,13/05/2021,3,1,111,25,86,49,0,0
222,16/05/2021,3,1,76,5,71,49,0,0
429,17/05/2021,3,3,122,39,83,49,0,0
210,16/05/2021,3,2,100,60,40,49,0,0
189,10/05/2021,3,0,165,116,49,64,0,0
358,10/05/2021,3,2,91,58,33,60,0,0
803,21/05/2021,3,1,68,68,0,NA,NA,NA
499,15/05/2021,3,0,31,11,20,49,0,0
702,23/05/2021,3,1,49,21,28,49,0,0
264,09/05/2021,3,1,59,17,42,49,0,0
618,13/05/2021,3,19,132,66,66,49,0,0
635,04/05/2021,3,1,87,57,30,49,0,0
469,09/05/2021,3,4,192,18,174,66,0,0
640,14/05/2021,3,0,126,20,106,49,0,0
896,02/05/2021,3,0,82,35,47,49,0,0
388,02/05/2021,3,1,59,8,51,49,0,0
844,20/05/2021,3,0,61,17,44,55,0,0
646,13/05/2021,3,14,122,52,70,49,0,0
115,20/05/2021,3,0,115,43,72,49,0,0
22,06/05/2021,3,0,64,41,23,60,0,0
309,05/05/2021,3,0,16,13,3,85,0,0
178,10/05/2021,3,1,37,31,6,64,0,0
782,09/05/2021,3,0,20,20,0,NA,NA,NA
252,14/05/2021,3,2,262,25,237,49,0,0
390,18/05/2021,3,2,134,73,61,49,0,0
373,15/05/2021,3,2,101,24,77,49,0,0
374,13/05/2021,3,0,56,36,20,52,0,0
745,17/05/2021,3,1,104,53,51,55,0,0
670,05/05/2021,3,5,103,54,49,55,0,0
296,17/05/2021,3,3,57,35,22,52,0,0
873,10/05/2021,3,5,96,40,56,49,0,0
424,05/05/2021,3,1,27,12,15,49,0,0
770,26/05/2021,3,2,33,17,16,67,0,0
657,06/05/2021,3,0,48,31,17,60,0,0
759,04/05/2021,3,2,85,37,48,49,0,0
660,21/05/2021,3,6,180,41,139,49,0,0
731,18/05/2021,3,6,93,86,7,70,0,0
519,15/05/2021,3,0,64,26,38,49,0,0
674,08/05/2021,3,1,97,10,87,49,0,0
507,21/05/2021,3,4,196,93,103,55,0,0
462,15/05/2021,3,4,185,5,180,55,0,0
311,22/05/2021,3,0,97,62,35,111,0,0
431,16/05/2021,3,2,128,29,99,49,0,0
420,11/05/2021,3,11,58,34,24,60,0,0
361,18/05/2021,3,38,27,24,3,80,0,0
412,13/05/2021,3,2,99,13,86,49,0,0
887,05/05/2021,3,2,321,15,306,39,0,0
886,15/05/2021,3,0,152,66,86,49,0,0
530,16/05/2021,3,1,59,39,20,52,0,0
339,18/05/2021,3,15,579,55,524,49,0,0
675,07/05/2021,3,2,54,11,43,49,0,0
835,16/05/2021,3,5,99,24,75,49,0,0
148,01/05/2021,3,0,25,5,20,49,0,0
347,21/05/2021,3,12,50,47,3,94,0,0
579,03/05/2021,3,0,44,3,41,49,0,0
742,16/05/2021,3,1,73,12,61,49,0,0
860,17/05/2021,3,10,82,51,31,49,0,0
338,16/05/2021,3,3,397,96,301,49,0,0
423,10/05/2021,3,1,49,10,39,55,0,0
621,10/05/2021,3,1,59,47,12,67,0,0
520,21/05/2021,3,0,58,58,0,NA,NA,NA
656,15/05/2021,3,0,115,48,67,49,0,0
613,22/05/2021,3,0,56,49,7,74,0,0
104,09/05/2021,3,1,61,25,36,49,0,0
483,13/05/2021,3,4,95,25,70,49,0,0
635,05/05/2021,3,1,87,45,42,49,0,0
469,11/05/2021,3,4,192,59,133,66,0,0
377,15/05/2021,3,0,149,29,120,49,0,0
896,03/05/2021,3,0,82,18,64,49,0,0
645,02/05/2021,3,1,40,4,36,49,0,0
911,20/05/2021,3,0,158,13,145,49,0,0
774,13/05/2021,3,4,101,52,49,49,0,0
115,23/05/2021,3,0,115,26,89,49,0,0
268,04/05/2021,3,2,76,64,12,89,0,0
59,03/05/2021,3,0,75,3,72,49,0,0
628,10/05/2021,3,4,55,30,25,55,0,0
292,11/05/2021,3,5,234,18,216,49,0,0
417,15/05/2021,3,0,103,32,71,49,0,0
739,18/05/2021,3,2,73,22,51,49,0,0
872,15/05/2021,3,1,64,32,32,49,0,0
572,13/05/2021,3,0,61,32,29,55,0,0
100,15/05/2021,3,86,138,24,114,49,0,0
853,05/05/2021,3,6,96,38,58,55,0,0
882,16/05/2021,3,0,130,23,107,39,0,0
230,11/05/2021,3,0,80,16,64,49,0,0
424,06/05/2021,3,1,27,12,15,49,0,0
721,24/05/2021,3,28,112,81,31,140,0,0
152,08/05/2021,3,1,90,23,67,49,0,0
704,04/05/2021,3,1,31,13,18,49,0,0
660,24/05/2021,3,6,180,36,144,49,0,0
216,19/05/2021,3,2,56,44,12,62,0,0
755,15/05/2021,3,0,87,33,54,49,0,0
270,09/05/2021,3,1,59,23,36,49,0,0
581,21/05/2021,3,48,177,135,42,65,0,0
654,15/05/2021,3,6,53,6,47,66,0,0
712,15/05/2021,3,1,84,4,80,49,0,0
574,16/05/2021,3,12,75,11,64,49,0,0
593,11/05/2021,3,5,76,67,9,115,0,0
17,18/05/2021,3,1,93,89,4,77,0,0
582,15/05/2021,3,0,53,25,28,49,0,0
544,02/05/2021,3,1,52,13,39,49,0,0
432,15/05/2021,3,0,165,15,150,66,0,0
38,17/05/2021,3,1,49,39,10,67,0,0
820,18/05/2021,3,0,127,127,0,NA,NA,NA
675,08/05/2021,3,2,54,19,35,49,0,0
855,16/05/2021,3,1,175,34,141,49,0,0
148,02/05/2021,3,0,25,4,21,49,0,0
396,21/05/2021,3,1,29,17,12,55,0,0
579,02/05/2021,3,0,44,3,41,49,0,0
227,15/05/2021,3,2,42,22,20,49,0,0
429,18/05/2021,3,3,122,38,84,49,0,0
330,17/05/2021,3,3,116,45,71,49,0,0
28,10/05/2021,3,2,126,82,44,64,0,0
156,10/05/2021,3,5,143,90,53,52,0,0
738,12/05/2021,3,1,123,38,85,55,0,0
697,15/05/2021,3,1,108,47,61,49,0,0
504,22/05/2021,3,0,83,48,35,55,0,0
112,09/05/2021,3,2,82,17,65,49,0,0
664,13/05/2021,3,5,150,62,88,49,0,0
453,04/05/2021,3,1,137,53,84,55,0,0
425,10/05/2021,3,3,247,27,220,66,0,0
503,17/05/2021,3,0,184,25,159,49,0,0
470,01/05/2021,3,1,79,33,46,49,0,0
81,03/05/2021,3,1,59,4,55,49,0,0
911,15/05/2021,3,0,158,2,156,49,0,0
157,14/05/2021,3,2,81,33,48,49,0,0
115,24/05/2021,3,0,115,26,89,49,0,0
303,06/05/2021,3,1,64,38,26,64,0,0
802,03/05/2021,3,1,64,25,39,59,0,0
279,11/05/2021,3,0,57,20,37,55,0,0
622,11/05/2021,3,6,38,18,20,67,0,0
163,13/05/2021,3,1,61,40,21,64,0,0
390,19/05/2021,3,2,134,71,63,49,0,0
137,16/05/2021,3,24,122,8,114,49,0,0
631,04/05/2021,3,2,69,41,28,59,0,0
710,15/05/2021,3,0,20,15,5,49,0,0
540,05/05/2021,3,2,80,31,49,49,0,0
66,17/05/2021,3,0,152,34,118,49,0,0
873,11/05/2021,3,4,97,43,54,49,0,0
717,03/05/2021,3,3,190,9,181,55,0,0
547,25/05/2021,3,1,73,52,21,156,0,0
211,08/05/2021,3,4,56,38,18,49,0,0
704,05/05/2021,3,1,31,12,19,49,0,0
391,24/05/2021,3,0,76,55,21,49,0,0
233,19/05/2021,3,3,64,41,23,80,0,0
451,15/05/2021,3,2,81,36,45,66,0,0
307,09/05/2021,3,1,78,6,72,49,0,0
809,21/05/2021,3,4,97,67,30,52,0,0
15,14/05/2021,3,0,31,7,24,49,0,0
500,13/05/2021,3,5,74,12,62,49,0,0
647,16/05/2021,3,2,91,55,36,49,0,0
151,11/05/2021,3,6,70,37,33,55,0,0
776,18/05/2021,3,0,104,47,57,49,0,0
706,13/05/2021,3,1,73,24,49,49,0,0
544,03/05/2021,3,1,52,17,35,49,0,0
699,15/05/2021,3,0,62,43,19,52,0,0
316,17/05/2021,3,1,38,37,1,95,0,0
732,17/05/2021,3,0,60,34,26,52,0,0
383,07/05/2021,3,3,82,21,61,49,0,0
32,16/05/2021,3,1,104,26,78,49,0,0
317,02/05/2021,3,0,80,9,71,49,0,0
781,21/05/2021,3,3,80,77,3,75,0,0
438,01/05/2021,3,31,65,21,44,55,0,0
326,15/05/2021,3,4,77,19,58,49,0,0
429,19/05/2021,3,3,122,36,86,49,0,0
338,17/05/2021,3,0,400,106,294,49,0,0
238,10/05/2021,3,0,66,31,35,55,0,0
343,08/05/2021,3,1,61,8,53,49,0,0
88,12/05/2021,3,1,41,11,30,55,0,0
549,10/05/2021,3,0,61,0,61,NA,NA,NA
406,23/05/2021,3,1,38,24,14,82,0,0
408,10/05/2021,3,4,161,9,152,49,0,0
208,14/05/2021,3,0,60,9,51,49,0,0
453,06/05/2021,3,1,137,46,91,55,0,0
469,08/05/2021,3,4,192,33,159,66,0,0
599,13/05/2021,3,2,151,74,77,49,0,0
801,03/05/2021,3,7,160,25,135,49,0,0
771,03/05/2021,3,2,28,14,14,49,0,0
844,15/05/2021,3,0,61,3,58,55,0,0
166,14/05/2021,3,3,63,18,45,49,0,0
756,24/05/2021,3,0,106,106,0,NA,NA,NA
268,06/05/2021,3,1,77,57,20,67,0,0
802,04/05/2021,3,1,64,45,19,72,0,0
528,11/05/2021,3,0,119,62,57,59,0,0
760,11/05/2021,3,3,33,5,28,49,0,0
266,13/05/2021,3,0,61,49,12,67,0,0
739,19/05/2021,3,2,73,24,49,49,0,0
650,16/05/2021,3,5,123,15,108,49,0,0
91,04/05/2021,3,4,76,23,53,49,0,0
753,16/05/2021,3,3,124,23,101,49,0,0
312,07/05/2021,3,2,95,16,79,49,0,0
267,17/05/2021,3,2,81,49,32,49,0,0
787,12/05/2021,3,1,107,24,83,49,0,0
70,04/05/2021,3,2,37,18,19,52,0,0
713,26/05/2021,3,1,60,52,8,144,0,0
669,07/05/2021,3,0,87,7,80,49,0,0
221,03/05/2021,3,1,61,4,57,55,0,0
1,05/05/2021,3,3,97,68,29,60,0,0
369,19/05/2021,3,5,85,50,35,60,0,0
183,16/05/2021,3,1,79,30,49,49,0,0
627,10/05/2021,3,0,41,6,35,59,0,0
687,21/05/2021,3,2,85,50,35,55,0,0
15,15/05/2021,3,0,31,3,28,49,0,0
712,14/05/2021,3,1,84,13,71,49,0,0
832,16/05/2021,3,1,99,11,88,49,0,0
243,09/05/2021,3,1,126,32,94,49,0,0
332,17/05/2021,3,0,40,30,10,67,0,0
39,14/05/2021,3,1,60,26,34,49,0,0
544,04/05/2021,3,1,52,17,35,49,0,0
805,15/05/2021,3,0,113,19,94,49,0,0
559,16/05/2021,3,46,139,31,108,49,0,0
830,18/05/2021,3,0,66,60,6,80,0,0
534,07/05/2021,3,0,85,13,72,49,0,0
257,16/05/2021,3,2,42,14,28,49,0,0
26,04/05/2021,3,0,66,34,32,55,0,0
676,20/05/2021,3,5,110,79,31,52,0,0
403,03/05/2021,3,2,96,20,76,55,0,0
326,16/05/2021,3,4,77,13,64,49,0,0
120,17/05/2021,3,0,154,105,49,57,0,0
902,17/05/2021,3,2,124,66,58,49,0,0
28,08/05/2021,3,1,127,27,100,49,0,0
156,08/05/2021,3,4,144,29,115,49,0,0
64,12/05/2021,3,3,244,19,225,49,0,0
549,11/05/2021,3,0,61,0,61,NA,NA,NA
537,22/05/2021,3,3,99,97,2,124,0,0
535,10/05/2021,3,0,83,24,59,49,0,0
664,14/05/2021,3,5,150,34,116,49,0,0
453,12/05/2021,3,1,137,74,63,55,0,0
578,07/05/2021,3,2,56,8,48,49,0,0
599,15/05/2021,3,2,151,23,128,49,0,0
819,01/05/2021,3,28,52,52,0,NA,NA,NA
552,04/05/2021,3,14,170,32,138,49,0,0
844,14/05/2021,3,0,61,6,55,55,0,0
298,14/05/2021,3,2,227,145,82,49,0,0
68,03/05/2021,3,0,116,1,115,49,0,0
8,01/05/2021,3,1,39,38,1,77,0,0
195,05/05/2021,3,1,50,18,32,52,0,0
155,12/05/2021,3,0,93,40,53,55,0,0
464,10/05/2021,3,1,265,28,237,66,0,0
213,14/05/2021,3,3,145,102,43,52,0,0
433,20/05/2021,3,2,316,131,185,66,0,0
839,16/05/2021,3,3,152,28,124,49,0,0
737,04/05/2021,3,2,40,11,29,49,0,0
71,17/05/2021,3,1,61,31,30,49,0,0
853,07/05/2021,3,5,97,19,78,49,0,0
446,17/05/2021,3,5,128,49,79,49,0,0
234,11/05/2021,3,1,61,21,40,49,0,0
614,04/05/2021,3,2,80,55,25,57,0,0
168,24/05/2021,3,0,48,32,16,64,0,0
498,08/05/2021,3,0,87,11,76,49,0,0
221,04/05/2021,3,1,61,19,42,55,0,0
1,06/05/2021,3,2,98,42,56,55,0,0
583,19/05/2021,3,2,79,54,25,67,0,0
865,16/05/2021,3,1,84,7,77,49,0,0
270,10/05/2021,3,1,59,21,38,59,0,0
904,21/05/2021,3,4,270,28,242,95,0,0
192,16/05/2021,3,0,86,24,62,49,0,0
217,14/05/2021,3,1,40,8,32,49,0,0
838,16/05/2021,3,3,62,32,30,49,0,0
593,09/05/2021,3,3,78,42,36,49,0,0
648,17/05/2021,3,0,64,45,19,64,0,0
45,14/05/2021,3,1,155,5,150,49,0,0
544,05/05/2021,3,1,52,18,34,49,0,0
805,16/05/2021,3,0,113,24,89,49,0,0
357,16/05/2021,3,1,82,15,67,49,0,0
327,17/05/2021,3,16,52,43,9,72,0,0
681,08/05/2021,3,2,69,18,51,49,0,0
505,16/05/2021,3,0,84,8,76,49,0,0
317,05/05/2021,3,0,80,23,57,55,0,0
592,20/05/2021,3,1,83,78,5,80,0,0
438,03/05/2021,3,33,63,15,48,59,0,0
691,16/05/2021,3,2,30,14,16,49,0,0
177,17/05/2021,3,0,48,21,27,64,0,0
493,06/05/2021,3,2,33,10,23,49,0,0
187,08/05/2021,3,1,40,19,21,49,0,0
562,08/05/2021,3,3,65,9,56,49,0,0
520,12/05/2021,3,0,58,23,35,49,0,0
549,12/05/2021,3,0,61,0,61,NA,NA,NA
858,23/05/2021,3,0,81,66,15,67,0,0
899,10/05/2021,3,4,101,22,79,49,0,0
664,15/05/2021,3,5,150,27,123,49,0,0
457,09/05/2021,3,2,61,13,48,49,0,0
24,09/05/2021,3,2,82,29,53,49,0,0
405,16/05/2021,3,2,88,18,70,49,0,0
573,10/05/2021,3,1,56,24,32,49,0,0
771,04/05/2021,3,2,28,23,5,49,0,0
313,14/05/2021,3,0,31,13,18,49,0,0
125,15/05/2021,3,2,34,12,22,49,0,0
68,04/05/2021,3,0,116,5,111,49,0,0
682,04/05/2021,3,1,79,51,28,57,0,0
95,05/05/2021,3,3,85,46,39,55,0,0
528,12/05/2021,3,0,119,54,65,59,0,0
518,11/05/2021,3,1,16,12,4,60,0,0
51,13/05/2021,3,2,78,45,33,55,0,0
390,20/05/2021,3,2,134,96,38,49,0,0
872,16/05/2021,3,1,64,41,23,49,0,0
246,05/05/2021,3,3,109,53,56,49,0,0
89,17/05/2021,3,2,58,33,25,49,0,0
540,08/05/2021,3,2,80,11,69,49,0,0
491,17/05/2021,3,5,174,47,127,49,0,0
539,11/05/2021,3,2,95,22,73,49,0,0
780,05/05/2021,3,3,57,31,26,52,0,0
159,25/05/2021,3,0,77,66,11,63,0,0
806,08/05/2021,3,2,134,38,96,49,0,0
488,04/05/2021,3,1,65,46,19,60,0,0
823,01/05/2021,3,1,60,54,6,62,0,0
685,19/05/2021,3,2,138,92,46,64,0,0
228,16/05/2021,3,2,40,10,30,49,0,0
659,10/05/2021,3,1,42,14,28,55,0,0
652,22/05/2021,3,0,69,43,26,60,0,0
15,16/05/2021,3,0,31,3,28,49,0,0
566,15/05/2021,3,1,74,29,45,49,0,0
439,17/05/2021,3,4,87,18,69,49,0,0
817,09/05/2021,3,1,82,9,73,49,0,0
864,17/05/2021,3,1,84,37,47,55,0,0
102,16/05/2021,3,0,60,14,46,49,0,0
544,06/05/2021,3,1,52,13,39,49,0,0
84,16/05/2021,3,0,20,7,13,49,0,0
107,15/05/2021,3,30,59,33,26,49,0,0
2,18/05/2021,3,2,57,56,1,131,0,0
863,06/05/2021,3,11,84,23,61,49,0,0
709,16/05/2021,3,0,83,16,67,49,0,0
26,01/05/2021,3,0,66,5,61,49,0,0
629,20/05/2021,3,1,61,47,14,52,0,0
403,02/05/2021,3,2,96,32,64,49,0,0
310,15/05/2021,3,1,71,13,58,49,0,0
250,17/05/2021,3,0,115,80,35,59,0,0
304,05/05/2021,3,2,58,26,32,52,0,0
696,09/05/2021,3,1,88,16,72,49,0,0
156,09/05/2021,3,5,143,33,110,49,0,0
485,12/05/2021,3,0,65,23,42,55,0,0
549,09/05/2021,3,0,61,0,61,NA,NA,NA
175,22/05/2021,3,8,112,94,18,67,0,0
688,08/05/2021,3,8,111,37,74,49,0,0
346,15/05/2021,3,2,118,56,62,49,0,0
457,10/05/2021,3,2,61,23,38,49,0,0
580,10/05/2021,3,0,98,35,63,49,0,0
395,14/05/2021,3,1,71,17,54,49,0,0
849,10/05/2021,3,1,83,30,53,49,0,0
116,01/05/2021,3,0,61,28,33,49,0,0
313,15/05/2021,3,0,31,16,15,49,0,0
585,15/05/2021,3,2,58,37,21,49,0,0
68,05/05/2021,3,0,116,6,110,49,0,0
303,05/05/2021,3,1,64,40,24,72,0,0
473,05/05/2021,3,2,48,32,16,55,0,0
565,12/05/2021,3,0,62,48,14,82,0,0
464,11/05/2021,3,1,265,23,242,66,0,0
427,13/05/2021,3,5,305,8,297,66,0,0
816,20/05/2021,3,1,81,81,0,NA,NA,NA
569,17/05/2021,3,0,120,33,87,49,0,0
737,05/05/2021,3,2,40,16,24,49,0,0
100,17/05/2021,3,77,147,82,65,49,0,0
397,05/05/2021,3,0,75,42,33,60,0,0
281,17/05/2021,3,3,80,61,19,65,0,0
230,10/05/2021,3,0,80,16,64,49,0,0
70,06/05/2021,3,2,37,23,14,52,0,0
90,25/05/2021,3,0,78,49,29,67,0,0
57,06/05/2021,3,1,139,35,104,49,0,0
221,02/05/2021,3,0,62,5,57,49,0,0
878,03/05/2021,3,0,218,10,208,44,0,0
216,17/05/2021,3,1,57,32,25,49,0,0
475,14/05/2021,3,1,98,18,80,49,0,0
197,09/05/2021,3,0,118,13,105,49,0,0
119,22/05/2021,3,2,66,37,29,55,0,0
186,16/05/2021,3,1,57,17,40,49,0,0
79,13/05/2021,3,2,44,22,22,64,0,0
832,17/05/2021,3,1,99,30,69,49,0,0
131,10/05/2021,3,2,47,17,30,49,0,0
287,18/05/2021,3,1,122,68,54,49,0,0
134,13/05/2021,3,1,47,36,11,74,0,0
633,06/05/2021,3,1,49,11,38,49,0,0
294,16/05/2021,3,0,117,92,25,57,0,0
174,17/05/2021,3,2,26,6,20,55,0,0
158,18/05/2021,3,2,22,19,3,85,0,0
418,07/05/2021,3,2,114,33,81,49,0,0
831,16/05/2021,3,1,149,26,123,49,0,0
345,01/05/2021,3,0,101,27,74,49,0,0
207,20/05/2021,3,2,61,41,20,59,0,0
218,01/05/2021,3,3,75,48,27,49,0,0
612,16/05/2021,3,1,41,15,26,49,0,0
366,17/05/2021,3,0,80,64,16,72,0,0
493,05/05/2021,3,2,33,19,14,57,0,0
187,10/05/2021,3,1,40,8,32,49,0,0
201,10/05/2021,3,3,135,15,120,49,0,0
460,12/05/2021,3,8,101,21,80,49,0,0
656,09/05/2021,3,0,115,9,106,49,0,0
175,23/05/2021,3,11,109,26,83,49,0,0
688,09/05/2021,3,38,81,27,54,49,0,0
363,13/05/2021,3,4,95,74,21,64,0,0
663,10/05/2021,3,2,146,23,123,49,0,0
694,10/05/2021,3,4,105,37,68,49,0,0
605,15/05/2021,3,1,159,39,120,49,0,0
801,11/05/2021,3,7,160,58,102,49,0,0
552,01/05/2021,3,9,175,28,147,49,0,0
856,14/05/2021,3,1,119,14,105,49,0,0
646,15/05/2021,3,15,121,27,94,49,0,0
68,01/05/2021,3,0,116,5,111,49,0,0
447,05/05/2021,3,0,143,106,37,60,0,0
802,05/05/2021,3,1,64,47,17,80,0,0
788,10/05/2021,3,2,89,7,82,49,0,0
813,11/05/2021,3,1,129,63,66,55,0,0
875,13/05/2021,3,2,90,66,24,60,0,0
394,09/05/2021,3,4,64,1,63,49,0,0
650,15/05/2021,3,4,124,15,109,49,0,0
205,05/05/2021,3,1,125,28,97,49,0,0
753,17/05/2021,3,1,126,55,71,49,0,0
898,06/05/2021,3,0,100,29,71,49,0,0
522,17/05/2021,3,5,57,49,8,57,0,0
521,12/05/2021,3,1,54,26,28,55,0,0
11,03/05/2021,3,2,82,7,75,49,0,0
567,25/05/2021,3,0,61,52,9,74,0,0
152,06/05/2021,3,1,90,28,62,49,0,0
47,06/05/2021,3,2,55,38,17,72,0,0
1,03/05/2021,3,0,100,55,45,55,0,0
748,17/05/2021,3,7,137,72,65,49,0,0
917,15/05/2021,3,1,105,9,96,35,0,0
307,08/05/2021,3,1,78,4,74,49,0,0
792,22/05/2021,3,0,102,94,8,110,0,0
512,16/05/2021,3,2,60,9,51,49,0,0
114,13/05/2021,3,0,75,58,17,80,0,0
838,12/05/2021,3,3,62,62,0,NA,NA,NA
817,10/05/2021,3,1,82,36,46,49,0,0
413,17/05/2021,3,2,114,85,29,52,0,0
543,15/05/2021,3,1,64,11,53,49,0,0
349,06/05/2021,3,1,89,28,61,55,0,0
34,16/05/2021,3,4,84,16,68,49,0,0
107,16/05/2021,3,30,59,21,38,49,0,0
921,17/05/2021,3,11,164,48,116,45,0,0
658,07/05/2021,3,1,80,29,51,49,0,0
389,08/05/2021,3,2,124,9,115,49,0,0
240,02/05/2021,3,0,71,45,26,49,0,0
347,20/05/2021,3,12,50,48,2,63,0,0
403,01/05/2021,3,2,96,39,57,49,0,0
481,16/05/2021,3,0,56,5,51,49,0,0
767,17/05/2021,3,0,67,48,19,60,0,0
212,06/05/2021,3,1,77,67,10,85,0,0
276,10/05/2021,3,3,201,52,149,49,0,0
741,10/05/2021,3,0,70,34,36,49,0,0
723,12/05/2021,3,1,80,37,43,55,0,0
340,10/05/2021,3,0,134,4,130,49,0,0
586,23/05/2021,3,4,79,45,34,59,0,0
83,08/05/2021,3,38,130,45,85,49,0,0
214,13/05/2021,3,4,82,62,20,57,0,0
663,11/05/2021,3,2,146,27,119,49,0,0
517,07/05/2021,3,1,57,16,41,49,0,0
468,15/05/2021,3,1,95,20,75,49,0,0
849,09/05/2021,3,1,83,18,65,49,0,0
606,01/05/2021,3,1,45,9,36,49,0,0
55,15/05/2021,3,1,32,2,30,49,0,0
7,05/05/2021,3,5,98,41,57,55,0,0
9,03/05/2021,3,0,27,9,18,55,0,0
447,04/05/2021,3,0,143,105,38,60,0,0
473,04/05/2021,3,2,48,27,21,60,0,0
458,11/05/2021,3,3,178,75,103,49,0,0
292,09/05/2021,3,0,239,27,212,49,0,0
128,13/05/2021,3,1,20,11,9,59,0,0
529,08/05/2021,3,3,38,6,32,49,0,0
563,15/05/2021,3,3,67,6,61,49,0,0
737,03/05/2021,3,2,40,1,39,49,0,0
615,02/05/2021,3,1,70,9,61,49,0,0
898,07/05/2021,3,0,100,7,93,49,0,0
182,17/05/2021,3,2,78,60,18,52,0,0
873,12/05/2021,3,3,98,45,53,49,0,0
409,03/05/2021,3,3,104,31,73,49,0,0
159,26/05/2021,3,0,77,53,24,52,0,0
368,06/05/2021,3,1,84,23,61,49,0,0
488,05/05/2021,3,3,63,50,13,74,0,0
371,05/05/2021,3,0,36,22,14,85,0,0
511,18/05/2021,3,2,74,47,27,49,0,0
865,15/05/2021,3,1,84,4,80,49,0,0
554,08/05/2021,3,2,40,10,30,49,0,0
608,22/05/2021,3,9,131,95,36,60,0,0
436,15/05/2021,3,2,204,15,189,49,0,0
824,15/05/2021,3,0,339,5,334,55,0,0
598,12/05/2021,3,0,146,147,-1,NA,NA,NA
131,11/05/2021,3,2,47,20,27,49,0,0
607,17/05/2021,3,1,74,41,33,55,0,0
412,16/05/2021,3,8,93,9,84,49,0,0
556,02/05/2021,3,1,116,17,99,49,0,0
206,16/05/2021,3,16,197,37,160,55,0,0
38,15/05/2021,3,1,49,20,29,49,0,0
96,18/05/2021,3,14,55,44,11,70,0,0
863,08/05/2021,3,6,89,9,80,49,0,0
314,09/05/2021,3,2,67,20,47,49,0,0
148,04/05/2021,3,0,25,7,18,49,0,0
207,21/05/2021,3,2,61,46,15,67,0,0
715,01/05/2021,3,2,86,26,60,49,0,0
222,07/05/2021,3,1,76,13,63,49,0,0
108,18/05/2021,3,0,78,36,42,57,0,0
78,04/05/2021,3,0,44,36,8,89,0,0
777,10/05/2021,3,3,117,43,74,49,0,0
201,09/05/2021,3,2,136,8,128,49,0,0
101,12/05/2021,3,1,59,48,11,62,0,0
340,11/05/2021,3,0,134,5,129,49,0,0
558,22/05/2021,3,0,44,34,10,60,0,0
402,08/05/2021,3,1,154,26,128,49,0,0
483,14/05/2021,3,3,96,10,86,49,0,0
457,12/05/2021,3,2,61,28,33,49,0,0
580,07/05/2021,3,1,97,31,66,49,0,0
605,17/05/2021,3,1,159,47,112,49,0,0
896,11/05/2021,3,0,82,52,30,64,0,0
773,01/05/2021,3,1,73,17,56,49,0,0
301,15/05/2021,3,1,100,34,66,49,0,0
125,05/05/2021,3,2,34,25,9,64,0,0
9,02/05/2021,3,0,27,6,21,49,0,0
268,05/05/2021,3,2,76,64,12,82,0,0
309,03/05/2021,3,0,16,7,9,55,0,0
528,10/05/2021,3,0,119,64,55,49,0,0
754,11/05/2021,3,0,62,20,42,49,0,0
138,13/05/2021,3,2,96,49,47,49,0,0
433,08/05/2021,3,2,316,26,290,66,0,0
839,15/05/2021,3,4,151,44,107,49,0,0
572,04/05/2021,3,1,60,20,40,55,0,0
710,02/05/2021,3,1,19,1,18,49,0,0
397,06/05/2021,3,0,75,32,43,55,0,0
666,17/05/2021,3,2,64,50,14,57,0,0
49,10/05/2021,3,2,146,29,117,49,0,0
780,03/05/2021,3,3,57,12,45,49,0,0
229,18/05/2021,3,4,52,52,0,NA,NA,NA
437,06/05/2021,3,2,163,64,99,49,0,0
759,02/05/2021,3,2,85,23,62,49,0,0
878,06/05/2021,3,0,218,13,205,44,0,0
511,19/05/2021,3,1,75,41,34,49,0,0
594,16/05/2021,3,43,64,42,22,49,0,0
659,08/05/2021,3,2,41,9,32,49,0,0
133,21/05/2021,3,2,62,14,48,55,0,0
186,15/05/2021,3,1,57,38,19,52,0,0
333,14/05/2021,3,1,56,47,9,82,0,0
714,12/05/2021,3,0,59,51,8,82,0,0
342,09/05/2021,3,0,114,28,86,49,0,0
589,18/05/2021,3,4,139,110,29,55,0,0
39,13/05/2021,3,1,60,26,34,55,0,0
384,05/05/2021,3,0,101,75,26,67,0,0
886,16/05/2021,3,0,152,54,98,49,0,0
316,15/05/2021,3,1,38,12,26,49,0,0
386,18/05/2021,3,3,82,51,31,52,0,0
235,06/05/2021,3,6,151,19,132,49,0,0
257,07/05/2021,3,1,43,14,29,49,0,0
812,02/05/2021,3,2,135,13,122,49,0,0
779,21/05/2021,3,0,104,90,14,79,0,0
603,01/05/2021,3,5,79,40,39,49,0,0
52,07/05/2021,3,11,131,35,96,49,0,0
767,19/05/2021,3,0,67,48,19,60,0,0
78,06/05/2021,3,0,44,26,18,64,0,0
276,08/05/2021,3,0,204,25,179,49,0,0
179,08/05/2021,3,1,91,10,81,49,0,0
803,12/05/2021,3,1,68,61,7,107,0,0
499,11/05/2021,3,0,31,13,18,49,0,0
883,23/05/2021,3,6,98,10,88,45,0,0
83,09/05/2021,3,39,129,32,97,49,0,0
363,15/05/2021,3,4,95,69,26,64,0,0
840,07/05/2021,3,1,311,32,279,49,0,0
651,09/05/2021,3,1,77,5,72,49,0,0
36,13/05/2021,3,1,62,21,41,49,0,0
470,10/05/2021,3,1,79,76,3,59,0,0
331,02/05/2021,3,22,72,25,47,49,0,0
814,15/05/2021,3,1,67,30,37,49,0,0
774,05/05/2021,3,6,99,50,49,49,0,0
344,02/05/2021,3,0,65,12,53,49,0,0
471,05/05/2021,3,7,113,63,50,60,0,0
37,03/05/2021,3,4,77,10,67,49,0,0
735,11/05/2021,3,0,29,4,25,49,0,0
204,11/05/2021,3,0,64,1,63,49,0,0
252,13/05/2021,3,3,261,96,165,49,0,0
142,08/05/2021,3,1,61,18,43,49,0,0
563,17/05/2021,3,2,68,36,32,49,0,0
572,05/05/2021,3,1,60,25,35,55,0,0
852,01/05/2021,3,1,79,80,-1,NA,NA,NA
348,05/05/2021,3,50,90,85,5,123,0,0
707,17/05/2021,3,1,39,32,7,80,0,0
325,10/05/2021,3,0,45,20,25,49,0,0
780,04/05/2021,3,3,57,33,24,49,0,0
713,18/05/2021,3,1,60,60,0,NA,NA,NA
669,06/05/2021,3,0,87,21,66,49,0,0
826,02/05/2021,3,2,96,21,75,49,0,0
1,02/05/2021,3,0,100,45,55,49,0,0
748,19/05/2021,3,7,137,67,70,49,0,0
262,14/05/2021,3,2,49,21,28,49,0,0
919,08/05/2021,3,0,123,16,107,49,0,0
608,21/05/2021,3,9,131,68,63,55,0,0
654,16/05/2021,3,6,53,4,49,66,0,0
293,15/05/2021,3,1,59,44,15,52,0,0
506,12/05/2021,3,0,195,10,185,49,0,0
259,11/05/2021,3,0,60,42,18,64,0,0
42,17/05/2021,3,2,97,67,30,52,0,0
341,13/05/2021,3,2,112,82,30,60,0,0
323,04/05/2021,3,0,31,17,14,67,0,0
294,15/05/2021,3,0,117,96,21,52,0,0
38,16/05/2021,3,1,49,11,38,49,0,0
386,17/05/2021,3,3,82,42,40,49,0,0
418,06/05/2021,3,2,114,32,82,49,0,0
277,07/05/2021,3,3,69,9,60,49,0,0
812,03/05/2021,3,2,135,11,124,49,0,0
130,20/05/2021,3,3,78,64,14,62,0,0
715,02/05/2021,3,2,86,25,61,49,0,0
612,08/05/2021,3,2,40,9,31,49,0,0
623,17/05/2021,3,0,78,34,44,49,0,0
117,04/05/2021,3,0,94,42,52,55,0,0
189,09/05/2021,3,0,165,41,124,49,0,0
494,08/05/2021,3,1,138,10,128,49,0,0
88,13/05/2021,3,1,41,13,28,55,0,0
340,12/05/2021,3,0,134,13,121,49,0,0
889,12/05/2021,3,1,123,7,116,45,0,0
402,09/05/2021,3,0,155,18,137,49,0,0
208,13/05/2021,3,0,60,26,34,55,0,0
635,09/05/2021,3,1,87,17,70,49,0,0
578,10/05/2021,3,1,57,18,39,49,0,0
395,13/05/2021,3,1,71,32,39,49,0,0
896,10/05/2021,3,0,82,43,39,59,0,0
773,02/05/2021,3,1,73,12,61,49,0,0
550,14/05/2021,3,3,109,6,103,49,0,0
646,05/05/2021,3,12,124,34,90,49,0,0
344,04/05/2021,3,0,65,22,43,49,0,0
22,03/05/2021,3,0,64,9,55,55,0,0
95,03/05/2021,3,2,86,20,66,49,0,0
237,12/05/2021,3,4,117,29,88,49,0,0
72,11/05/2021,3,2,58,52,6,77,0,0
836,13/05/2021,3,3,98,29,69,49,0,0
173,08/05/2021,3,3,68,12,56,49,0,0
430,15/05/2021,3,2,87,27,60,55,0,0
631,03/05/2021,3,1,70,7,63,59,0,0
745,05/05/2021,3,3,102,50,52,55,0,0
853,08/05/2021,3,5,97,17,80,49,0,0
790,17/05/2021,3,1,98,52,46,66,0,0
118,11/05/2021,3,3,56,21,35,49,0,0
780,06/05/2021,3,3,57,41,16,57,0,0
561,18/05/2021,3,1,59,42,17,74,0,0
57,07/05/2021,3,1,139,28,111,49,0,0
154,03/05/2021,3,1,103,16,87,49,0,0
265,02/05/2021,3,1,56,20,36,49,0,0
487,17/05/2021,3,0,39,21,18,49,0,0
451,16/05/2021,3,2,81,31,50,66,0,0
372,09/05/2021,3,3,89,35,54,49,0,0
448,21/05/2021,3,1,152,60,92,100,0,0
162,14/05/2021,3,0,122,29,93,49,0,0
783,13/05/2021,3,1,79,42,37,59,0,0
484,13/05/2021,3,0,40,24,16,55,0,0
184,09/05/2021,3,0,51,20,31,49,0,0
361,17/05/2021,3,38,27,22,5,80,0,0
102,13/05/2021,3,0,60,16,44,55,0,0
215,05/05/2021,3,0,46,33,13,64,0,0
857,15/05/2021,3,1,209,121,88,55,0,0
821,16/05/2021,3,1,78,25,53,49,0,0
203,17/05/2021,3,0,40,21,19,49,0,0
60,07/05/2021,3,0,57,9,48,49,0,0
831,07/05/2021,3,1,149,12,137,49,0,0
146,04/05/2021,3,2,39,38,1,89,0,0
254,20/05/2021,3,1,77,60,17,57,0,0
764,03/05/2021,3,2,67,12,55,49,0,0
227,07/05/2021,3,2,42,11,31,49,0,0
392,17/05/2021,3,0,176,78,98,49,0,0
78,05/05/2021,3,0,44,37,7,59,0,0
276,09/05/2021,3,0,204,35,169,49,0,0
445,09/05/2021,3,1,168,14,154,49,0,0
738,13/05/2021,3,1,123,44,79,55,0,0
501,12/05/2021,3,9,224,9,215,49,0,0
175,11/05/2021,3,1,119,41,78,49,0,0
479,09/05/2021,3,1,54,12,42,49,0,0
21,13/05/2021,3,0,60,12,48,49,0,0
140,13/05/2021,3,1,169,77,92,49,0,0
578,11/05/2021,3,1,57,16,41,49,0,0
395,15/05/2021,3,1,71,25,46,49,0,0
379,06/05/2021,3,4,283,83,200,66,0,0
552,03/05/2021,3,11,173,14,159,49,0,0
550,15/05/2021,3,2,110,15,95,49,0,0
105,05/05/2021,3,1,74,56,18,80,0,0
68,02/05/2021,3,0,116,1,115,49,0,0
447,03/05/2021,3,0,143,53,90,55,0,0
443,04/05/2021,3,4,86,36,50,49,0,0
458,12/05/2021,3,3,178,74,104,49,0,0
72,10/05/2021,3,3,57,47,10,57,0,0
836,14/05/2021,3,4,97,24,73,49,0,0
12,08/05/2021,3,2,41,9,32,49,0,0
430,17/05/2021,3,3,86,53,33,55,0,0
435,04/05/2021,3,66,54,30,24,52,0,0
370,05/05/2021,3,1,39,12,27,59,0,0
768,06/05/2021,3,2,85,39,46,49,0,0
239,17/05/2021,3,0,40,34,6,80,0,0
539,12/05/2021,3,2,95,22,73,49,0,0
638,04/05/2021,3,0,101,52,49,59,0,0
736,18/05/2021,3,1,104,31,73,49,0,0
437,07/05/2021,3,2,163,40,123,49,0,0
242,03/05/2021,3,3,135,38,97,49,0,0
391,02/05/2021,3,2,74,10,64,49,0,0
634,17/05/2021,3,0,20,13,7,90,0,0
193,14/05/2021,3,2,106,10,96,49,0,0
376,09/05/2021,3,1,63,20,43,49,0,0
444,22/05/2021,3,4,115,94,21,52,0,0
393,14/05/2021,3,1,59,10,49,49,0,0
43,13/05/2021,3,2,71,25,46,55,0,0
647,12/05/2021,3,3,90,68,22,57,0,0
259,09/05/2021,3,0,60,19,41,49,0,0
589,17/05/2021,3,4,139,101,38,57,0,0
199,16/05/2021,3,0,82,48,34,49,0,0
323,05/05/2021,3,0,31,18,13,60,0,0
220,15/05/2021,3,7,96,20,76,49,0,0
407,16/05/2021,3,1,40,4,36,49,0,0
410,17/05/2021,3,0,56,23,33,49,0,0
235,07/05/2021,3,6,151,13,138,49,0,0
257,08/05/2021,3,1,43,9,34,49,0,0
146,05/05/2021,3,2,39,36,3,93,0,0
779,20/05/2021,3,0,104,54,50,55,0,0
218,02/05/2021,3,3,75,31,44,49,0,0
691,08/05/2021,3,1,31,8,23,49,0,0
392,18/05/2021,3,0,176,74,102,49,0,0
210,05/05/2021,3,3,99,54,45,52,0,0
570,10/05/2021,3,0,149,56,93,49,0,0
494,09/05/2021,3,1,138,7,131,49,0,0
172,12/05/2021,3,2,83,42,41,55,0,0
733,12/05/2021,3,0,100,17,83,49,0,0
69,12/05/2021,3,1,59,36,23,52,0,0
402,10/05/2021,3,0,155,46,109,49,0,0
31,13/05/2021,3,1,62,21,41,49,0,0
140,14/05/2021,3,1,169,28,141,49,0,0
260,07/05/2021,3,0,120,28,92,49,0,0
605,13/05/2021,3,1,159,56,103,49,0,0
379,08/05/2021,3,4,283,57,226,66,0,0
771,01/05/2021,3,2,28,16,12,49,0,0
698,15/05/2021,3,2,114,59,55,55,0,0
123,05/05/2021,3,0,95,13,82,49,0,0
662,04/05/2021,3,17,90,26,64,55,0,0
447,06/05/2021,3,0,143,93,50,55,0,0
195,03/05/2021,3,1,50,5,45,49,0,0
628,12/05/2021,3,4,55,40,15,80,0,0
202,10/05/2021,3,0,76,53,23,64,0,0
51,15/05/2021,3,2,78,16,62,49,0,0
394,08/05/2021,3,4,64,9,55,49,0,0
575,15/05/2021,3,1,49,30,19,49,0,0
435,05/05/2021,3,67,53,38,15,52,0,0
171,05/05/2021,3,2,47,33,14,52,0,0
540,07/05/2021,3,2,80,19,61,49,0,0
401,17/05/2021,3,0,79,63,16,67,0,0
284,10/05/2021,3,1,25,16,9,52,0,0
638,05/05/2021,3,0,101,49,52,59,0,0
713,17/05/2021,3,1,60,58,2,91,0,0
560,07/05/2021,3,0,80,21,59,49,0,0
154,05/05/2021,3,1,103,30,73,49,0,0
701,03/05/2021,3,2,60,7,53,49,0,0
440,17/05/2021,3,0,265,31,234,66,0,0
594,15/05/2021,3,43,64,36,28,49,0,0
665,09/05/2021,3,1,105,23,82,49,0,0
507,22/05/2021,3,4,196,160,36,60,0,0
474,14/05/2021,3,0,112,24,88,49,0,0
465,13/05/2021,3,5,262,96,166,55,0,0
362,12/05/2021,3,4,116,93,23,85,0,0
365,11/05/2021,3,0,68,66,2,85,0,0
17,17/05/2021,3,1,93,75,18,67,0,0
45,13/05/2021,3,1,155,25,130,49,0,0
215,06/05/2021,3,0,46,29,17,64,0,0
220,11/05/2021,3,28,75,20,55,49,0,0
407,07/05/2021,3,1,40,2,38,49,0,0
486,17/05/2021,3,0,124,27,97,49,0,0
632,07/05/2021,3,0,82,10,72,49,0,0
176,09/05/2021,3,4,96,14,82,49,0,0
513,05/05/2021,3,2,75,24,51,49,0,0
335,20/05/2021,3,1,85,45,40,49,0,0
218,03/05/2021,3,1,77,29,48,49,0,0
222,09/05/2021,3,1,76,6,70,49,0,0
767,18/05/2021,3,0,67,52,15,74,0,0
902,04/05/2021,3,2,124,34,90,49,0,0
305,10/05/2021,3,2,57,12,45,49,0,0
828,09/05/2021,3,1,74,12,62,49,0,0
334,12/05/2021,3,0,58,28,30,55,0,0
601,12/05/2021,3,4,64,30,34,52,0,0
889,10/05/2021,3,1,123,10,113,45,0,0
688,10/05/2021,3,34,85,42,43,49,0,0
845,13/05/2021,3,1,119,58,61,49,0,0
663,14/05/2021,3,1,147,18,129,49,0,0
651,11/05/2021,3,1,77,14,63,49,0,0
405,14/05/2021,3,1,89,16,73,49,0,0
847,06/05/2021,3,8,189,60,129,35,0,0
773,04/05/2021,3,1,73,55,18,80,0,0
98,14/05/2021,3,1,94,13,81,49,0,0
7,06/05/2021,3,5,98,39,59,55,0,0
135,05/05/2021,3,3,63,38,25,74,0,0
268,03/05/2021,3,2,76,28,48,55,0,0
37,04/05/2021,3,4,77,21,56,49,0,0
54,10/05/2021,3,1,60,40,20,55,0,0
622,10/05/2021,3,6,38,29,9,67,0,0
266,15/05/2021,3,0,61,34,27,49,0,0
390,08/05/2021,3,2,134,13,121,49,0,0
538,15/05/2021,3,1,43,5,38,49,0,0
631,05/05/2021,3,2,69,40,29,59,0,0
89,03/05/2021,3,3,57,8,49,49,0,0
768,08/05/2021,3,2,85,17,68,49,0,0
784,16/05/2021,3,2,47,18,29,49,0,0
258,10/05/2021,3,1,142,73,69,55,0,0
614,06/05/2021,3,2,80,52,28,52,0,0
721,17/05/2021,3,29,111,101,10,115,0,0
669,08/05/2021,3,0,87,10,77,49,0,0
759,05/05/2021,3,2,85,38,47,49,0,0
391,05/05/2021,3,1,75,32,43,49,0,0
263,17/05/2021,3,0,66,18,48,49,0,0
183,15/05/2021,3,1,79,22,57,49,0,0
674,09/05/2021,3,1,97,8,89,49,0,0
442,22/05/2021,3,8,150,118,32,60,0,0
597,14/05/2021,3,4,97,20,77,49,0,0
311,13/05/2021,3,0,97,46,51,55,0,0
362,13/05/2021,3,4,116,87,29,72,0,0
365,09/05/2021,3,0,68,11,57,55,0,0
147,17/05/2021,3,1,79,54,25,52,0,0
134,14/05/2021,3,1,47,23,24,49,0,0
75,04/05/2021,3,0,81,40,41,49,0,0
385,11/05/2021,3,2,61,15,46,59,0,0
407,08/05/2021,3,1,40,2,38,49,0,0
96,17/05/2021,3,14,55,41,14,62,0,0
681,07/05/2021,3,2,69,19,50,49,0,0
121,08/05/2021,3,0,110,65,45,49,0,0
26,03/05/2021,3,10,56,4,52,55,0,0
515,20/05/2021,3,7,105,50,55,49,0,0
509,03/05/2021,3,1,111,15,96,49,0,0
772,09/05/2021,3,1,56,10,46,49,0,0
177,18/05/2021,3,0,48,29,19,59,0,0
493,04/05/2021,3,2,33,18,15,49,0,0
785,10/05/2021,3,2,108,47,61,49,0,0
343,10/05/2021,3,1,61,32,29,49,0,0
803,13/05/2021,3,0,69,55,14,62,0,0
697,12/05/2021,3,1,108,27,81,55,0,0
586,11/05/2021,3,4,79,63,16,80,0,0
104,08/05/2021,3,1,61,29,32,49,0,0
346,14/05/2021,3,2,118,59,59,49,0,0
140,15/05/2021,3,1,169,39,130,49,0,0
694,08/05/2021,3,6,103,8,95,49,0,0
605,14/05/2021,3,1,159,22,137,49,0,0
847,11/05/2021,3,4,193,70,123,35,0,0
351,01/05/2021,3,1,65,29,36,49,0,0
716,14/05/2021,3,0,104,27,77,49,0,0
157,06/05/2021,3,3,80,39,41,60,0,0
662,05/05/2021,3,3,104,25,79,55,0,0
800,02/05/2021,3,2,55,8,47,49,0,0
244,04/05/2021,3,0,200,91,109,49,0,0
318,11/05/2021,3,0,59,42,17,85,0,0
139,11/05/2021,3,2,57,16,41,52,0,0
51,06/05/2021,3,2,78,20,58,55,0,0
142,09/05/2021,3,1,61,43,18,52,0,0
373,17/05/2021,3,1,102,50,52,55,0,0
205,03/05/2021,3,1,125,17,108,49,0,0
71,01/05/2021,3,2,60,11,49,49,0,0
898,05/05/2021,3,0,100,41,59,49,0,0
66,11/05/2021,3,1,151,3,148,49,0,0
734,12/05/2021,3,3,58,55,3,123,0,0
711,04/05/2021,3,1,88,53,35,64,0,0
547,18/05/2021,3,0,74,64,10,80,0,0
152,07/05/2021,3,1,90,22,68,49,0,0
242,04/05/2021,3,3,135,65,70,49,0,0
1,12/05/2021,3,1,99,62,37,60,0,0
624,17/05/2021,3,0,79,49,30,52,0,0
917,14/05/2021,3,2,104,9,95,35,0,0
376,10/05/2021,3,1,63,42,21,60,0,0
581,22/05/2021,3,48,177,175,2,115,0,0
251,14/05/2021,3,0,124,13,111,49,0,0
465,15/05/2021,3,21,246,40,206,55,0,0
110,12/05/2021,3,1,86,59,27,60,0,0
271,09/05/2021,3,0,70,4,66,49,0,0
198,17/05/2021,3,1,134,108,26,72,0,0
134,16/05/2021,3,1,47,11,36,49,0,0
75,06/05/2021,3,0,81,30,51,49,0,0
385,12/05/2021,3,2,61,13,48,59,0,0
174,06/05/2021,3,2,26,2,24,55,0,0
158,17/05/2021,3,2,22,19,3,88,0,0
383,08/05/2021,3,3,82,28,54,49,0,0
709,09/05/2021,3,0,83,13,70,49,0,0
576,03/05/2021,3,1,57,4,53,55,0,0
282,21/05/2021,3,29,672,102,570,49,0,0
438,02/05/2021,3,31,65,19,46,67,0,0
481,09/05/2021,3,0,56,21,35,49,0,0
588,18/05/2021,3,0,59,38,21,64,0,0
304,06/05/2021,3,2,58,25,33,49,0,0
380,10/05/2021,3,2,158,45,113,49,0,0
494,10/05/2021,3,1,138,37,101,49,0,0
19,12/05/2021,3,2,92,34,58,49,0,0
636,11/05/2021,3,0,120,120,0,NA,NA,NA
883,11/05/2021,3,6,98,23,75,45,0,0
272,10/05/2021,3,1,126,45,81,49,0,0
845,14/05/2021,3,1,119,21,98,49,0,0
663,18/05/2021,3,1,147,32,115,49,0,0
580,09/05/2021,3,5,93,10,83,49,0,0
13,15/05/2021,3,1,80,21,59,49,0,0
847,10/05/2021,3,4,193,66,127,35,0,0
606,02/05/2021,3,1,45,10,35,49,0,0
808,14/05/2021,3,10,158,57,101,49,0,0
157,05/05/2021,3,3,80,51,29,72,0,0
135,01/05/2021,3,4,62,23,39,49,0,0
268,02/05/2021,3,2,76,22,54,49,0,0
244,03/05/2021,3,0,200,54,146,49,0,0
279,12/05/2021,3,0,57,19,38,55,0,0
518,10/05/2021,3,1,16,11,5,67,0,0
128,07/05/2021,3,1,20,4,16,49,0,0
739,09/05/2021,3,2,73,4,69,49,0,0
373,16/05/2021,3,1,102,21,81,49,0,0
435,03/05/2021,3,66,54,19,35,49,0,0
615,01/05/2021,3,1,70,17,53,49,0,0
300,05/05/2021,3,0,210,93,117,49,0,0
666,09/05/2021,3,3,63,12,51,49,0,0
325,11/05/2021,3,0,45,31,14,55,0,0
170,04/05/2021,3,2,103,79,24,74,0,0
567,18/05/2021,3,0,61,57,4,79,0,0
211,07/05/2021,3,4,56,18,38,49,0,0
154,06/05/2021,3,4,100,31,69,49,0,0
111,08/05/2021,3,0,60,21,39,49,0,0
841,19/05/2021,3,0,182,34,148,55,0,0
617,16/05/2021,3,2,42,4,38,49,0,0
372,10/05/2021,3,4,88,77,11,72,0,0
792,21/05/2021,3,0,102,80,22,89,0,0
269,14/05/2021,3,1,79,10,69,49,0,0
293,13/05/2021,3,1,59,30,29,49,0,0
584,13/05/2021,3,1,96,47,49,55,0,0
342,11/05/2021,3,0,114,50,64,49,0,0
198,18/05/2021,3,1,134,124,10,80,0,0
543,16/05/2021,3,1,64,13,51,49,0,0
75,02/05/2021,3,0,81,14,67,49,0,0
76,12/05/2021,3,1,92,42,50,49,0,0
5,06/05/2021,3,69,20,20,0,NA,NA,NA
531,18/05/2021,3,2,57,40,17,57,0,0
418,08/05/2021,3,1,115,22,93,49,0,0
176,07/05/2021,3,4,96,14,82,49,0,0
63,01/05/2021,3,1,63,9,54,49,0,0
867,11/05/2021,3,1,59,59,0,NA,NA,NA
764,01/05/2021,3,2,67,8,59,49,0,0
742,07/05/2021,3,1,73,6,67,49,0,0
588,17/05/2021,3,0,59,34,25,60,0,0
210,06/05/2021,3,3,99,57,42,49,0,0
380,08/05/2021,3,2,158,29,129,49,0,0
562,10/05/2021,3,1,67,32,35,49,0,0
64,13/05/2021,3,3,244,9,235,49,0,0
636,12/05/2021,3,2,118,119,-1,NA,NA,NA
702,11/05/2021,3,1,49,49,0,NA,NA,NA
479,08/05/2021,3,1,54,15,39,49,0,0
618,15/05/2021,3,12,139,23,116,49,0,0
840,18/05/2021,3,1,311,82,229,49,0,0
694,09/05/2021,3,6,103,8,95,49,0,0
468,16/05/2021,3,1,95,18,77,49,0,0
801,06/05/2021,3,7,160,24,136,49,0,0
771,02/05/2021,3,2,28,10,18,49,0,0
508,15/05/2021,3,22,58,15,43,49,0,0
105,06/05/2021,3,1,74,45,29,59,0,0
542,01/05/2021,3,4,71,52,19,49,0,0
447,02/05/2021,3,0,143,34,109,49,0,0
443,05/05/2021,3,4,86,37,49,49,0,0
155,10/05/2021,3,0,93,31,62,49,0,0
464,09/05/2021,3,1,265,17,248,66,0,0
128,06/05/2021,3,1,20,11,9,55,0,0
527,09/05/2021,3,8,53,13,40,49,0,0
113,17/05/2021,3,1,31,13,18,49,0,0
205,04/05/2021,3,1,125,38,87,49,0,0
370,03/05/2021,3,1,39,7,32,49,0,0
833,05/05/2021,3,0,83,46,37,49,0,0
784,09/05/2021,3,4,45,5,40,49,0,0
258,11/05/2021,3,0,143,79,64,60,0,0
409,04/05/2021,3,1,106,62,44,52,0,0
90,18/05/2021,3,0,78,77,1,170,0,0
368,07/05/2021,3,1,84,16,68,49,0,0
759,06/05/2021,3,2,85,35,50,49,0,0
514,08/05/2021,3,6,228,16,212,49,0,0
841,17/05/2021,3,0,182,54,128,55,0,0
865,14/05/2021,3,1,84,9,75,49,0,0
665,10/05/2021,3,1,105,42,63,55,0,0
591,22/05/2021,3,0,68,51,17,67,0,0
269,15/05/2021,3,2,78,8,70,49,0,0
783,14/05/2021,3,2,78,25,53,49,0,0
728,12/05/2021,3,1,46,28,18,52,0,0
689,11/05/2021,3,0,130,29,101,49,0,0
287,17/05/2021,3,1,122,63,59,49,0,0
582,13/05/2021,3,3,50,17,33,55,0,0
556,03/05/2021,3,1,116,13,103,49,0,0
84,12/05/2021,3,0,20,19,1,147,0,0
174,07/05/2021,3,2,26,9,17,49,0,0
791,18/05/2021,3,33,95,69,26,52,0,0
658,06/05/2021,3,1,80,30,50,55,0,0
32,08/05/2021,3,1,104,26,78,49,0,0
240,05/05/2021,3,1,70,43,27,49,0,0
207,11/05/2021,3,2,61,28,33,64,0,0
308,03/05/2021,3,2,46,2,44,49,0,0
127,09/05/2021,3,1,59,5,54,49,0,0
120,18/05/2021,3,0,154,110,44,80,0,0
807,05/05/2021,3,3,97,39,58,55,0,0
785,08/05/2021,3,2,108,11,97,49,0,0
828,10/05/2021,3,1,74,16,58,49,0,0
101,13/05/2021,3,1,59,27,32,49,0,0
697,11/05/2021,3,1,108,25,83,55,0,0
537,12/05/2021,3,3,99,99,0,NA,NA,NA
804,08/05/2021,3,3,142,39,103,49,0,0
483,15/05/2021,3,3,96,13,83,49,0,0
680,11/05/2021,3,3,77,18,59,49,0,0
36,17/05/2021,3,1,62,30,32,49,0,0
896,06/05/2021,3,0,82,28,54,49,0,0
388,03/05/2021,3,1,59,5,54,49,0,0
724,15/05/2021,3,3,83,62,21,60,0,0
298,05/05/2021,3,2,227,57,170,49,0,0
616,02/05/2021,3,3,72,11,61,49,0,0
471,02/05/2021,3,7,113,30,83,49,0,0
443,08/05/2021,3,6,84,37,47,49,0,0
458,10/05/2021,3,3,178,78,100,49,0,0
202,11/05/2021,3,1,75,60,15,72,0,0
51,05/05/2021,3,2,78,33,45,55,0,0
209,09/05/2021,3,1,113,33,80,55,0,0
758,15/05/2021,3,1,72,27,45,49,0,0
374,03/05/2021,3,0,56,9,47,49,0,0
710,03/05/2021,3,1,19,3,16,55,0,0
397,07/05/2021,3,0,75,16,59,49,0,0
66,10/05/2021,3,1,151,4,147,49,0,0
258,12/05/2021,3,0,143,62,81,55,0,0
614,05/05/2021,3,2,80,60,20,62,0,0
90,17/05/2021,3,0,78,78,0,NA,NA,NA
525,08/05/2021,3,3,72,23,49,49,0,0
154,02/05/2021,3,1,103,17,86,49,0,0
660,08/05/2021,3,6,180,21,159,49,0,0
487,18/05/2021,3,0,39,17,22,49,0,0
106,15/05/2021,3,1,30,8,22,49,0,0
197,08/05/2021,3,0,118,16,102,49,0,0
677,22/05/2021,3,0,40,37,3,55,0,0
393,15/05/2021,3,1,59,29,30,49,0,0
907,13/05/2021,3,2,78,46,32,49,0,0
439,12/05/2021,3,5,86,18,68,49,0,0
778,11/05/2021,3,2,79,73,6,82,0,0
198,07/05/2021,3,1,134,18,116,49,0,0
39,16/05/2021,3,1,60,22,38,49,0,0
77,04/05/2021,3,1,102,25,77,49,0,0
285,11/05/2021,3,0,80,35,45,64,0,0
174,08/05/2021,3,2,26,12,14,49,0,0
921,18/05/2021,3,10,165,49,116,45,0,0
681,06/05/2021,3,2,69,34,35,55,0,0
837,08/05/2021,3,6,320,21,299,66,0,0
513,01/05/2021,3,2,75,16,59,49,0,0
347,11/05/2021,3,22,40,30,10,57,0,0
308,02/05/2021,3,1,47,4,43,49,0,0
326,07/05/2021,3,4,77,12,65,49,0,0
250,18/05/2021,3,0,115,78,37,64,0,0
330,05/05/2021,3,2,117,38,79,55,0,0
380,09/05/2021,3,2,158,15,143,49,0,0
445,08/05/2021,3,1,168,9,159,49,0,0
815,12/05/2021,3,12,117,48,69,49,0,0
610,11/05/2021,3,1,66,38,28,60,0,0
558,11/05/2021,3,0,44,11,33,55,0,0
112,10/05/2021,3,0,84,40,44,49,0,0
31,14/05/2021,3,1,62,14,48,49,0,0
578,09/05/2021,3,1,57,8,49,49,0,0
336,02/05/2021,3,1,73,33,40,49,0,0
819,07/05/2021,3,0,80,43,37,49,0,0
81,04/05/2021,3,1,59,9,50,49,0,0
724,14/05/2021,3,3,83,56,27,60,0,0
166,06/05/2021,3,3,63,25,38,49,0,0
129,04/05/2021,3,8,192,32,160,49,0,0
682,03/05/2021,3,1,79,32,47,49,0,0
473,08/05/2021,3,2,48,18,30,49,0,0
786,10/05/2021,3,1,61,8,53,49,0,0
782,11/05/2021,3,0,20,18,2,189,0,0
417,06/05/2021,3,2,101,35,66,55,0,0
433,09/05/2021,3,2,316,41,275,66,0,0
569,15/05/2021,3,0,120,29,91,49,0,0
625,03/05/2021,3,1,160,9,151,49,0,0
710,04/05/2021,3,0,20,10,10,60,0,0
833,08/05/2021,3,0,83,23,60,49,0,0
784,11/05/2021,3,2,47,19,28,49,0,0
539,10/05/2021,3,2,95,22,73,49,0,0
409,05/05/2021,3,1,106,58,48,52,0,0
547,17/05/2021,3,0,74,74,0,NA,NA,NA
560,06/05/2021,3,0,80,43,37,49,0,0
704,06/05/2021,3,1,31,13,18,49,0,0
823,09/05/2021,3,1,60,18,42,49,0,0
624,18/05/2021,3,0,79,44,35,49,0,0
475,15/05/2021,3,1,98,31,67,49,0,0
197,10/05/2021,3,0,118,22,96,49,0,0
442,21/05/2021,3,8,150,98,52,49,0,0
253,16/05/2021,3,1,57,16,41,49,0,0
293,14/05/2021,3,1,59,35,24,49,0,0
574,13/05/2021,3,1,86,16,70,49,0,0
817,11/05/2021,3,1,82,31,51,55,0,0
589,08/05/2021,3,3,140,23,117,49,0,0
706,16/05/2021,3,1,73,12,61,49,0,0
887,03/05/2021,3,5,318,16,302,39,0,0
432,11/05/2021,3,0,165,5,160,66,0,0
357,08/05/2021,3,2,81,12,69,49,0,0
410,18/05/2021,3,0,56,33,23,57,0,0
918,07/05/2021,3,0,201,23,178,39,0,0
837,09/05/2021,3,6,320,23,297,66,0,0
576,04/05/2021,3,1,57,15,42,55,0,0
515,11/05/2021,3,2,110,47,63,49,0,0
308,01/05/2021,3,1,47,3,44,49,0,0
310,07/05/2021,3,1,71,19,52,49,0,0
250,19/05/2021,3,0,115,72,43,64,0,0
212,04/05/2021,3,1,77,74,3,94,0,0
400,09/05/2021,3,2,28,1,27,49,0,0
741,09/05/2021,3,1,69,17,52,49,0,0
172,13/05/2021,3,2,83,48,35,49,0,0
610,12/05/2021,3,1,66,33,33,60,0,0
613,12/05/2021,3,0,56,39,17,57,0,0
479,10/05/2021,3,1,54,22,32,49,0,0
845,15/05/2021,3,1,119,12,107,49,0,0
260,09/05/2021,3,0,120,21,99,49,0,0
273,02/05/2021,3,0,103,103,0,NA,NA,NA
896,07/05/2021,3,0,82,31,51,49,0,0
606,04/05/2021,3,1,45,13,32,49,0,0
459,14/05/2021,3,4,88,29,59,49,0,0
585,06/05/2021,3,4,56,45,11,82,0,0
344,05/05/2021,3,3,62,29,33,49,0,0
8,03/05/2021,3,1,39,10,29,49,0,0
802,08/05/2021,3,1,64,21,43,49,0,0
786,12/05/2021,3,1,61,13,48,49,0,0
813,09/05/2021,3,1,129,27,102,49,0,0
51,07/05/2021,3,2,78,4,74,49,0,0
816,08/05/2021,3,3,79,47,32,57,0,0
758,16/05/2021,3,0,73,19,54,49,0,0
87,04/05/2021,3,2,116,30,86,49,0,0
710,05/05/2021,3,0,20,11,9,60,0,0
898,08/05/2021,3,0,100,20,80,49,0,0
707,11/05/2021,3,2,38,32,6,85,0,0
234,10/05/2021,3,1,61,17,44,49,0,0
170,05/05/2021,3,1,104,37,67,55,0,0
27,18/05/2021,3,0,78,78,0,NA,NA,NA
226,07/05/2021,3,0,47,11,36,49,0,0
879,02/05/2021,3,3,161,7,154,39,0,0
1,10/05/2021,3,1,99,71,28,55,0,0
440,19/05/2021,3,0,265,49,216,66,0,0
755,14/05/2021,3,0,87,20,67,49,0,0
35,09/05/2021,3,0,110,20,90,49,0,0
231,16/05/2021,3,0,41,6,35,49,0,0
393,16/05/2021,3,1,59,24,35,49,0,0
566,14/05/2021,3,1,74,33,41,49,0,0
686,12/05/2021,3,0,46,20,26,52,0,0
420,10/05/2021,3,12,57,37,20,67,0,0
361,06/05/2021,3,38,27,18,9,80,0,0
706,02/05/2021,3,1,73,0,73,49,0,0
349,04/05/2021,3,1,89,45,44,64,0,0
143,11/05/2021,3,0,120,25,95,49,0,0
316,07/05/2021,3,1,38,11,27,49,0,0
2,17/05/2021,3,2,57,56,1,115,0,0
60,06/05/2021,3,0,57,26,31,55,0,0
837,07/05/2021,3,6,320,17,303,66,0,0
576,05/05/2021,3,1,57,22,35,55,0,0
781,11/05/2021,3,4,79,34,45,49,0,0
579,01/05/2021,3,0,44,6,38,49,0,0
275,08/05/2021,3,6,111,28,83,49,0,0
108,17/05/2021,3,0,78,32,46,49,0,0
117,06/05/2021,3,0,94,44,50,55,0,0
400,10/05/2021,3,2,28,11,17,49,0,0
445,10/05/2021,3,1,168,48,120,49,0,0
19,13/05/2021,3,1,93,49,44,49,0,0
870,10/05/2021,3,5,41,26,15,74,0,0
504,12/05/2021,3,0,83,11,72,49,0,0
104,10/05/2021,3,1,61,58,3,95,0,0
725,13/05/2021,3,0,17,12,5,64,0,0
680,09/05/2021,3,3,77,17,60,49,0,0
599,02/05/2021,3,5,148,23,125,49,0,0
50,08/05/2021,3,2,119,17,102,49,0,0
331,04/05/2021,3,19,75,57,18,79,0,0
301,14/05/2021,3,1,100,41,59,49,0,0
798,05/05/2021,3,1,80,43,37,55,0,0
115,01/05/2021,3,3,112,22,90,49,0,0
761,04/05/2021,3,0,83,26,57,49,0,0
37,09/05/2021,3,3,78,9,69,49,0,0
178,11/05/2021,3,1,37,32,5,72,0,0
72,09/05/2021,3,3,57,24,33,49,0,0
213,06/05/2021,3,4,144,128,16,62,0,0
167,08/05/2021,3,0,84,25,59,49,0,0
551,16/05/2021,3,0,115,11,104,49,0,0
87,03/05/2021,3,2,116,9,107,49,0,0
615,04/05/2021,3,0,71,23,48,49,0,0
348,07/05/2021,3,50,90,52,38,49,0,0
416,11/05/2021,3,0,34,4,30,49,0,0
787,11/05/2021,3,1,107,28,79,49,0,0
711,03/05/2021,3,1,88,19,69,55,0,0
524,17/05/2021,3,0,110,73,37,52,0,0
498,06/05/2021,3,0,87,34,53,49,0,0
879,05/05/2021,3,3,161,9,152,39,0,0
111,10/05/2021,3,0,60,59,1,94,0,0
703,19/05/2021,3,0,91,67,24,60,0,0
193,08/05/2021,3,2,106,10,96,49,0,0
35,10/05/2021,3,0,110,37,73,49,0,0
652,16/05/2021,3,0,69,6,63,49,0,0
162,16/05/2021,3,0,122,26,96,49,0,0
797,14/05/2021,3,0,67,22,45,49,0,0
484,12/05/2021,3,0,40,26,14,67,0,0
778,09/05/2021,3,2,79,36,43,49,0,0
287,07/05/2021,3,3,120,30,90,49,0,0
341,01/05/2021,3,3,111,40,71,49,0,0
564,04/05/2021,3,3,71,47,24,52,0,0
432,12/05/2021,3,0,165,2,163,66,0,0
316,08/05/2021,3,1,38,9,29,49,0,0
643,18/05/2021,3,1,102,54,48,62,0,0
235,08/05/2021,3,6,151,17,134,49,0,0
103,08/05/2021,3,1,160,137,23,57,0,0
345,05/05/2021,3,0,101,64,37,64,0,0
65,11/05/2021,3,1,77,21,56,49,0,0
58,02/05/2021,3,0,67,26,41,49,0,0
426,08/05/2021,3,13,150,37,113,49,0,0
108,19/05/2021,3,0,78,28,50,49,0,0
304,04/05/2021,3,5,55,26,29,49,0,0
423,08/05/2021,3,3,47,30,17,49,0,0
653,08/05/2021,3,2,113,15,98,49,0,0
460,13/05/2021,3,8,101,31,70,49,0,0
355,11/05/2021,3,3,96,38,58,55,0,0
492,11/05/2021,3,3,34,26,8,63,0,0
248,10/05/2021,3,0,82,23,59,55,0,0
483,05/05/2021,3,3,96,30,66,49,0,0
651,10/05/2021,3,1,77,15,62,49,0,0
13,04/05/2021,3,4,77,50,27,72,0,0
896,08/05/2021,3,0,82,27,55,49,0,0
645,04/05/2021,3,3,38,18,20,55,0,0
181,15/05/2021,3,1,33,13,20,49,0,0
298,06/05/2021,3,2,227,76,151,49,0,0
129,02/05/2021,3,10,190,113,77,49,0,0
22,01/05/2021,3,0,64,15,49,49,0,0
161,09/05/2021,3,0,61,14,47,49,0,0
54,12/05/2021,3,1,60,36,24,55,0,0
3,10/05/2021,3,5,108,54,54,49,0,0
128,05/05/2021,3,1,20,15,5,67,0,0
527,08/05/2021,3,7,54,17,37,49,0,0
551,01/05/2021,3,1,114,8,106,49,0,0
246,03/05/2021,3,5,107,17,90,49,0,0
615,05/05/2021,3,0,71,27,44,49,0,0
312,06/05/2021,3,4,93,40,53,49,0,0
882,09/05/2021,3,0,130,19,111,39,0,0
230,04/05/2021,3,0,80,21,59,49,0,0
11,05/05/2021,3,2,82,30,52,55,0,0
149,17/05/2021,3,0,88,65,23,52,0,0
525,07/05/2021,3,3,72,30,42,49,0,0
879,06/05/2021,3,3,161,10,151,39,0,0
1,09/05/2021,3,1,99,47,52,49,0,0
634,18/05/2021,3,0,20,19,1,80,0,0
865,08/05/2021,3,1,84,6,78,49,0,0
295,10/05/2021,3,0,105,12,93,49,0,0
353,16/05/2021,3,1,51,15,36,49,0,0
247,14/05/2021,3,2,91,40,51,49,0,0
637,14/05/2021,3,3,71,14,57,49,0,0
352,12/05/2021,3,0,64,21,43,59,0,0
131,09/05/2021,3,2,47,6,41,49,0,0
607,07/05/2021,3,2,73,8,65,49,0,0
199,02/05/2021,3,3,79,8,71,49,0,0
215,03/05/2021,3,0,46,14,32,59,0,0
220,12/05/2021,3,28,75,23,52,49,0,0
821,07/05/2021,3,2,77,29,48,49,0,0
441,17/05/2021,3,0,168,20,148,55,0,0
658,08/05/2021,3,1,80,27,53,49,0,0
314,07/05/2021,3,1,68,9,59,49,0,0
345,02/05/2021,3,0,101,15,86,49,0,0
254,11/05/2021,3,1,77,27,50,55,0,0
715,03/05/2021,3,2,86,35,51,59,0,0
326,09/05/2021,3,2,79,16,63,49,0,0
588,19/05/2021,3,0,59,37,22,64,0,0
807,04/05/2021,3,3,97,34,63,55,0,0
895,08/05/2021,3,0,69,21,48,49,0,0
358,09/05/2021,3,2,91,14,77,49,0,0
723,13/05/2021,3,1,80,50,30,49,0,0
355,12/05/2021,3,3,96,36,60,55,0,0
883,10/05/2021,3,6,98,21,77,45,0,0
104,04/05/2021,3,2,60,56,4,95,0,0
725,04/05/2021,3,0,17,17,0,NA,NA,NA
661,10/05/2021,3,4,168,13,155,49,0,0
36,03/05/2021,3,1,62,5,57,49,0,0
470,09/05/2021,3,1,79,35,44,49,0,0
116,04/05/2021,3,0,61,42,19,59,0,0
856,15/05/2021,3,1,119,21,98,49,0,0
646,06/05/2021,3,9,127,32,95,49,0,0
135,03/05/2021,3,4,62,16,46,55,0,0
447,01/05/2021,3,0,143,38,105,49,0,0
244,09/05/2021,3,0,200,40,160,49,0,0
628,11/05/2021,3,4,55,33,22,64,0,0
92,10/05/2021,3,1,121,26,95,49,0,0
600,05/05/2021,3,1,49,17,32,55,0,0
529,09/05/2021,3,3,38,6,32,49,0,0
538,02/05/2021,3,1,43,3,40,49,0,0
91,05/05/2021,3,1,79,24,55,49,0,0
852,05/05/2021,3,0,80,22,58,49,0,0
540,06/05/2021,3,2,80,32,48,49,0,0
882,11/05/2021,3,0,130,39,91,39,0,0
234,04/05/2021,3,2,60,17,43,49,0,0
717,05/05/2021,3,3,190,67,123,55,0,0
567,17/05/2021,3,0,61,52,9,60,0,0
806,07/05/2021,3,2,134,36,98,49,0,0
47,04/05/2021,3,2,55,45,10,89,0,0
391,09/05/2021,3,1,75,6,69,49,0,0
634,09/05/2021,3,0,20,13,7,52,0,0
228,08/05/2021,3,3,39,10,29,49,0,0
919,10/05/2021,3,0,123,14,109,49,0,0
904,16/05/2021,3,1,273,2,271,66,0,0
436,14/05/2021,3,2,204,30,174,49,0,0
356,15/05/2021,3,2,134,34,100,49,0,0
136,12/05/2021,3,0,128,44,84,49,0,0
689,09/05/2021,3,1,129,11,118,49,0,0
361,08/05/2021,3,38,27,18,9,80,0,0
412,02/05/2021,3,10,91,13,78,49,0,0
323,03/05/2021,3,0,31,5,26,55,0,0
886,10/05/2021,3,0,152,62,90,49,0,0
679,08/05/2021,3,2,87,87,0,NA,NA,NA
531,17/05/2021,3,1,58,32,26,49,0,0
681,14/05/2021,3,2,69,15,54,49,0,0
835,07/05/2021,3,4,100,22,78,49,0,0
240,03/05/2021,3,1,70,31,39,49,0,0
396,11/05/2021,3,1,29,19,10,70,0,0
58,03/05/2021,3,2,65,28,37,55,0,0
127,07/05/2021,3,1,59,10,49,49,0,0
392,19/05/2021,3,0,176,73,103,49,0,0
117,05/05/2021,3,0,94,37,57,55,0,0
28,09/05/2021,3,2,126,34,92,49,0,0
653,10/05/2021,3,2,113,27,86,49,0,0
815,13/05/2021,3,12,117,54,63,49,0,0
870,12/05/2021,3,6,40,36,4,55,0,0
858,11/05/2021,3,0,81,70,11,95,0,0
479,04/05/2021,3,2,53,28,25,52,0,0
31,04/05/2021,3,1,62,14,48,49,0,0
680,10/05/2021,3,3,77,19,58,49,0,0
36,04/05/2021,3,1,62,7,55,49,0,0
819,09/05/2021,3,1,79,42,37,49,0,0
81,01/05/2021,3,1,59,7,52,49,0,0
814,14/05/2021,3,1,67,29,38,49,0,0
166,05/05/2021,3,4,62,36,26,52,0,0
542,04/05/2021,3,4,71,45,26,62,0,0
761,03/05/2021,3,2,81,18,63,49,0,0
309,09/05/2021,3,0,16,9,7,49,0,0
318,12/05/2021,3,0,59,51,8,90,0,0
642,10/05/2021,3,5,90,34,56,49,0,0
600,06/05/2021,3,1,49,17,32,55,0,0
816,09/05/2021,3,2,80,28,52,49,0,0
113,03/05/2021,3,1,31,1,30,49,0,0
91,03/05/2021,3,4,76,13,63,49,0,0
700,04/05/2021,3,5,127,24,103,49,0,0
670,06/05/2021,3,4,104,44,60,49,0,0
296,10/05/2021,3,3,57,31,26,52,0,0
539,04/05/2021,3,2,95,32,63,49,0,0
638,06/05/2021,3,0,101,46,55,55,0,0
159,18/05/2021,3,0,77,62,15,63,0,0
560,08/05/2021,3,0,80,19,61,49,0,0
765,09/05/2021,3,1,100,30,70,49,0,0
660,09/05/2021,3,40,146,25,121,49,0,0
440,11/05/2021,3,0,265,12,253,66,0,0
865,07/05/2021,3,1,84,4,80,49,0,0
665,14/05/2021,3,1,105,28,77,49,0,0
792,17/05/2021,3,0,102,76,26,52,0,0
597,20/05/2021,3,3,98,52,46,49,0,0
114,15/05/2021,3,0,75,31,44,49,0,0
506,13/05/2021,3,0,195,14,181,49,0,0
184,10/05/2021,3,0,51,35,16,72,0,0
153,08/05/2021,3,1,63,12,51,49,0,0
412,01/05/2021,3,10,91,11,80,49,0,0
384,04/05/2021,3,0,101,71,30,55,0,0
857,11/05/2021,3,1,209,18,191,49,0,0
38,06/05/2021,3,2,48,25,23,55,0,0
791,17/05/2021,3,30,98,64,34,49,0,0
863,14/05/2021,3,7,88,11,77,49,0,0
176,08/05/2021,3,4,96,16,80,49,0,0
146,01/05/2021,3,2,39,20,19,49,0,0
869,11/05/2021,3,1,59,44,15,90,0,0
438,09/05/2021,3,11,85,13,72,55,0,0
426,07/05/2021,3,13,150,37,113,49,0,0
480,09/05/2021,3,0,28,4,24,49,0,0
330,04/05/2021,3,2,117,34,83,55,0,0
187,09/05/2021,3,1,40,15,25,49,0,0
343,14/05/2021,3,1,61,21,40,49,0,0
99,12/05/2021,3,0,167,48,119,49,0,0
601,11/05/2021,3,4,64,34,30,57,0,0
613,10/05/2021,3,0,56,44,12,57,0,0
408,11/05/2021,3,4,161,9,152,49,0,0
21,05/05/2021,3,1,59,10,49,49,0,0
260,12/05/2021,3,0,120,30,90,49,0,0
283,02/05/2021,3,1,75,11,64,49,0,0
50,10/05/2021,3,2,119,31,88,49,0,0
645,01/05/2021,3,1,40,13,27,49,0,0
329,15/05/2021,3,9,98,6,92,49,0,0
585,05/05/2021,3,5,55,50,5,80,0,0
542,05/05/2021,3,4,71,58,13,71,0,0
682,15/05/2021,3,2,78,20,58,49,0,0
443,09/05/2021,3,6,84,23,61,49,0,0
735,12/05/2021,3,0,29,3,26,49,0,0
754,10/05/2021,3,0,62,22,40,49,0,0
138,07/05/2021,3,1,97,36,61,49,0,0
527,13/05/2021,3,9,52,45,7,57,0,0
563,01/05/2021,3,1,69,15,54,49,0,0
246,04/05/2021,3,3,109,24,85,49,0,0
753,02/05/2021,3,3,124,12,112,49,0,0
300,14/05/2021,3,0,210,167,43,52,0,0
296,11/05/2021,3,3,57,38,19,60,0,0
118,09/05/2021,3,4,55,9,46,49,0,0
780,14/05/2021,3,1,59,37,22,49,0,0
770,17/05/2021,3,2,33,26,7,57,0,0
437,21/05/2021,3,2,163,71,92,49,0,0
154,11/05/2021,3,5,99,38,61,49,0,0
514,09/05/2021,3,6,228,9,219,49,0,0
263,09/05/2021,3,0,66,14,52,49,0,0
917,08/05/2021,3,2,104,0,104,35,0,0
659,15/05/2021,3,2,41,21,20,49,0,0
119,17/05/2021,3,2,66,32,34,49,0,0
436,20/05/2021,3,2,204,112,92,49,0,0
637,13/05/2021,3,3,71,44,27,49,0,0
404,13/05/2021,3,0,67,35,32,59,0,0
259,10/05/2021,3,0,60,46,14,72,0,0
147,08/05/2021,3,0,80,13,67,49,0,0
412,03/05/2021,3,10,91,15,76,49,0,0
619,06/05/2021,3,0,101,41,60,55,0,0
857,12/05/2021,3,1,209,20,189,49,0,0
559,06/05/2021,3,42,143,73,70,49,0,0
486,18/05/2021,3,0,124,38,86,49,0,0
918,13/05/2021,3,0,201,15,186,39,0,0
434,08/05/2021,3,3,57,15,42,49,0,0
146,02/05/2021,3,2,39,16,23,49,0,0
629,11/05/2021,3,0,62,36,26,57,0,0
764,09/05/2021,3,2,67,14,53,49,0,0
227,08/05/2021,3,2,42,9,33,49,0,0
250,11/05/2021,3,0,115,96,19,80,0,0
411,05/05/2021,3,2,183,36,147,49,0,0
895,13/05/2021,3,0,69,40,29,49,0,0
179,15/05/2021,3,1,91,13,78,49,0,0
485,19/05/2021,3,0,65,38,27,60,0,0
870,11/05/2021,3,5,41,25,16,74,0,0
378,12/05/2021,3,1,83,40,43,55,0,0
688,11/05/2021,3,3,116,50,66,49,0,0
21,06/05/2021,3,1,59,7,52,49,0,0
680,13/05/2021,3,3,77,31,46,49,0,0
283,04/05/2021,3,1,75,24,51,55,0,0
801,10/05/2021,3,7,160,48,112,49,0,0
606,03/05/2021,3,1,45,4,41,49,0,0
911,14/05/2021,3,0,158,5,153,49,0,0
105,10/05/2021,3,1,74,63,11,72,0,0
616,05/05/2021,3,1,74,31,43,59,0,0
682,17/05/2021,3,2,78,34,44,49,0,0
195,01/05/2021,3,1,50,8,42,49,0,0
237,10/05/2021,3,4,117,16,101,49,0,0
782,13/05/2021,3,0,20,7,13,64,0,0
321,05/05/2021,3,1,39,23,16,52,0,0
209,13/05/2021,3,1,113,72,41,55,0,0
872,01/05/2021,3,1,64,34,30,49,0,0
91,10/05/2021,3,1,79,24,55,49,0,0
745,03/05/2021,3,3,102,21,81,55,0,0
670,14/05/2021,3,0,108,28,80,49,0,0
707,10/05/2021,3,1,39,37,2,115,0,0
873,09/05/2021,3,5,96,22,74,49,0,0
409,14/05/2021,3,7,100,20,80,49,0,0
561,17/05/2021,3,1,59,39,20,52,0,0
211,22/05/2021,3,3,57,50,7,67,0,0
154,10/05/2021,3,5,99,46,53,49,0,0
263,11/05/2021,3,0,66,25,41,49,0,0
193,12/05/2021,3,1,107,32,75,49,0,0
376,14/05/2021,3,1,63,26,37,49,0,0
133,17/05/2021,3,2,62,32,30,49,0,0
825,20/05/2021,3,4,142,65,77,49,0,0
360,15/05/2021,3,1,43,7,36,49,0,0
838,11/05/2021,3,3,62,62,0,NA,NA,NA
778,17/05/2021,3,1,80,67,13,72,0,0
648,07/05/2021,3,1,63,17,46,49,0,0
199,01/05/2021,3,2,80,8,72,49,0,0
384,02/05/2021,3,0,101,18,83,49,0,0
76,10/05/2021,3,1,92,41,51,49,0,0
107,07/05/2021,3,2,87,23,64,49,0,0
53,17/05/2021,3,0,70,69,1,90,0,0
418,04/05/2021,3,2,114,20,94,49,0,0
709,08/05/2021,3,0,83,7,76,49,0,0
513,04/05/2021,3,2,75,32,43,49,0,0
867,10/05/2021,3,1,59,59,0,NA,NA,NA
218,09/05/2021,3,3,75,5,70,49,0,0
326,08/05/2021,3,3,78,14,64,49,0,0
588,11/05/2021,3,0,59,43,16,72,0,0
338,04/05/2021,3,0,400,86,314,49,0,0
189,14/05/2021,3,0,165,48,117,49,0,0
445,15/05/2021,3,1,168,11,157,49,0,0
723,19/05/2021,3,0,81,51,30,74,0,0
97,11/05/2021,3,6,101,60,41,72,0,0
406,12/05/2021,3,1,38,17,21,64,0,0
104,11/05/2021,3,1,61,53,8,127,0,0
225,04/05/2021,3,11,69,34,35,60,0,0
580,15/05/2021,3,0,98,19,79,49,0,0
468,01/05/2021,3,0,96,13,83,49,0,0
849,13/05/2021,3,1,83,26,57,49,0,0
388,01/05/2021,3,1,59,7,52,49,0,0
319,19/05/2021,3,8,106,96,10,77,0,0
157,10/05/2021,3,2,81,63,18,80,0,0
344,01/05/2021,3,20,45,20,25,49,0,0
800,10/05/2021,3,2,55,23,32,49,0,0
155,14/05/2021,3,0,93,22,71,49,0,0
422,12/05/2021,3,1,78,37,41,49,0,0
163,06/05/2021,3,1,61,41,20,60,0,0
816,13/05/2021,3,3,79,58,21,72,0,0
569,02/05/2021,3,0,120,11,109,49,0,0
246,10/05/2021,3,1,111,18,93,49,0,0
370,04/05/2021,3,1,39,12,27,64,0,0
48,15/05/2021,3,0,179,16,163,49,0,0
790,09/05/2021,3,1,98,16,82,66,0,0
234,09/05/2021,3,2,60,13,47,49,0,0
70,13/05/2021,3,2,37,17,20,49,0,0
770,20/05/2021,3,2,33,26,7,57,0,0
437,22/05/2021,3,2,163,78,85,49,0,0
242,07/05/2021,3,2,136,59,77,49,0,0
634,11/05/2021,3,0,20,20,0,NA,NA,NA
183,12/05/2021,3,0,80,36,44,64,0,0
919,14/05/2021,3,1,122,13,109,49,0,0
507,17/05/2021,3,3,197,50,147,49,0,0
251,22/05/2021,3,2,122,49,73,49,0,0
566,13/05/2021,3,1,74,42,32,52,0,0
584,11/05/2021,3,1,96,54,42,60,0,0
151,17/05/2021,3,7,69,37,32,55,0,0
607,06/05/2021,3,3,72,23,49,55,0,0
706,01/05/2021,3,1,73,0,73,49,0,0
77,03/05/2021,3,1,102,8,94,49,0,0
76,11/05/2021,3,1,92,45,47,49,0,0
357,07/05/2021,3,2,81,11,70,49,0,0
757,17/05/2021,3,0,117,111,6,80,0,0
752,04/05/2021,3,18,26,10,16,67,0,0
855,08/05/2021,3,1,175,30,145,49,0,0
317,01/05/2021,3,0,80,14,66,49,0,0
592,10/05/2021,3,19,65,65,0,NA,NA,NA
715,09/05/2021,3,2,86,18,68,49,0,0
772,08/05/2021,3,1,56,6,50,49,0,0
366,11/05/2021,3,0,80,76,4,80,0,0
338,05/05/2021,3,0,400,94,306,49,0,0
895,15/05/2021,3,0,69,18,51,49,0,0
414,13/05/2021,3,21,165,21,144,49,0,0
466,18/05/2021,3,0,140,44,96,52,0,0
97,12/05/2021,3,6,101,62,39,64,0,0
702,12/05/2021,3,1,49,45,4,55,0,0
264,12/05/2021,3,1,59,38,21,60,0,0
363,06/05/2021,3,2,97,59,38,59,0,0
694,15/05/2021,3,5,104,14,90,49,0,0
405,02/05/2021,3,1,89,10,79,49,0,0
470,15/05/2021,3,2,78,28,50,49,0,0
552,08/05/2021,3,15,169,19,150,49,0,0
698,19/05/2021,3,2,114,53,61,49,0,0
798,10/05/2021,3,1,80,70,10,80,0,0
428,01/05/2021,3,4,88,28,60,49,0,0
800,11/05/2021,3,2,55,21,34,49,0,0
788,14/05/2021,3,2,89,15,74,49,0,0
760,12/05/2021,3,1,35,7,28,49,0,0
266,05/05/2021,3,1,60,45,15,62,0,0
209,14/05/2021,3,1,113,66,47,55,0,0
872,04/05/2021,3,1,64,65,-1,NA,NA,NA
374,10/05/2021,3,0,56,20,36,49,0,0
122,04/05/2021,3,5,116,74,42,60,0,0
300,16/05/2021,3,0,210,81,129,49,0,0
882,10/05/2021,3,0,130,35,95,39,0,0
284,08/05/2021,3,1,25,6,19,49,0,0
409,15/05/2021,3,9,98,29,69,49,0,0
770,21/05/2021,3,1,34,29,5,77,0,0
806,20/05/2021,3,1,135,134,1,83,0,0
47,09/05/2021,3,2,55,25,30,49,0,0
233,09/05/2021,3,4,63,5,58,49,0,0
183,13/05/2021,3,0,80,43,37,59,0,0
376,15/05/2021,3,0,64,31,33,49,0,0
677,17/05/2021,3,0,40,21,19,49,0,0
15,20/05/2021,3,0,31,31,0,NA,NA,NA
783,15/05/2021,3,2,78,24,54,49,0,0
352,09/05/2021,3,1,63,9,54,49,0,0
342,17/05/2021,3,2,112,37,75,49,0,0
17,06/05/2021,3,1,93,74,19,57,0,0
543,02/05/2021,3,1,64,8,56,49,0,0
77,06/05/2021,3,1,102,30,72,49,0,0
34,10/05/2021,3,3,85,58,27,60,0,0
290,08/05/2021,3,3,104,58,46,49,0,0
820,17/05/2021,3,0,127,107,20,72,0,0
863,04/05/2021,3,10,85,23,62,57,0,0
257,09/05/2021,3,1,43,17,26,49,0,0
63,14/05/2021,3,1,63,11,52,49,0,0
419,11/05/2021,3,3,107,48,59,66,0,0
509,07/05/2021,3,1,111,19,92,49,0,0
310,09/05/2021,3,1,71,25,46,49,0,0
108,11/05/2021,3,0,78,24,54,49,0,0
411,06/05/2021,3,0,185,39,146,49,0,0
570,14/05/2021,3,0,149,29,120,49,0,0
494,13/05/2021,3,2,137,36,101,49,0,0
868,18/05/2021,3,0,83,33,50,49,0,0
97,10/05/2021,3,7,100,56,44,64,0,0
93,10/05/2021,3,3,138,53,85,49,0,0
112,11/05/2021,3,0,84,46,38,57,0,0
725,05/05/2021,3,0,17,14,3,80,0,0
260,16/05/2021,3,1,119,29,90,49,0,0
273,01/05/2021,3,0,103,103,0,NA,NA,NA
896,15/05/2021,3,0,82,27,55,49,0,0
645,08/05/2021,3,2,39,19,20,49,0,0
856,19/05/2021,3,1,119,58,61,49,0,0
157,12/05/2021,3,2,81,53,28,64,0,0
662,01/05/2021,3,1,106,13,93,49,0,0
761,12/05/2021,3,0,83,18,65,49,0,0
788,13/05/2021,3,2,89,11,78,49,0,0
292,12/05/2021,3,8,231,34,197,49,0,0
163,05/05/2021,3,1,61,43,18,72,0,0
394,13/05/2021,3,2,66,35,31,49,0,0
872,05/05/2021,3,1,64,64,0,NA,NA,NA
737,10/05/2021,3,2,40,11,29,49,0,0
171,04/05/2021,3,2,47,26,21,52,0,0
300,17/05/2021,3,0,210,125,85,49,0,0
239,11/05/2021,3,0,40,37,3,93,0,0
325,09/05/2021,3,1,44,15,29,49,0,0
638,15/05/2021,3,21,80,45,35,49,0,0
168,19/05/2021,3,0,48,38,10,80,0,0
525,21/05/2021,3,1,74,55,19,67,0,0
242,10/05/2021,3,2,136,71,65,49,0,0
487,09/05/2021,3,4,35,2,33,49,0,0
193,13/05/2021,3,2,106,41,65,49,0,0
35,14/05/2021,3,0,110,14,96,49,0,0
444,18/05/2021,3,4,115,55,60,49,0,0
399,22/05/2021,3,1,60,60,0,NA,NA,NA
846,15/05/2021,3,1,188,21,167,45,0,0
584,09/05/2021,3,1,96,33,63,49,0,0
817,17/05/2021,3,1,82,20,62,49,0,0
198,06/05/2021,3,1,134,65,69,55,0,0
134,01/05/2021,3,1,47,17,30,49,0,0
219,06/05/2021,3,5,72,21,51,49,0,0
750,11/05/2021,3,3,109,57,52,52,0,0
679,07/05/2021,3,2,87,71,16,80,0,0
339,22/05/2021,3,15,579,80,499,49,0,0
675,05/05/2021,3,1,55,33,22,67,0,0
277,09/05/2021,3,5,67,24,43,49,0,0
576,14/05/2021,3,2,56,16,40,49,0,0
592,11/05/2021,3,20,64,62,2,115,0,0
308,07/05/2021,3,1,47,6,41,49,0,0
861,07/05/2021,3,0,61,44,17,52,0,0
33,09/05/2021,3,6,74,18,56,49,0,0
330,06/05/2021,3,2,117,45,72,55,0,0
570,13/05/2021,3,0,149,69,80,49,0,0
653,13/05/2021,3,2,113,30,83,49,0,0
485,09/05/2021,3,0,65,2,63,49,0,0
610,10/05/2021,3,1,66,41,25,60,0,0
492,10/05/2021,3,3,34,18,16,52,0,0
248,11/05/2021,3,0,82,58,24,67,0,0
725,06/05/2021,3,0,17,13,4,72,0,0
469,13/05/2021,3,4,192,47,145,66,0,0
13,01/05/2021,3,1,80,58,22,57,0,0
849,16/05/2021,3,1,83,21,62,49,0,0
771,08/05/2021,3,2,28,7,21,49,0,0
459,19/05/2021,3,4,88,62,26,52,0,0
157,11/05/2021,3,2,81,50,31,64,0,0
428,02/05/2021,3,5,87,19,68,49,0,0
8,04/05/2021,3,1,39,13,26,49,0,0
54,13/05/2021,3,1,60,40,20,60,0,0
92,12/05/2021,3,1,121,29,92,49,0,0
417,05/05/2021,3,2,101,42,59,55,0,0
739,13/05/2021,3,3,72,20,52,49,0,0
575,05/05/2021,3,1,49,22,27,59,0,0
625,12/05/2021,3,0,161,48,113,49,0,0
700,02/05/2021,3,7,125,109,16,57,0,0
312,17/05/2021,3,3,94,28,66,49,0,0
267,09/05/2021,3,2,81,17,64,49,0,0
521,09/05/2021,3,1,54,7,47,49,0,0
717,16/05/2021,3,3,190,22,168,49,0,0
149,21/05/2021,3,0,88,76,12,74,0,0
498,20/05/2021,3,0,87,40,47,49,0,0
826,10/05/2021,3,2,96,25,71,49,0,0
487,11/05/2021,3,4,35,12,23,49,0,0
475,13/05/2021,3,1,98,51,47,49,0,0
627,14/05/2021,3,0,41,9,32,49,0,0
608,18/05/2021,3,9,131,52,79,49,0,0
56,11/05/2021,3,4,61,36,25,64,0,0
43,14/05/2021,3,2,71,10,61,49,0,0
728,11/05/2021,3,1,46,23,23,49,0,0
342,18/05/2021,3,2,112,46,66,49,0,0
332,06/05/2021,3,0,40,18,22,55,0,0
706,04/05/2021,3,3,71,65,6,70,0,0
77,02/05/2021,3,1,102,49,53,49,0,0
805,11/05/2021,3,2,111,38,73,55,0,0
530,08/05/2021,3,1,59,48,11,52,0,0
256,23/05/2021,3,1,108,47,61,49,0,0
752,05/05/2021,3,18,26,18,8,55,0,0
389,09/05/2021,3,2,124,16,108,49,0,0
240,12/05/2021,3,0,71,28,43,55,0,0
207,10/05/2021,3,2,61,26,35,59,0,0
579,08/05/2021,3,0,44,10,34,49,0,0
275,07/05/2021,3,7,110,24,86,49,0,0
429,09/05/2021,3,3,122,9,113,49,0,0
212,05/05/2021,3,1,77,73,4,89,0,0
28,14/05/2021,3,2,126,59,67,49,0,0
201,14/05/2021,3,4,134,17,117,49,0,0
88,11/05/2021,3,1,41,11,30,55,0,0
355,10/05/2021,3,3,96,36,60,55,0,0
69,11/05/2021,3,2,58,38,20,57,0,0
272,12/05/2021,3,1,126,32,94,49,0,0
208,05/05/2021,3,0,60,28,32,59,0,0
469,15/05/2021,3,4,192,16,176,66,0,0
377,03/05/2021,3,2,147,23,124,55,0,0
50,17/05/2021,3,2,119,56,63,49,0,0
291,09/05/2021,3,2,59,29,30,49,0,0
891,18/05/2021,3,2,80,78,2,87,0,0
585,10/05/2021,3,3,57,56,1,127,0,0
542,03/05/2021,3,4,71,22,49,49,0,0
761,06/05/2021,3,0,83,20,63,49,0,0
178,13/05/2021,3,1,37,22,15,59,0,0
92,13/05/2021,3,1,121,36,85,49,0,0
163,07/05/2021,3,1,61,24,37,49,0,0
816,14/05/2021,3,3,79,46,33,49,0,0
113,04/05/2021,3,1,31,16,15,65,0,0
87,10/05/2021,3,5,113,18,95,49,0,0
89,01/05/2021,3,0,60,7,53,49,0,0
768,17/05/2021,3,2,85,60,25,49,0,0
491,09/05/2021,3,6,173,13,160,49,0,0
230,08/05/2021,3,0,80,63,17,57,0,0
705,12/05/2021,3,1,90,27,63,49,0,0
168,21/05/2021,3,0,48,47,1,84,0,0
560,20/05/2021,3,0,80,67,13,63,0,0
759,10/05/2021,3,2,85,45,40,49,0,0
624,09/05/2021,3,2,77,7,70,49,0,0
755,13/05/2021,3,0,87,42,45,59,0,0
639,14/05/2021,3,0,59,5,54,49,0,0
652,14/05/2021,3,0,69,5,64,49,0,0
512,12/05/2021,3,2,60,37,23,52,0,0
217,15/05/2021,3,1,40,17,23,49,0,0
598,11/05/2021,3,0,146,147,-1,NA,NA,NA
259,17/05/2021,3,0,60,56,4,127,0,0
361,07/05/2021,3,38,27,26,1,80,0,0
102,02/05/2021,3,0,60,17,43,49,0,0
564,02/05/2021,3,4,70,13,57,49,0,0
750,12/05/2021,3,3,109,61,48,52,0,0
107,06/05/2021,3,2,87,45,42,55,0,0
339,23/05/2021,3,15,579,51,528,49,0,0
383,05/05/2021,3,4,81,25,56,59,0,0
831,08/05/2021,3,3,147,12,135,49,0,0
146,10/05/2021,3,2,39,31,8,83,0,0
779,11/05/2021,3,0,104,32,72,55,0,0
322,09/05/2021,3,0,100,9,91,49,0,0
691,07/05/2021,3,1,31,10,21,49,0,0
860,09/05/2021,3,12,80,22,58,49,0,0
807,06/05/2021,3,3,97,43,54,55,0,0
777,14/05/2021,3,3,117,17,100,49,0,0
414,14/05/2021,3,20,166,21,145,49,0,0
88,09/05/2021,3,1,41,4,37,49,0,0
355,09/05/2021,3,3,96,11,85,49,0,0
795,11/05/2021,3,5,100,52,48,55,0,0
804,11/05/2021,3,3,142,25,117,49,0,0
827,04/05/2021,3,1,69,18,51,55,0,0
24,14/05/2021,3,1,83,35,48,49,0,0
336,04/05/2021,3,1,73,63,10,79,0,0
23,17/05/2021,3,3,61,32,29,49,0,0
773,09/05/2021,3,2,72,13,59,49,0,0
814,18/05/2021,3,1,67,64,3,90,0,0
7,11/05/2021,3,2,101,60,41,55,0,0
616,03/05/2021,3,3,72,15,57,49,0,0
268,01/05/2021,3,2,76,26,50,49,0,0
318,13/05/2021,3,0,59,42,17,72,0,0
422,13/05/2021,3,1,78,22,56,49,0,0
684,07/05/2021,3,3,95,20,75,49,0,0
173,13/05/2021,3,1,70,39,31,60,0,0
113,05/05/2021,3,1,31,15,16,63,0,0
205,10/05/2021,3,0,126,27,99,49,0,0
710,01/05/2021,3,0,20,12,8,49,0,0
851,17/05/2021,3,0,92,26,66,49,0,0
182,10/05/2021,3,2,78,29,49,49,0,0
364,08/05/2021,3,2,128,91,37,59,0,0
409,13/05/2021,3,1,106,42,64,49,0,0
794,20/05/2021,3,0,137,48,89,55,0,0
525,20/05/2021,3,1,74,54,20,57,0,0
242,11/05/2021,3,2,136,76,60,49,0,0
731,09/05/2021,3,7,92,13,79,49,0,0
848,13/05/2021,3,9,129,14,115,35,0,0
197,15/05/2021,3,0,118,12,106,49,0,0
792,14/05/2021,3,0,102,26,76,49,0,0
56,12/05/2021,3,2,63,34,29,59,0,0
637,15/05/2021,3,0,74,21,53,49,0,0
404,09/05/2021,3,0,67,16,51,49,0,0
689,17/05/2021,3,0,130,67,63,49,0,0
648,06/05/2021,3,1,63,28,35,59,0,0
102,04/05/2021,3,0,60,16,44,55,0,0
564,03/05/2021,3,4,70,18,52,49,0,0
805,10/05/2021,3,2,111,48,63,49,0,0
357,06/05/2021,3,2,81,25,56,55,0,0
643,23/05/2021,3,2,101,35,66,49,0,0
534,03/05/2021,3,0,85,7,78,49,0,0
32,07/05/2021,3,1,104,34,70,49,0,0
146,11/05/2021,3,2,39,28,11,64,0,0
789,10/05/2021,3,0,72,40,32,55,0,0
218,08/05/2021,3,3,75,19,56,49,0,0
426,09/05/2021,3,12,151,27,124,49,0,0
232,11/05/2021,3,3,62,44,18,74,0,0
210,04/05/2021,3,3,99,59,40,49,0,0
276,13/05/2021,3,1,203,63,140,49,0,0
156,15/05/2021,3,3,145,45,100,49,0,0
64,10/05/2021,3,3,244,8,236,49,0,0
499,09/05/2021,3,0,31,8,23,49,0,0
883,12/05/2021,3,6,98,10,88,45,0,0
899,11/05/2021,3,6,99,23,76,49,0,0
346,06/05/2021,3,5,115,64,51,55,0,0
461,16/05/2021,3,2,120,3,117,66,0,0
273,04/05/2021,3,0,103,100,3,95,0,0
552,10/05/2021,3,14,170,38,132,49,0,0
716,19/05/2021,3,0,104,83,21,87,0,0
7,12/05/2021,3,2,101,49,52,55,0,0
662,03/05/2021,3,1,106,10,96,49,0,0
471,01/05/2021,3,7,113,38,75,49,0,0
155,13/05/2021,3,0,93,52,41,49,0,0
813,13/05/2021,3,1,129,67,62,49,0,0
321,06/05/2021,3,1,39,10,29,49,0,0
390,13/05/2021,3,3,133,70,63,49,0,0
575,03/05/2021,3,1,49,3,46,55,0,0
625,11/05/2021,3,0,161,62,99,49,0,0
171,02/05/2021,3,2,47,19,28,49,0,0
557,14/05/2021,3,1,103,33,70,49,0,0
491,10/05/2021,3,5,174,29,145,49,0,0
234,08/05/2021,3,2,60,23,37,49,0,0
780,13/05/2021,3,1,59,30,29,49,0,0
713,21/05/2021,3,1,60,53,7,153,0,0
368,21/05/2021,3,1,84,48,36,68,0,0
488,01/05/2021,3,2,64,20,44,49,0,0
685,11/05/2021,3,5,135,70,65,59,0,0
865,13/05/2021,3,1,84,11,73,49,0,0
627,15/05/2021,3,0,41,13,28,49,0,0
231,15/05/2021,3,0,41,13,28,49,0,0
253,11/05/2021,3,1,57,25,32,55,0,0
797,13/05/2021,3,0,67,30,37,55,0,0
484,09/05/2021,3,0,40,9,31,49,0,0
342,16/05/2021,3,0,114,18,96,49,0,0
589,07/05/2021,3,3,140,19,121,49,0,0
126,02/05/2021,3,0,120,31,89,49,0,0
633,03/05/2021,3,2,48,6,42,49,0,0
857,10/05/2021,3,2,208,14,194,49,0,0
530,07/05/2021,3,1,59,44,15,57,0,0
757,22/05/2021,3,0,117,90,27,90,0,0
752,03/05/2021,3,18,26,3,23,49,0,0
314,08/05/2021,3,2,67,12,55,49,0,0
576,12/05/2021,3,1,57,27,30,52,0,0
20,10/05/2021,3,1,81,34,47,55,0,0
603,08/05/2021,3,2,82,25,57,49,0,0
127,08/05/2021,3,1,59,18,41,49,0,0
120,09/05/2021,3,2,152,19,133,49,0,0
411,04/05/2021,3,2,183,33,150,49,0,0
696,14/05/2021,3,1,88,22,66,49,0,0
343,13/05/2021,3,1,61,26,35,49,0,0
64,11/05/2021,3,3,244,12,232,49,0,0
80,10/05/2021,3,2,123,34,89,49,0,0
889,11/05/2021,3,1,123,13,110,45,0,0
804,12/05/2021,3,3,142,24,118,49,0,0
346,04/05/2021,3,6,114,42,72,55,0,0
461,13/05/2021,3,2,120,9,111,66,0,0
273,03/05/2021,3,0,103,97,6,90,0,0
773,08/05/2021,3,1,73,20,53,49,0,0
98,18/05/2021,3,1,94,90,4,123,0,0
798,02/05/2021,3,0,81,21,60,49,0,0
129,05/05/2021,3,9,191,42,149,49,0,0
682,01/05/2021,3,1,79,17,62,49,0,0
565,13/05/2021,3,0,62,37,25,64,0,0
3,12/05/2021,3,6,107,51,56,49,0,0
417,07/05/2021,3,0,103,14,89,49,0,0
529,13/05/2021,3,3,38,18,20,49,0,0
551,05/05/2021,3,0,115,58,57,52,0,0
631,10/05/2021,3,1,70,51,19,64,0,0
370,02/05/2021,3,1,39,10,29,49,0,0
898,14/05/2021,3,1,99,23,76,49,0,0
446,11/05/2021,3,8,125,56,69,49,0,0
539,09/05/2021,3,2,95,4,91,49,0,0
409,12/05/2021,3,1,106,46,60,49,0,0
456,20/05/2021,3,4,86,70,16,57,0,0
4,22/05/2021,3,1,63,59,4,151,0,0
759,01/05/2021,3,2,85,11,74,49,0,0
233,11/05/2021,3,4,63,33,30,64,0,0
519,04/05/2021,3,0,64,61,3,90,0,0
307,07/05/2021,3,1,78,5,73,49,0,0
442,14/05/2021,3,1,157,29,128,49,0,0
393,11/05/2021,3,2,58,24,34,49,0,0
356,13/05/2021,3,3,133,63,70,55,0,0
686,09/05/2021,3,0,46,4,42,49,0,0
259,08/05/2021,3,0,60,22,38,49,0,0
287,08/05/2021,3,3,120,42,78,49,0,0
45,01/05/2021,3,1,155,9,146,49,0,0
556,05/05/2021,3,1,116,38,78,49,0,0
750,10/05/2021,3,3,109,38,71,49,0,0
5,07/05/2021,3,68,21,17,4,57,0,0
820,22/05/2021,3,0,127,119,8,77,0,0
418,05/05/2021,3,2,114,23,91,49,0,0
505,07/05/2021,3,0,84,9,75,49,0,0
576,13/05/2021,3,1,57,35,22,57,0,0
335,11/05/2021,3,4,82,22,60,55,0,0
58,08/05/2021,3,2,65,63,2,57,0,0
861,09/05/2021,3,0,61,44,17,52,0,0
33,10/05/2021,3,5,75,44,31,57,0,0
902,05/05/2021,3,2,124,43,81,49,0,0
785,14/05/2021,3,1,109,14,95,49,0,0
358,14/05/2021,3,1,92,12,80,49,0,0
460,11/05/2021,3,11,98,30,68,49,0,0
499,10/05/2021,3,0,31,17,14,49,0,0
492,12/05/2021,3,4,33,24,9,63,0,0
272,11/05/2021,3,1,126,38,88,49,0,0
346,05/05/2021,3,5,115,36,79,55,0,0
680,14/05/2021,3,3,77,52,25,52,0,0
377,04/05/2021,3,2,147,100,47,57,0,0
351,09/05/2021,3,1,65,16,49,49,0,0
98,19/05/2021,3,2,93,79,14,89,0,0
7,02/05/2021,3,2,101,23,78,49,0,0
344,03/05/2021,3,0,65,11,54,49,0,0
22,02/05/2021,3,0,64,5,59,49,0,0
786,13/05/2021,3,2,60,15,45,49,0,0
642,12/05/2021,3,3,92,48,44,49,0,0
266,07/05/2021,3,0,61,10,51,49,0,0
173,14/05/2021,3,1,70,14,56,49,0,0
758,05/05/2021,3,0,73,36,37,55,0,0
91,12/05/2021,3,1,79,22,57,55,0,0
700,03/05/2021,3,6,126,19,107,49,0,0
670,15/05/2021,3,1,107,30,77,49,0,0
666,11/05/2021,3,2,64,26,38,49,0,0
521,08/05/2021,3,1,54,15,39,49,0,0
614,16/05/2021,3,1,81,12,69,49,0,0
229,20/05/2021,3,4,52,49,3,119,0,0
152,22/05/2021,3,1,90,89,1,89,0,0
704,01/05/2021,3,1,31,6,25,49,0,0
86,11/05/2021,3,2,46,29,17,67,0,0
594,05/05/2021,3,43,64,45,19,80,0,0
554,06/05/2021,3,1,41,40,1,75,0,0
353,14/05/2021,3,1,51,8,43,49,0,0
269,11/05/2021,3,3,77,7,70,49,0,0
356,14/05/2021,3,2,134,38,96,49,0,0
506,10/05/2021,3,0,195,3,192,49,0,0
526,05/05/2021,3,0,38,18,20,55,0,0
17,07/05/2021,3,1,93,19,74,49,0,0
582,04/05/2021,3,0,53,24,29,55,0,0
564,05/05/2021,3,6,68,41,27,49,0,0
886,11/05/2021,3,4,148,107,41,49,0,0
5,08/05/2021,3,68,21,18,3,70,0,0
820,23/05/2021,3,0,127,74,53,49,0,0
534,05/05/2021,3,0,85,24,61,49,0,0
505,08/05/2021,3,0,84,10,74,49,0,0
26,13/05/2021,3,3,63,29,34,55,0,0
130,11/05/2021,3,3,78,32,46,49,0,0
715,08/05/2021,3,2,86,84,2,69,0,0
612,07/05/2021,3,2,40,3,37,49,0,0
250,10/05/2021,3,1,114,100,14,80,0,0
338,06/05/2021,3,5,395,114,281,49,0,0
276,15/05/2021,3,1,203,31,172,49,0,0
562,14/05/2021,3,1,67,11,56,49,0,0
334,11/05/2021,3,0,58,29,29,60,0,0
601,10/05/2021,3,4,64,28,36,49,0,0
537,11/05/2021,3,3,99,96,3,123,0,0
479,11/05/2021,3,1,54,22,32,49,0,0
845,04/05/2021,3,1,119,55,64,67,0,0
680,15/05/2021,3,3,77,56,21,52,0,0
336,03/05/2021,3,1,73,25,48,55,0,0
81,10/05/2021,3,1,59,19,40,49,0,0
891,19/05/2021,3,2,80,75,5,79,0,0
7,03/05/2021,3,2,101,21,80,55,0,0
756,02/05/2021,3,0,106,88,18,52,0,0
471,03/05/2021,3,8,112,32,80,49,0,0
54,14/05/2021,3,1,60,23,37,49,0,0
3,13/05/2021,3,6,107,58,49,49,0,0
684,05/05/2021,3,3,95,33,62,49,0,0
433,13/05/2021,3,2,316,63,253,66,0,0
137,03/05/2021,3,23,123,13,110,49,0,0
572,10/05/2021,3,0,61,36,25,60,0,0
852,03/05/2021,3,1,79,16,63,49,0,0
557,16/05/2021,3,1,103,28,75,49,0,0
239,09/05/2021,3,0,40,12,28,49,0,0
787,08/05/2021,3,1,107,34,73,49,0,0
866,14/05/2021,3,0,100,13,87,49,0,0
456,19/05/2021,3,4,86,49,37,49,0,0
4,20/05/2021,3,1,63,63,0,NA,NA,NA
221,01/05/2021,3,0,62,12,50,49,0,0
369,11/05/2021,3,5,85,54,31,67,0,0
755,05/05/2021,3,0,87,47,40,64,0,0
554,07/05/2021,3,2,40,41,-1,NA,NA,NA
25,15/05/2021,3,1,51,13,38,49,0,0
597,11/05/2021,3,3,98,36,62,49,0,0
465,14/05/2021,3,12,255,36,219,55,0,0
439,09/05/2021,3,4,87,6,81,49,0,0
184,06/05/2021,3,0,51,27,24,59,0,0
147,07/05/2021,3,0,80,12,68,49,0,0
134,04/05/2021,3,1,47,25,22,52,0,0
556,06/05/2021,3,1,116,36,80,49,0,0
84,10/05/2021,3,0,20,18,2,79,0,0
38,08/05/2021,3,1,49,10,39,49,0,0
327,22/05/2021,3,16,52,51,1,NA,NA,NA
632,03/05/2021,3,0,82,17,65,55,0,0
835,09/05/2021,3,4,100,35,65,49,0,0
576,10/05/2021,3,1,57,17,40,49,0,0
282,11/05/2021,3,27,674,30,644,49,0,0
322,07/05/2021,3,0,100,5,95,49,0,0
52,08/05/2021,3,11,131,31,100,49,0,0
33,11/05/2021,3,5,75,44,31,60,0,0
902,06/05/2021,3,2,124,36,88,49,0,0
696,15/05/2021,3,1,88,15,73,49,0,0
828,14/05/2021,3,1,74,13,61,49,0,0
738,11/05/2021,3,1,123,49,74,55,0,0
636,10/05/2021,3,0,120,69,51,49,0,0
586,12/05/2021,3,4,79,72,7,85,0,0
535,11/05/2021,3,0,83,26,57,49,0,0
827,06/05/2021,3,1,69,28,41,55,0,0
517,13/05/2021,3,1,57,40,17,52,0,0
377,01/05/2021,3,2,147,27,120,49,0,0
116,10/05/2021,3,0,61,45,16,64,0,0
508,19/05/2021,3,12,68,40,28,62,0,0
166,03/05/2021,3,3,63,8,55,49,0,0
9,04/05/2021,3,0,27,27,0,NA,NA,NA
471,06/05/2021,3,7,113,53,60,49,0,0
178,14/05/2021,3,1,37,9,28,49,0,0
139,13/05/2021,3,2,57,14,43,49,0,0
252,07/05/2021,3,3,261,22,239,49,0,0
433,14/05/2021,3,2,316,21,295,66,0,0
137,04/05/2021,3,23,123,18,105,49,0,0
572,11/05/2021,3,0,61,34,27,67,0,0
700,05/05/2021,3,4,128,22,106,49,0,0
898,16/05/2021,3,1,99,17,82,49,0,0
416,10/05/2021,3,0,34,3,31,49,0,0
284,09/05/2021,3,1,25,9,16,49,0,0
711,15/05/2021,3,0,89,23,66,49,0,0
673,21/05/2021,3,8,115,112,3,74,0,0
152,21/05/2021,3,1,90,90,0,NA,NA,NA
879,01/05/2021,3,3,161,6,155,45,0,0
634,10/05/2021,3,0,20,19,1,80,0,0
475,04/05/2021,3,1,98,45,53,60,0,0
197,05/05/2021,3,0,118,31,87,49,0,0
119,14/05/2021,3,2,66,23,43,49,0,0
186,11/05/2021,3,1,57,32,25,49,0,0
360,13/05/2021,3,1,43,14,29,55,0,0
838,10/05/2021,3,4,61,61,0,NA,NA,NA
259,06/05/2021,3,0,60,28,32,55,0,0
332,08/05/2021,3,0,40,14,26,49,0,0
39,04/05/2021,3,1,60,43,17,94,0,0
323,02/05/2021,3,0,31,4,27,49,0,0
180,11/05/2021,3,0,41,26,15,52,0,0
290,06/05/2021,3,3,104,49,55,49,0,0
203,13/05/2021,3,0,40,3,37,49,0,0
60,04/05/2021,3,0,57,43,14,67,0,0
103,07/05/2021,3,1,160,69,91,49,0,0
513,11/05/2021,3,1,76,29,47,49,0,0
282,10/05/2021,3,27,674,14,660,49,0,0
603,07/05/2021,3,2,82,19,63,49,0,0
452,08/05/2021,3,1,59,14,45,55,0,0
274,09/05/2021,3,2,208,10,198,39,0,0
212,01/05/2021,3,1,77,76,1,82,0,0
305,13/05/2021,3,5,54,12,42,49,0,0
343,15/05/2021,3,1,61,12,49,49,0,0
88,10/05/2021,3,1,41,7,34,55,0,0
188,11/05/2021,3,4,117,52,65,49,0,0
406,11/05/2021,3,1,38,22,16,72,0,0
112,12/05/2021,3,0,84,35,49,49,0,0
363,05/05/2021,3,1,98,46,52,59,0,0
421,14/05/2021,3,0,19,14,5,72,0,0
405,01/05/2021,3,1,89,17,72,49,0,0
388,10/05/2021,3,1,59,45,14,62,0,0
550,18/05/2021,3,2,110,62,48,49,0,0
123,02/05/2021,3,1,94,6,88,49,0,0
9,05/05/2021,3,0,27,27,0,NA,NA,NA
682,06/05/2021,3,1,79,18,61,49,0,0
458,14/05/2021,3,3,178,38,140,49,0,0
292,13/05/2021,3,5,234,35,199,49,0,0
600,07/05/2021,3,1,49,20,29,49,0,0
142,13/05/2021,3,1,61,39,22,64,0,0
650,02/05/2021,3,3,125,7,118,49,0,0
572,01/05/2021,3,1,60,13,47,49,0,0
71,05/05/2021,3,3,59,18,41,49,0,0
312,15/05/2021,3,3,94,18,76,49,0,0
281,11/05/2021,3,3,80,20,60,49,0,0
734,09/05/2021,3,2,59,19,40,49,0,0
866,15/05/2021,3,0,100,8,92,49,0,0
811,21/05/2021,3,3,87,53,34,55,0,0
806,21/05/2021,3,1,135,135,0,NA,NA,NA
47,01/05/2021,3,2,55,32,23,49,0,0
703,11/05/2021,3,0,91,51,40,55,0,0
262,04/05/2021,3,2,49,27,22,55,0,0
919,05/05/2021,3,0,123,12,111,49,0,0
904,14/05/2021,3,3,271,2,269,66,0,0
683,13/05/2021,3,1,65,29,36,49,0,0
712,13/05/2021,3,1,84,11,73,49,0,0
352,11/05/2021,3,1,63,30,33,59,0,0
271,08/05/2021,3,0,70,12,58,49,0,0
332,07/05/2021,3,0,40,11,29,49,0,0
341,03/05/2021,3,3,111,68,43,55,0,0
75,03/05/2021,3,0,81,19,62,49,0,0
699,11/05/2021,3,0,62,44,18,72,0,0
407,06/05/2021,3,1,40,6,34,49,0,0
667,11/05/2021,3,0,10,0,10,NA,NA,NA
918,04/05/2021,3,0,201,49,152,39,0,0
389,07/05/2021,3,2,124,24,100,49,0,0
576,11/05/2021,3,1,57,25,32,49,0,0
254,10/05/2021,3,1,77,29,48,49,0,0
438,07/05/2021,3,16,80,16,64,49,0,0
452,09/05/2021,3,1,59,17,42,55,0,0
274,10/05/2021,3,2,208,40,168,39,0,0
212,03/05/2021,3,2,76,59,17,64,0,0
777,13/05/2021,3,3,117,46,71,49,0,0
494,15/05/2021,3,1,138,8,130,49,0,0
172,11/05/2021,3,2,83,40,43,55,0,0
499,12/05/2021,3,0,31,16,15,49,0,0
558,10/05/2021,3,0,44,10,34,49,0,0
535,12/05/2021,3,0,83,26,57,49,0,0
618,04/05/2021,3,14,137,43,94,49,0,0
661,12/05/2021,3,4,168,16,152,49,0,0
468,02/05/2021,3,0,96,10,86,49,0,0
331,09/05/2021,3,3,91,14,77,49,0,0
550,19/05/2021,3,2,110,40,70,49,0,0
123,03/05/2021,3,1,94,5,89,49,0,0
115,05/05/2021,3,0,115,25,90,49,0,0
800,03/05/2021,3,2,55,8,47,49,0,0
628,14/05/2021,3,1,58,7,51,49,0,0
754,13/05/2021,3,0,62,11,51,49,0,0
321,07/05/2021,3,1,39,3,36,49,0,0
167,13/05/2021,3,0,84,72,12,80,0,0
575,01/05/2021,3,1,49,12,37,49,0,0
631,02/05/2021,3,1,70,5,65,49,0,0
89,05/05/2021,3,3,57,17,40,49,0,0
557,15/05/2021,3,1,103,42,61,49,0,0
401,09/05/2021,3,0,79,8,71,49,0,0
230,09/05/2021,3,0,80,11,69,49,0,0
866,16/05/2021,3,0,100,10,90,49,0,0
164,19/05/2021,3,0,62,41,21,52,0,0
67,22/05/2021,3,1,51,51,0,NA,NA,NA
154,01/05/2021,3,2,102,31,71,49,0,0
841,11/05/2021,3,0,182,32,150,55,0,0
617,04/05/2021,3,2,42,23,19,55,0,0
372,07/05/2021,3,2,90,26,64,49,0,0
145,15/05/2021,3,4,54,3,51,49,0,0
15,12/05/2021,3,0,31,16,15,64,0,0
846,14/05/2021,3,3,186,18,168,45,0,0
362,10/05/2021,3,3,117,103,14,80,0,0
526,06/05/2021,3,0,38,8,30,55,0,0
42,06/05/2021,3,2,97,42,55,49,0,0
39,03/05/2021,3,1,60,28,32,55,0,0
219,03/05/2021,3,6,71,6,65,49,0,0
285,10/05/2021,3,0,80,28,52,55,0,0
290,07/05/2021,3,3,104,51,53,49,0,0
667,13/05/2021,3,0,10,0,10,NA,NA,NA
658,05/05/2021,3,1,80,33,47,55,0,0
709,07/05/2021,3,0,83,7,76,49,0,0
513,13/05/2021,3,1,76,41,35,49,0,0
781,10/05/2021,3,1,82,33,49,49,0,0
509,08/05/2021,3,1,111,19,92,49,0,0
52,09/05/2021,3,14,128,46,82,49,0,0
274,11/05/2021,3,2,208,50,158,39,0,0
210,02/05/2021,3,3,99,75,24,52,0,0
785,13/05/2021,3,1,109,50,59,49,0,0
358,15/05/2021,3,1,92,15,77,49,0,0
815,09/05/2021,3,12,117,12,105,49,0,0
656,12/05/2021,3,0,115,43,72,49,0,0
858,12/05/2021,3,0,81,48,33,72,0,0
688,12/05/2021,3,5,114,51,63,49,0,0
618,06/05/2021,3,15,136,34,102,49,0,0
260,13/05/2021,3,0,120,35,85,49,0,0
605,02/05/2021,3,4,156,34,122,49,0,0
552,09/05/2021,3,14,170,11,159,49,0,0
319,18/05/2021,3,1,113,94,19,74,0,0
123,04/05/2021,3,1,94,8,86,49,0,0
115,04/05/2021,3,3,112,19,93,49,0,0
682,05/05/2021,3,1,79,19,60,49,0,0
735,06/05/2021,3,0,29,11,18,49,0,0
760,13/05/2021,3,1,35,9,26,49,0,0
138,06/05/2021,3,2,96,46,50,55,0,0
862,13/05/2021,3,3,107,52,55,49,0,0
551,02/05/2021,3,1,114,10,104,49,0,0
625,02/05/2021,3,1,160,13,147,49,0,0
753,05/05/2021,3,3,124,44,80,49,0,0
833,16/05/2021,3,1,82,23,59,49,0,0
446,10/05/2021,3,8,125,57,68,49,0,0
787,09/05/2021,3,1,107,14,93,49,0,0
711,16/05/2021,3,0,89,13,76,49,0,0
27,20/05/2021,3,0,78,71,7,86,0,0
226,20/05/2021,3,0,47,47,0,NA,NA,NA
826,01/05/2021,3,2,96,24,72,49,0,0
685,09/05/2021,3,4,136,45,91,49,0,0
865,04/05/2021,3,2,83,7,76,49,0,0
659,07/05/2021,3,2,41,6,35,49,0,0
904,15/05/2021,3,4,270,3,267,66,0,0
192,12/05/2021,3,0,86,50,36,57,0,0
311,14/05/2021,3,0,97,16,81,49,0,0
362,11/05/2021,3,3,117,96,21,90,0,0
243,07/05/2021,3,1,126,70,56,49,0,0
287,06/05/2021,3,3,120,34,86,49,0,0
543,04/05/2021,3,1,64,25,39,55,0,0
633,04/05/2021,3,2,48,15,33,49,0,0
294,10/05/2021,3,0,117,36,81,49,0,0
559,07/05/2021,3,78,107,25,82,49,0,0
667,12/05/2021,3,0,10,0,10,NA,NA,NA
632,05/05/2021,3,0,82,42,40,55,0,0
434,07/05/2021,3,3,57,16,41,49,0,0
513,14/05/2021,3,1,76,15,61,49,0,0
65,10/05/2021,3,1,77,25,52,49,0,0
509,09/05/2021,3,1,111,33,78,49,0,0
275,09/05/2021,3,6,111,17,94,49,0,0
250,09/05/2021,3,1,114,66,48,59,0,0
807,02/05/2021,3,3,97,12,85,49,0,0
380,14/05/2021,3,2,158,29,129,49,0,0
828,15/05/2021,3,1,74,15,59,49,0,0
520,09/05/2021,3,0,58,8,50,49,0,0
859,12/05/2021,3,1,84,14,70,49,0,0
477,12/05/2021,3,4,116,33,83,49,0,0
83,11/05/2021,3,88,80,58,22,49,0,0
21,04/05/2021,3,1,59,14,45,49,0,0
580,13/05/2021,3,0,98,50,48,49,0,0
13,03/05/2021,3,3,78,14,64,49,0,0
388,09/05/2021,3,1,59,3,56,49,0,0
329,19/05/2021,3,10,97,45,52,49,0,0
798,04/05/2021,3,1,80,30,50,55,0,0
616,04/05/2021,3,3,72,34,38,64,0,0
800,01/05/2021,3,2,55,6,49,49,0,0
735,07/05/2021,3,0,29,2,27,49,0,0
642,13/05/2021,3,2,93,49,44,49,0,0
684,06/05/2021,3,3,95,27,68,49,0,0
529,14/05/2021,3,3,38,9,29,49,0,0
113,01/05/2021,3,1,31,4,27,49,0,0
91,01/05/2021,3,2,78,11,67,49,0,0
753,01/05/2021,3,6,121,11,110,49,0,0
300,15/05/2021,3,0,210,210,0,NA,NA,NA
666,10/05/2021,3,3,63,22,41,49,0,0
539,08/05/2021,3,2,95,6,89,49,0,0
705,01/05/2021,3,1,90,11,79,49,0,0
27,21/05/2021,3,0,78,76,2,101,0,0
657,20/05/2021,3,0,48,48,0,NA,NA,NA
242,01/05/2021,3,4,134,133,1,62,0,0
263,10/05/2021,3,0,66,20,46,49,0,0
451,04/05/2021,3,2,81,37,44,66,0,0
307,05/05/2021,3,1,78,14,64,49,0,0
145,14/05/2021,3,4,54,4,50,49,0,0
462,12/05/2021,3,0,189,4,185,55,0,0
114,14/05/2021,3,0,75,18,57,49,0,0
362,09/05/2021,3,5,115,62,53,59,0,0
689,07/05/2021,3,1,129,18,111,49,0,0
776,06/05/2021,3,0,104,28,76,49,0,0
743,04/05/2021,3,1,125,38,87,55,0,0
77,05/05/2021,3,1,102,28,74,49,0,0
294,11/05/2021,3,0,117,41,76,49,0,0
107,08/05/2021,3,2,87,18,69,49,0,0
2,11/05/2021,3,2,57,46,11,89,0,0
863,05/05/2021,3,12,83,24,59,52,0,0
277,08/05/2021,3,4,68,22,46,49,0,0
812,11/05/2021,3,2,135,63,72,49,0,0
130,10/05/2021,3,3,78,20,58,49,0,0
603,09/05/2021,3,4,80,21,59,49,0,0
772,07/05/2021,3,0,57,7,50,49,0,0
854,09/05/2021,3,7,103,9,94,55,0,0
330,02/05/2021,3,2,117,20,97,49,0,0
895,14/05/2021,3,0,69,22,47,49,0,0
455,13/05/2021,3,7,244,10,234,66,0,0
520,10/05/2021,3,0,58,17,41,49,0,0
97,09/05/2021,3,7,100,21,79,49,0,0
613,11/05/2021,3,0,56,39,17,57,0,0
402,11/05/2021,3,0,155,50,105,49,0,0
483,04/05/2021,3,3,96,32,64,49,0,0
661,13/05/2021,3,4,168,18,150,49,0,0
599,03/05/2021,3,5,148,35,113,49,0,0
351,08/05/2021,3,1,65,27,38,49,0,0
337,19/05/2021,3,1,59,43,16,70,0,0
125,03/05/2021,3,2,34,6,28,55,0,0
428,04/05/2021,3,5,87,46,41,55,0,0
8,02/05/2021,3,1,39,25,14,49,0,0
735,05/05/2021,3,1,28,9,19,49,0,0
139,12/05/2021,3,2,57,11,46,49,0,0
252,05/05/2021,3,3,261,78,183,49,0,0
12,13/05/2021,3,1,42,8,34,49,0,0
113,02/05/2021,3,1,31,4,27,49,0,0
625,01/05/2021,3,2,159,18,141,49,0,0
753,03/05/2021,3,4,123,6,117,49,0,0
833,03/05/2021,3,0,83,21,62,49,0,0
281,10/05/2021,3,3,80,16,64,49,0,0
325,08/05/2021,3,1,44,19,25,49,0,0
780,01/05/2021,3,4,56,52,4,57,0,0
794,21/05/2021,3,0,137,39,98,85,0,0
657,22/05/2021,3,0,48,48,0,NA,NA,NA
18,01/05/2021,3,2,90,29,61,49,0,0
748,09/05/2021,3,4,140,13,127,49,0,0
106,04/05/2021,3,1,30,15,15,55,0,0
639,05/05/2021,3,1,58,27,31,49,0,0
25,14/05/2021,3,1,51,8,43,49,0,0
399,11/05/2021,3,0,61,54,7,59,0,0
824,14/05/2021,3,0,339,4,335,55,0,0
431,09/05/2021,3,4,126,36,90,49,0,0
817,08/05/2021,3,1,82,8,74,49,0,0
42,07/05/2021,3,2,97,19,78,49,0,0
39,01/05/2021,3,1,60,28,32,49,0,0
887,02/05/2021,3,5,318,12,306,39,0,0
143,12/05/2021,3,0,120,32,88,49,0,0
476,08/05/2021,3,1,172,4,168,49,0,0
96,11/05/2021,3,14,55,35,20,62,0,0
383,04/05/2021,3,4,81,47,34,64,0,0
835,08/05/2021,3,4,100,27,73,49,0,0
63,13/05/2021,3,2,62,32,30,49,0,0
224,10/05/2021,3,1,56,23,33,49,0,0
58,09/05/2021,3,2,65,54,11,57,0,0
481,08/05/2021,3,0,56,12,44,49,0,0
232,10/05/2021,3,3,62,33,29,55,0,0
210,03/05/2021,3,3,99,53,46,49,0,0
189,15/05/2021,3,0,165,50,115,49,0,0
156,13/05/2021,3,4,144,124,20,62,0,0
101,09/05/2021,3,1,59,14,45,49,0,0
636,09/05/2021,3,1,119,20,99,49,0,0
406,10/05/2021,3,1,38,24,14,64,0,0
479,12/05/2021,3,1,54,22,32,49,0,0
664,04/05/2021,3,3,152,67,85,49,0,0
580,14/05/2021,3,0,98,26,72,49,0,0
395,04/05/2021,3,2,70,34,36,49,0,0
388,08/05/2021,3,1,59,5,54,49,0,0
808,19/05/2021,3,1,167,145,22,74,0,0
125,04/05/2021,3,2,34,23,11,59,0,0
428,05/05/2021,3,5,87,58,29,60,0,0
730,03/05/2021,3,2,73,6,67,49,0,0
786,06/05/2021,3,1,61,8,53,49,0,0
813,12/05/2021,3,1,129,56,73,55,0,0
138,05/05/2021,3,2,96,46,50,55,0,0
496,13/05/2021,3,1,59,12,47,49,0,0
538,04/05/2021,3,1,43,19,24,49,0,0
737,02/05/2021,3,2,40,6,34,49,0,0
71,03/05/2021,3,1,61,4,57,49,0,0
540,02/05/2021,3,1,81,10,71,49,0,0
296,09/05/2021,3,3,57,13,44,49,0,0
364,09/05/2021,3,2,128,61,67,59,0,0
780,02/05/2021,3,4,56,39,17,52,0,0
673,19/05/2021,3,0,123,55,68,49,0,0
915,12/05/2021,3,4,185,4,181,35,0,0
18,05/05/2021,3,2,90,42,48,55,0,0
487,10/05/2021,3,4,35,13,22,49,0,0
228,04/05/2021,3,3,39,11,28,49,0,0
674,05/05/2021,3,1,97,6,91,49,0,0
231,14/05/2021,3,0,41,10,31,49,0,0
654,11/05/2021,3,6,53,13,40,66,0,0
824,13/05/2021,3,0,339,8,331,55,0,0
647,09/05/2021,3,6,87,29,58,49,0,0
131,05/05/2021,3,2,47,11,36,52,0,0
413,07/05/2021,3,2,114,20,94,49,0,0
543,01/05/2021,3,1,64,10,54,49,0,0
349,03/05/2021,3,1,89,21,68,55,0,0
180,12/05/2021,3,0,41,20,21,49,0,0
559,08/05/2021,3,78,107,25,82,49,0,0
158,11/05/2021,3,1,23,19,4,85,0,0
681,04/05/2021,3,2,69,27,42,55,0,0
103,09/05/2021,3,1,160,50,110,49,0,0
146,14/05/2021,3,2,39,16,23,49,0,0
347,10/05/2021,3,12,50,25,25,49,0,0
403,07/05/2021,3,2,96,38,58,49,0,0
742,09/05/2021,3,1,73,5,68,49,0,0
232,09/05/2021,3,2,63,23,40,49,0,0
78,02/05/2021,3,0,44,10,34,49,0,0
570,15/05/2021,3,0,149,22,127,49,0,0
621,13/05/2021,3,1,59,45,14,67,0,0
803,09/05/2021,3,1,68,15,53,49,0,0
610,09/05/2021,3,1,66,25,41,49,0,0
702,10/05/2021,3,1,49,47,2,74,0,0
83,12/05/2021,3,90,78,57,21,49,0,0
31,06/05/2021,3,1,62,22,40,49,0,0
24,13/05/2021,3,1,83,48,35,49,0,0
605,04/05/2021,3,4,156,39,117,49,0,0
606,10/05/2021,3,1,45,11,34,49,0,0
508,18/05/2021,3,12,68,38,30,57,0,0
585,04/05/2021,3,4,56,47,9,80,0,0
756,05/05/2021,3,0,106,76,30,64,0,0
682,02/05/2021,3,1,79,7,72,49,0,0
237,05/05/2021,3,5,116,16,100,49,0,0
464,13/05/2021,3,1,265,14,251,66,0,0
836,05/05/2021,3,2,99,64,35,55,0,0
467,14/05/2021,3,3,109,5,104,55,0,0
538,05/05/2021,3,1,43,13,30,49,0,0
737,01/05/2021,3,2,40,5,35,49,0,0
745,02/05/2021,3,3,102,11,91,49,0,0
312,03/05/2021,3,4,93,13,80,49,0,0
784,10/05/2021,3,2,47,14,33,49,0,0
49,08/05/2021,3,2,146,15,131,49,0,0
424,02/05/2021,3,1,27,22,5,71,0,0
229,21/05/2021,3,4,52,51,1,103,0,0
915,13/05/2021,3,4,185,6,179,35,0,0
765,05/05/2021,3,1,100,60,40,60,0,0
369,09/05/2021,3,5,85,8,77,49,0,0
848,04/05/2021,3,8,130,13,117,35,0,0
307,06/05/2021,3,1,78,14,64,49,0,0
809,15/05/2021,3,4,97,19,78,49,0,0
350,11/05/2021,3,5,55,35,20,67,0,0
311,15/05/2021,3,0,97,17,80,49,0,0
439,11/05/2021,3,5,86,29,57,49,0,0
151,05/05/2021,3,6,70,39,31,67,0,0
153,06/05/2021,3,1,63,35,28,49,0,0
45,02/05/2021,3,4,152,9,143,49,0,0
384,03/05/2021,3,0,101,30,71,55,0,0
385,10/05/2021,3,2,61,5,56,59,0,0
821,08/05/2021,3,2,77,29,48,49,0,0
158,12/05/2021,3,1,23,18,5,89,0,0
60,03/05/2021,3,0,57,21,36,55,0,0
121,07/05/2021,3,0,110,63,47,49,0,0
345,14/05/2021,3,0,101,34,67,49,0,0
676,10/05/2021,3,4,111,46,65,49,0,0
764,08/05/2021,3,2,67,14,53,49,0,0
452,07/05/2021,3,7,53,11,42,55,0,0
767,09/05/2021,3,1,66,20,46,49,0,0
902,03/05/2021,3,2,124,9,115,49,0,0
777,15/05/2021,3,3,117,30,87,49,0,0
455,14/05/2021,3,7,244,9,235,66,0,0
868,11/05/2021,3,4,79,24,55,49,0,0
656,10/05/2021,3,0,115,28,87,49,0,0
858,10/05/2021,3,1,80,53,27,67,0,0
402,12/05/2021,3,0,155,47,108,49,0,0
214,06/05/2021,3,5,81,44,37,49,0,0
260,15/05/2021,3,1,119,30,89,49,0,0
640,04/05/2021,3,0,126,29,97,49,0,0
645,06/05/2021,3,2,39,19,20,55,0,0
724,19/05/2021,3,3,83,76,7,114,0,0
105,03/05/2021,3,1,74,11,63,59,0,0
135,02/05/2021,3,4,62,10,52,49,0,0
730,05/05/2021,3,2,73,11,62,49,0,0
237,06/05/2021,3,5,116,17,99,49,0,0
760,04/05/2021,3,3,33,11,22,55,0,0
836,06/05/2021,3,2,99,70,29,55,0,0
390,14/05/2021,3,2,134,11,123,49,0,0
538,03/05/2021,3,1,43,3,40,49,0,0
374,02/05/2021,3,0,56,8,48,49,0,0
89,04/05/2021,3,3,57,16,41,49,0,0
853,02/05/2021,3,6,96,9,87,49,0,0
182,11/05/2021,3,2,78,23,55,49,0,0
258,08/05/2021,3,1,142,29,113,49,0,0
70,01/05/2021,3,3,36,23,13,49,0,0
713,20/05/2021,3,1,60,59,1,96,0,0
915,14/05/2021,3,5,184,3,181,35,0,0
221,06/05/2021,3,1,61,14,47,55,0,0
511,11/05/2021,3,3,73,33,40,49,0,0
106,05/05/2021,3,1,30,17,13,55,0,0
674,06/05/2021,3,1,97,9,88,49,0,0
448,14/05/2021,3,3,150,24,126,66,0,0
186,12/05/2021,3,1,57,26,31,52,0,0
907,15/05/2021,3,1,79,16,63,49,0,0
110,09/05/2021,3,1,86,8,78,49,0,0
190,05/05/2021,3,7,73,25,48,52,0,0
153,07/05/2021,3,1,63,17,46,49,0,0
134,02/05/2021,3,1,47,12,35,49,0,0
619,04/05/2021,3,0,101,41,60,55,0,0
34,11/05/2021,3,3,85,58,27,64,0,0
679,06/05/2021,3,2,87,71,16,80,0,0
410,12/05/2021,3,1,55,26,29,52,0,0
383,03/05/2021,3,4,81,26,55,59,0,0
121,09/05/2021,3,0,110,58,52,49,0,0
345,12/05/2021,3,0,101,67,34,64,0,0
335,10/05/2021,3,4,82,25,57,49,0,0
579,05/05/2021,3,0,44,12,32,49,0,0
222,08/05/2021,3,1,76,8,68,49,0,0
429,10/05/2021,3,3,122,18,104,49,0,0
411,03/05/2021,3,0,185,30,155,49,0,0
400,07/05/2021,3,2,28,0,28,49,0,0
621,14/05/2021,3,0,60,15,45,49,0,0
99,11/05/2021,3,0,167,46,121,49,0,0
656,11/05/2021,3,0,115,37,78,49,0,0
558,12/05/2021,3,0,44,16,28,55,0,0
408,12/05/2021,3,4,161,12,149,49,0,0
483,06/05/2021,3,3,96,28,68,49,0,0
694,01/05/2021,3,3,106,13,93,49,0,0
36,01/05/2021,3,1,62,12,50,49,0,0
116,06/05/2021,3,0,61,41,20,60,0,0
844,19/05/2021,3,0,61,28,33,55,0,0
157,04/05/2021,3,3,80,51,29,72,0,0
428,03/05/2021,3,5,87,19,68,55,0,0
800,05/05/2021,3,2,55,23,32,49,0,0
54,05/05/2021,3,2,59,39,20,60,0,0
139,05/05/2021,3,2,57,18,39,49,0,0
875,06/05/2021,3,3,89,58,31,55,0,0
739,14/05/2021,3,3,72,7,65,49,0,0
563,04/05/2021,3,1,69,20,49,52,0,0
87,01/05/2021,3,2,116,9,107,49,0,0
753,04/05/2021,3,3,124,26,98,49,0,0
853,01/05/2021,3,6,96,11,85,49,0,0
182,09/05/2021,3,2,78,12,66,49,0,0
734,08/05/2021,3,2,59,18,41,49,0,0
409,01/05/2021,3,3,104,59,45,49,0,0
149,19/05/2021,3,0,88,66,22,67,0,0
211,14/05/2021,3,3,57,25,32,49,0,0
765,06/05/2021,3,1,100,62,38,55,0,0
583,09/05/2021,3,1,80,18,62,49,0,0
228,05/05/2021,3,3,39,12,27,49,0,0
639,07/05/2021,3,1,58,31,27,49,0,0
245,15/05/2021,3,5,92,74,18,60,0,0
247,12/05/2021,3,3,90,56,34,60,0,0
907,14/05/2021,3,1,79,19,60,49,0,0
136,09/05/2021,3,1,127,22,105,49,0,0
420,05/05/2021,3,12,57,28,29,64,0,0
648,08/05/2021,3,1,63,17,46,49,0,0
341,02/05/2021,3,3,111,35,76,49,0,0
619,05/05/2021,3,0,101,38,63,55,0,0
432,10/05/2021,3,0,165,3,162,66,0,0
316,06/05/2021,3,1,38,34,4,119,0,0
818,12/05/2021,3,1,80,78,2,95,0,0
681,03/05/2021,3,2,69,5,64,55,0,0
434,09/05/2021,3,3,57,10,47,49,0,0
317,14/05/2021,3,0,80,20,60,49,0,0
515,10/05/2021,3,2,110,50,60,49,0,0
579,06/05/2021,3,0,44,4,40,49,0,0
310,08/05/2021,3,1,71,16,55,49,0,0
860,10/05/2021,3,12,80,39,41,49,0,0
338,01/05/2021,3,0,400,84,316,49,0,0
423,05/05/2021,3,3,47,15,32,60,0,0
621,15/05/2021,3,0,60,11,49,49,0,0
520,11/05/2021,3,0,58,23,35,49,0,0
80,12/05/2021,3,2,123,45,78,49,0,0
175,10/05/2021,3,1,119,33,86,49,0,0
899,12/05/2021,3,6,99,31,68,49,0,0
664,06/05/2021,3,3,152,82,70,49,0,0
425,02/05/2021,3,3,247,11,236,66,0,0
605,01/05/2021,3,3,157,33,124,49,0,0
552,05/05/2021,3,14,170,35,135,49,0,0
911,18/05/2021,3,0,158,10,148,49,0,0
7,04/05/2021,3,2,101,38,63,55,0,0
135,04/05/2021,3,3,63,46,17,74,0,0
761,05/05/2021,3,0,83,26,57,49,0,0
628,06/05/2021,3,1,58,11,47,55,0,0
464,05/05/2021,3,1,265,46,219,66,0,0
875,05/05/2021,3,3,89,65,24,60,0,0
862,14/05/2021,3,3,107,29,78,49,0,0
373,03/05/2021,3,2,101,17,84,55,0,0
205,01/05/2021,3,1,125,21,104,49,0,0
852,04/05/2021,3,0,80,30,50,49,0,0
348,02/05/2021,3,49,91,44,47,49,0,0
281,09/05/2021,3,1,82,10,72,49,0,0
49,09/05/2021,3,2,146,11,135,49,0,0
70,02/05/2021,3,2,37,12,25,49,0,0
159,19/05/2021,3,0,77,66,11,62,0,0
806,12/05/2021,3,2,134,111,23,67,0,0
488,02/05/2021,3,0,66,14,52,49,0,0
583,11/05/2021,3,1,80,39,41,55,0,0
451,05/05/2021,3,2,81,34,47,66,0,0
270,05/05/2021,3,1,59,36,23,72,0,0
581,15/05/2021,3,175,50,34,16,52,0,0
253,12/05/2021,3,1,57,27,30,60,0,48
333,15/05/2021,3,1,56,38,18,109,0,0
832,09/05/2021,3,1,99,15,84,49,0,0
593,05/05/2021,3,5,76,66,10,93,0,0
864,08/05/2021,3,1,84,25,59,49,0,0
582,02/05/2021,3,0,53,26,27,49,0,0
887,06/05/2021,3,17,306,14,292,39,0,0
699,12/05/2021,3,0,62,42,20,64,0,0
821,06/05/2021,3,2,77,54,23,60,0,0
339,11/05/2021,3,22,572,29,543,49,0,0
60,05/05/2021,3,0,57,38,19,60,0,0
505,09/05/2021,3,0,84,11,73,49,0,0
810,12/05/2021,3,0,389,34,355,55,0,0
779,10/05/2021,3,0,104,33,71,55,0,0
764,05/05/2021,3,2,67,35,32,55,0,0
742,08/05/2021,3,1,73,6,67,49,0,0
429,11/05/2021,3,3,122,25,97,49,0,0
411,01/05/2021,3,0,185,80,105,49,0,0
305,05/05/2021,3,2,57,14,43,49,0,0
621,03/05/2021,3,1,59,11,48,55,0,0
172,10/05/2021,3,2,83,32,51,49,0,0
188,12/05/2021,3,3,118,41,77,49,0,0
378,10/05/2021,3,0,84,42,42,49,0,0
104,12/05/2021,3,1,61,52,9,123,0,0
845,06/05/2021,3,1,119,45,74,49,0,0
651,01/05/2021,3,1,77,6,71,49,0,0
336,01/05/2021,3,1,73,33,40,49,0,0
552,06/05/2021,3,15,169,34,135,49,0,0
911,12/05/2021,3,0,158,3,155,49,0,0
646,03/05/2021,3,9,127,34,93,49,0,0
129,01/05/2021,3,9,191,185,6,62,0,0
178,05/05/2021,3,0,38,29,9,72,0,0
92,04/05/2021,3,1,121,22,99,49,0,0
266,06/05/2021,3,1,60,40,20,52,0,0
529,07/05/2021,3,4,37,6,31,49,0,0
430,04/05/2021,3,3,86,35,51,55,0,0
631,01/05/2021,3,1,70,9,61,49,0,0
89,02/05/2021,3,3,57,6,51,49,0,0
540,01/05/2021,3,1,81,12,69,49,0,0
416,09/05/2021,3,0,34,4,30,49,0,0
258,09/05/2021,3,1,142,25,117,49,0,0
705,02/05/2021,3,1,90,11,79,49,0,0
547,19/05/2021,3,0,74,73,1,95,0,0
806,14/05/2021,3,2,134,55,79,49,0,0
47,02/05/2021,3,2,55,24,31,49,0,0
440,10/05/2021,3,0,265,1,264,66,0,0
617,05/05/2021,3,1,43,28,15,55,0,0
665,05/05/2021,3,1,105,38,67,55,0,0
245,14/05/2021,3,5,92,52,40,49,0,0
56,13/05/2021,3,2,63,32,31,59,0,0
846,13/05/2021,3,4,185,22,163,45,0,0
110,10/05/2021,3,1,86,44,42,49,0,0
420,08/05/2021,3,2,67,53,14,74,0,0
589,06/05/2021,3,3,140,55,85,49,0,0
102,01/05/2021,3,0,60,25,35,49,0,0
384,06/05/2021,3,0,101,59,42,60,0,0
285,12/05/2021,3,0,80,35,45,59,0,0
530,06/05/2021,3,1,59,24,35,55,0,0
490,11/05/2021,3,5,160,11,149,49,0,0
918,03/05/2021,3,0,201,46,155,39,0,0
831,09/05/2021,3,3,147,14,133,49,0,0
26,11/05/2021,3,2,64,24,40,59,0,0
629,10/05/2021,3,2,60,40,20,57,0,0
403,04/05/2021,3,2,96,49,47,55,0,0
227,09/05/2021,3,2,42,8,34,49,0,0
860,11/05/2021,3,11,81,29,52,49,0,0
338,02/05/2021,3,0,400,83,317,49,0,0
785,05/05/2021,3,3,107,33,74,49,0,0
179,04/05/2021,3,2,90,36,54,55,0,0
815,10/05/2021,3,12,117,41,76,49,0,0
188,09/05/2021,3,5,116,12,104,49,0,0
504,10/05/2021,3,0,83,13,70,49,0,0
248,12/05/2021,3,0,82,26,56,55,0,0
214,05/05/2021,3,6,80,50,30,57,0,0
651,02/05/2021,3,1,77,9,68,49,0,0
599,01/05/2021,3,5,148,27,121,49,0,0
331,07/05/2021,3,3,91,20,71,49,0,0
337,12/05/2021,3,0,60,22,38,52,0,0
646,04/05/2021,3,11,125,47,78,49,0,0
756,01/05/2021,3,0,106,103,3,63,0,0
318,05/05/2021,3,0,59,49,10,88,0,0
813,04/05/2021,3,1,129,57,72,49,0,0
213,07/05/2021,3,4,144,140,4,65,0,0
529,06/05/2021,3,4,37,6,31,55,0,0
430,03/05/2021,3,3,86,38,48,55,0,0
91,02/05/2021,3,3,77,9,68,49,0,0
615,03/05/2021,3,0,71,13,58,49,0,0
768,01/05/2021,3,2,85,10,75,49,0,0
446,09/05/2021,3,8,125,30,95,49,0,0
118,01/05/2021,3,2,57,19,38,49,0,0
711,01/05/2021,3,1,88,15,73,49,0,0
159,21/05/2021,3,0,77,61,16,60,0,0
67,12/05/2021,3,1,51,26,25,59,0,0
765,02/05/2021,3,1,100,19,81,49,0,0
841,10/05/2021,3,0,182,34,148,55,0,0
106,06/05/2021,3,1,30,12,18,55,0,0
372,05/05/2021,3,3,89,59,30,60,0,0
677,14/05/2021,3,1,39,1,38,49,0,0
247,11/05/2021,3,3,90,51,39,55,0,0
797,15/05/2021,3,0,67,21,46,49,0,0
574,11/05/2021,3,1,86,20,66,49,0,0
190,08/05/2021,3,6,74,10,64,49,0,0
776,07/05/2021,3,0,104,11,93,49,0,0
743,02/05/2021,3,1,125,22,103,49,0,0
619,03/05/2021,3,0,101,15,86,55,0,0
626,11/05/2021,3,1,101,49,52,60,0,0
476,06/05/2021,3,1,172,17,155,49,0,0
339,12/05/2021,3,22,572,27,545,49,0,0
918,05/05/2021,3,0,201,34,167,39,0,0
855,07/05/2021,3,1,175,27,148,49,0,0
146,13/05/2021,3,2,39,20,19,55,0,0
20,11/05/2021,3,1,81,37,44,55,0,0
438,06/05/2021,3,16,80,46,34,93,0,0
612,09/05/2021,3,2,40,5,35,49,0,0
177,10/05/2021,3,0,48,28,20,64,0,0
411,02/05/2021,3,0,185,39,146,49,0,0
423,06/05/2021,3,3,47,17,30,55,0,0
201,04/05/2021,3,7,131,21,110,49,0,0
99,10/05/2021,3,0,167,43,124,49,0,0
501,10/05/2021,3,9,224,7,217,49,0,0
477,11/05/2021,3,4,116,29,87,49,0,0
934,02/05/2021,3,64,35,1,34,35,0,0
225,05/05/2021,3,11,69,32,37,55,0,0
578,01/05/2021,3,2,56,7,49,49,0,0
640,01/05/2021,3,5,121,32,89,49,0,0
645,07/05/2021,3,2,39,7,32,49,0,0
98,12/05/2021,3,1,94,89,5,89,0,0
497,02/05/2021,3,1,192,33,159,49,0,0
756,03/05/2021,3,0,106,58,48,59,0,0
565,05/05/2021,3,0,62,48,14,80,0,0
422,05/05/2021,3,1,78,28,50,49,0,0
252,06/05/2021,3,3,261,71,190,49,0,0
816,05/05/2021,3,4,78,53,25,64,0,0
373,05/05/2021,3,2,101,36,65,55,0,0
246,02/05/2021,3,3,109,25,84,49,0,0
122,01/05/2021,3,4,117,39,78,49,0,0
312,02/05/2021,3,4,93,41,52,49,0,0
522,09/05/2021,3,1,61,24,37,49,0,0
118,02/05/2021,3,4,55,10,45,49,0,0
638,01/05/2021,3,0,101,13,88,49,0,0
547,21/05/2021,3,0,74,50,24,142,0,0
657,12/05/2021,3,0,48,20,28,59,0,0
242,06/05/2021,3,3,135,62,73,49,0,0
86,09/05/2021,3,2,46,20,26,49,0,0
617,06/05/2021,3,1,43,11,32,55,0,0
659,06/05/2021,3,1,42,8,34,55,0,0
442,15/05/2021,3,1,157,31,126,49,0,0
247,13/05/2021,3,3,90,51,39,55,0,0
43,15/05/2021,3,2,71,10,61,49,0,0
832,11/05/2021,3,1,99,30,69,49,0,0
184,05/05/2021,3,0,51,30,21,72,0,0
198,08/05/2021,3,1,134,27,107,49,0,0
45,03/05/2021,3,11,145,7,138,49,0,0
564,06/05/2021,3,6,68,33,35,49,0,0
34,12/05/2021,3,3,85,50,35,72,0,0
38,07/05/2021,3,1,49,12,37,49,0,0
490,12/05/2021,3,4,161,8,153,49,0,0
658,03/05/2021,3,0,81,18,63,55,0,0
32,09/05/2021,3,1,104,31,73,49,0,0
63,11/05/2021,3,2,62,26,36,49,0,0
224,11/05/2021,3,1,56,22,34,52,0,0
715,06/05/2021,3,2,86,84,2,90,0,0
691,09/05/2021,3,1,31,5,26,49,0,0
854,10/05/2021,3,0,110,12,98,55,0,0
902,02/05/2021,3,2,124,8,116,49,0,0
305,07/05/2021,3,2,57,5,52,49,0,0
562,04/05/2021,3,1,67,34,33,49,0,0
334,10/05/2021,3,0,58,33,25,49,0,0
501,11/05/2021,3,9,224,8,216,49,0,0
504,11/05/2021,3,0,83,11,72,49,0,0
83,02/05/2021,3,38,130,55,75,49,0,0
214,04/05/2021,3,6,80,44,36,49,0,0
517,02/05/2021,3,3,55,16,39,49,0,0
13,02/05/2021,3,1,80,11,69,49,0,0
773,07/05/2021,3,1,73,16,57,49,0,0
814,12/05/2021,3,1,67,36,31,55,0,0
774,03/05/2021,3,0,105,14,91,49,0,0
756,04/05/2021,3,0,106,86,20,80,0,0
155,07/05/2021,3,0,93,9,84,49,0,0
813,05/05/2021,3,1,129,58,71,49,0,0
836,07/05/2021,3,2,99,35,64,49,0,0
173,06/05/2021,3,3,68,30,38,55,0,0
430,01/05/2021,3,0,89,34,55,55,0,0
87,02/05/2021,3,1,117,9,108,49,0,0
370,01/05/2021,3,1,39,9,30,49,0,0
557,02/05/2021,3,1,103,17,86,49,0,0
707,09/05/2021,3,2,38,17,21,49,0,0
258,02/05/2021,3,0,143,25,118,49,0,0
11,01/05/2021,3,2,82,16,66,49,0,0
721,12/05/2021,3,29,111,42,69,57,0,0
226,12/05/2021,3,0,47,33,14,85,0,0
879,03/05/2021,3,3,161,10,151,39,0,0
703,15/05/2021,3,1,90,19,71,49,0,0
865,06/05/2021,3,2,83,13,70,49,0,0
197,13/05/2021,3,0,118,39,79,49,0,0
444,19/05/2021,3,4,115,57,58,49,0,0
15,11/05/2021,3,0,31,11,20,59,0,0
360,14/05/2021,3,1,43,5,38,49,0,0
574,09/05/2021,3,0,87,9,78,49,0,0
420,06/05/2021,3,7,62,29,33,59,0,0
776,13/05/2021,3,0,104,38,66,49,0,0
543,03/05/2021,3,2,63,15,48,49,0,0
556,13/05/2021,3,0,117,48,69,49,0,0
626,12/05/2021,3,2,100,45,55,55,0,0
679,13/05/2021,3,2,87,59,28,72,0,0
791,12/05/2021,3,17,111,36,75,49,0,0
235,04/05/2021,3,6,151,27,124,49,0,0
855,09/05/2021,3,1,175,23,152,49,0,0
810,11/05/2021,3,0,389,31,358,55,0,0
676,11/05/2021,3,3,112,50,62,52,0,0
322,04/05/2021,3,0,100,15,85,49,0,0
481,07/05/2021,3,0,56,19,37,49,0,0
366,10/05/2021,3,0,80,76,4,80,0,0
304,03/05/2021,3,5,55,10,45,49,0,0
570,05/05/2021,3,0,149,49,100,49,0,0
653,12/05/2021,3,2,113,33,80,49,0,0
466,10/05/2021,3,0,140,35,105,49,0,0
601,09/05/2021,3,5,63,13,50,49,0,0
889,14/05/2021,3,1,123,6,117,45,0,0
934,04/05/2021,3,66,33,8,25,35,0,0
827,12/05/2021,3,1,69,34,35,55,0,0
24,07/05/2021,3,0,84,34,50,49,0,0
395,03/05/2021,3,2,70,10,60,49,0,0
291,07/05/2021,3,2,59,37,22,49,0,0
724,12/05/2021,3,2,84,82,2,114,0,0
105,02/05/2021,3,1,74,7,67,49,0,0
115,02/05/2021,3,3,112,18,94,49,0,0
279,06/05/2021,3,0,57,15,42,49,0,0
622,04/05/2021,3,1,43,14,29,55,0,0
875,07/05/2021,3,0,92,24,68,49,0,0
527,06/05/2021,3,10,51,34,17,60,0,0
430,02/05/2021,3,1,88,33,55,55,0,0
374,01/05/2021,3,0,56,6,50,49,0,0
852,09/05/2021,3,0,80,26,54,49,0,0
768,02/05/2021,3,2,85,10,75,49,0,0
491,11/05/2021,3,5,174,38,136,49,0,0
539,02/05/2021,3,2,95,2,93,49,0,0
170,01/05/2021,3,1,104,15,89,49,0,0
229,12/05/2021,3,1,55,44,11,90,0,0
67,14/05/2021,3,0,52,8,44,49,0,0
242,02/05/2021,3,3,135,100,35,52,0,0
685,16/05/2021,3,4,136,41,95,49,0,0
917,04/05/2021,3,3,103,16,87,35,0,0
35,13/05/2021,3,0,110,28,82,49,0,0
507,19/05/2021,3,4,196,58,138,49,0,0
399,12/05/2021,3,0,61,47,14,80,0,0
500,19/05/2021,3,5,74,43,31,52,0,0
598,09/05/2021,3,0,146,56,90,49,0,0
420,07/05/2021,3,2,67,39,28,55,0,0
42,12/05/2021,3,2,97,56,41,60,0,0
743,07/05/2021,3,1,125,16,109,49,0,0
556,12/05/2021,3,0,117,30,87,49,0,0
805,12/05/2021,3,3,110,48,62,55,0,0
679,14/05/2021,3,2,87,86,1,59,0,0
53,11/05/2021,3,0,70,37,33,72,0,0
658,04/05/2021,3,0,81,31,50,55,0,0
277,15/05/2021,3,4,68,28,40,49,0,0
317,11/05/2021,3,0,80,46,34,64,0,0
779,16/05/2021,3,0,104,8,96,49,0,0
322,06/05/2021,3,0,100,8,92,49,0,0
861,08/05/2021,3,0,61,38,23,49,0,0
232,16/05/2021,3,3,62,22,40,49,0,0
338,03/05/2021,3,0,400,77,323,49,0,0
187,07/05/2021,3,1,40,13,27,49,0,0
179,11/05/2021,3,1,91,41,50,59,0,0
99,15/05/2021,3,0,167,38,129,49,0,0
188,10/05/2021,3,4,117,30,87,49,0,0
406,13/05/2021,3,1,38,17,21,59,0,0
804,03/05/2021,3,3,142,17,125,49,0,0
618,11/05/2021,3,12,139,56,83,49,0,0
24,08/05/2021,3,1,83,44,39,49,0,0
605,03/05/2021,3,4,156,26,130,49,0,0
291,05/05/2021,3,1,60,39,21,52,0,0
329,12/05/2021,3,9,98,10,88,49,0,0
646,07/05/2021,3,9,127,34,93,49,0,0
115,03/05/2021,3,3,112,15,97,49,0,0
628,05/05/2021,3,1,58,18,40,59,0,0
202,16/05/2021,3,0,76,28,48,49,0,0
213,05/05/2021,3,16,132,132,0,NA,NA,NA
142,05/05/2021,3,1,61,36,25,59,0,0
430,05/05/2021,3,2,87,35,52,55,0,0
625,04/05/2021,3,0,161,28,133,49,0,0
171,07/05/2021,3,2,47,8,39,49,0,0
540,03/05/2021,3,3,79,13,66,49,0,0
491,14/05/2021,3,5,174,35,139,49,0,0
873,02/05/2021,3,4,97,11,86,49,0,0
717,01/05/2021,3,3,190,16,174,49,0,0
561,11/05/2021,3,1,59,58,1,119,0,0
226,14/05/2021,3,0,47,9,38,49,0,0
488,03/05/2021,3,0,66,17,49,55,0,0
703,16/05/2021,3,1,90,15,75,49,0,0
617,10/05/2021,3,1,43,24,19,60,0,0
197,12/05/2021,3,0,118,39,79,49,0,0
133,20/05/2021,3,2,62,30,32,49,0,0
15,13/05/2021,3,0,31,21,10,72,0,0
712,21/05/2021,3,6,79,51,28,55,0,0
647,14/05/2021,3,2,91,63,28,49,0,0
689,06/05/2021,3,1,129,40,89,49,0,0
198,13/05/2021,3,2,133,81,52,64,0,0
45,08/05/2021,3,2,154,2,152,49,0,0
75,14/05/2021,3,0,81,12,69,49,0,0
206,17/05/2021,3,16,197,134,63,59,0,0
530,12/05/2021,3,1,59,34,25,59,0,0
441,11/05/2021,3,0,168,20,148,55,0,0
681,05/05/2021,3,2,69,34,35,60,0,0
314,15/05/2021,3,1,68,16,52,49,0,0
148,13/05/2021,3,0,25,4,21,49,0,0
781,16/05/2021,3,4,79,26,53,49,0,0
308,06/05/2021,3,2,46,7,39,49,0,0
452,13/05/2021,3,3,57,48,9,74,0,0
429,16/05/2021,3,3,122,10,112,49,0,0
493,01/05/2021,3,2,33,9,24,55,0,0
276,06/05/2021,3,4,200,36,164,49,0,0
179,12/05/2021,3,1,91,41,50,59,0,0
868,15/05/2021,3,0,83,6,77,49,0,0
697,10/05/2021,3,1,108,31,77,49,0,0
586,13/05/2021,3,4,79,64,15,72,0,0
899,03/05/2021,3,4,101,12,89,49,0,0
845,10/05/2021,3,1,119,67,52,49,0,0
680,08/05/2021,3,3,77,42,35,49,0,0
640,03/05/2021,3,0,126,36,90,49,0,0
771,06/05/2021,3,2,28,18,10,57,0,0
313,12/05/2021,3,0,31,27,4,115,0,0
497,08/05/2021,3,1,192,49,143,49,0,0
616,01/05/2021,3,3,72,11,61,49,0,0
786,11/05/2021,3,1,61,14,47,49,0,0
92,15/05/2021,3,1,121,49,72,49,0,0
51,16/05/2021,3,2,78,28,50,49,0,0
394,05/05/2021,3,4,64,23,41,49,0,0
758,03/05/2021,3,0,73,18,55,55,0,0
87,05/05/2021,3,2,116,23,93,49,0,0
700,08/05/2021,3,4,128,70,58,49,0,0
768,03/05/2021,3,2,85,9,76,49,0,0
666,14/05/2021,3,2,64,10,54,49,0,0
230,03/05/2021,3,0,80,11,69,49,0,0
170,02/05/2021,3,2,103,15,88,49,0,0
713,12/05/2021,3,1,60,59,1,85,0,0
669,14/05/2021,3,0,87,10,77,49,0,0
765,04/05/2021,3,1,100,62,38,60,0,0
748,16/05/2021,3,5,139,20,119,49,0,0
262,11/05/2021,3,2,49,36,13,60,0,0
919,11/05/2021,3,0,123,18,105,49,0,0
442,20/05/2021,3,8,150,67,83,49,0,0
462,11/05/2021,3,0,189,8,181,55,0,0
500,21/05/2021,3,5,74,31,43,55,0,0
439,14/05/2021,3,5,86,8,78,49,0,0
817,06/05/2021,3,2,81,31,50,49,0,0
648,13/05/2021,3,0,64,34,30,59,0,0
126,05/05/2021,3,1,119,40,79,49,0,0
323,15/05/2021,3,0,31,8,23,49,0,0
285,17/05/2021,3,1,79,46,33,55,0,0
407,02/05/2021,3,2,39,7,32,49,0,0
830,11/05/2021,3,0,66,27,39,59,0,0
675,04/05/2021,3,1,55,26,29,67,0,0
831,14/05/2021,3,0,150,22,128,49,0,0
513,03/05/2021,3,2,75,15,60,49,0,0
867,16/05/2021,3,1,59,35,24,49,0,0
509,06/05/2021,3,1,111,21,90,49,0,0
127,13/05/2021,3,1,59,18,41,55,0,0
860,16/05/2021,3,12,80,20,60,49,0,0
330,03/05/2021,3,2,117,18,99,55,0,0
189,05/05/2021,3,0,165,106,59,64,0,0
741,12/05/2021,3,0,70,40,30,49,0,0
520,16/05/2021,3,0,58,8,50,49,0,0
733,09/05/2021,3,0,100,17,83,49,0,0
378,13/05/2021,3,1,83,47,36,49,0,0
83,04/05/2021,3,42,126,43,83,49,0,0
31,11/05/2021,3,1,62,20,42,52,0,0
260,10/05/2021,3,0,120,42,78,49,0,0
599,04/05/2021,3,5,148,90,58,49,0,0
116,07/05/2021,3,0,61,21,40,49,0,0
911,13/05/2021,3,0,158,6,152,49,0,0
585,09/05/2021,3,5,55,13,42,49,0,0
542,02/05/2021,3,4,71,9,62,49,0,0
478,02/05/2021,3,1,19,12,7,52,0,0
422,14/05/2021,3,1,78,30,48,49,0,0
266,16/05/2021,3,0,61,21,40,49,0,0
496,05/05/2021,3,1,59,19,40,49,0,0
758,04/05/2021,3,0,73,37,36,55,0,0
625,05/05/2021,3,0,161,38,123,49,0,0
700,09/05/2021,3,4,128,27,101,49,0,0
249,04/05/2021,3,1,126,80,46,49,0,0
882,14/05/2021,3,0,130,20,110,39,0,0
284,03/05/2021,3,1,25,6,19,49,0,0
409,02/05/2021,3,3,104,42,62,49,0,0
587,11/05/2021,3,2,79,35,44,55,0,0
806,13/05/2021,3,2,134,104,30,67,0,0
18,06/05/2021,3,3,89,34,55,49,0,0
487,07/05/2021,3,0,39,4,35,49,0,0
183,09/05/2021,3,2,78,20,58,49,0,0
35,12/05/2021,3,0,110,32,78,49,0,0
507,20/05/2021,3,4,196,72,124,49,0,0
162,11/05/2021,3,0,122,35,87,49,0,0
797,21/05/2021,3,0,67,55,12,133,0,0
584,14/05/2021,3,3,94,34,60,49,0,0
131,07/05/2021,3,2,47,13,34,49,0,0
147,12/05/2021,3,1,79,36,43,52,0,0
45,06/05/2021,3,9,147,17,130,49,0,0
384,15/05/2021,3,0,101,32,69,49,0,0
76,18/05/2021,3,1,92,86,6,62,0,0
174,01/05/2021,3,2,26,1,25,49,0,0
53,13/05/2021,3,0,70,43,27,72,0,0
632,04/05/2021,3,0,82,41,41,60,0,0
505,15/05/2021,3,0,84,12,72,49,0,0
812,04/05/2021,3,2,135,41,94,49,0,0
224,17/05/2021,3,1,56,23,33,49,0,0
764,04/05/2021,3,2,67,37,30,55,0,0
227,14/05/2021,3,2,42,19,23,49,0,0
108,08/05/2021,3,0,78,10,68,49,0,0
210,07/05/2021,3,2,100,97,3,71,0,0
189,06/05/2021,3,0,165,97,68,59,0,0
201,11/05/2021,3,4,134,15,119,49,0,0
466,14/05/2021,3,0,140,19,121,49,0,0
733,10/05/2021,3,0,100,15,85,49,0,0
406,14/05/2021,3,1,38,21,17,49,0,0
112,04/05/2021,3,1,83,22,61,49,0,0
21,12/05/2021,3,1,59,7,52,49,0,0
517,10/05/2021,3,1,57,37,20,49,0,0
283,01/05/2021,3,1,75,9,66,49,0,0
606,06/05/2021,3,1,45,12,33,49,0,0
55,12/05/2021,3,1,32,12,20,55,0,0
774,09/05/2021,3,4,101,18,83,49,0,0
662,02/05/2021,3,1,106,9,97,49,0,0
628,02/05/2021,3,1,58,5,53,49,0,0
3,16/05/2021,3,8,105,23,82,49,0,0
252,17/05/2021,3,2,262,115,147,49,0,0
390,05/05/2021,3,2,134,35,99,49,0,0
373,04/05/2021,3,2,101,38,63,55,0,0
374,05/05/2021,3,0,56,28,28,55,0,0
852,06/05/2021,3,0,80,23,57,49,0,0
768,04/05/2021,3,1,86,17,69,49,0,0
882,15/05/2021,3,0,130,19,111,39,0,0
234,01/05/2021,3,1,61,30,31,49,0,0
711,02/05/2021,3,1,88,13,75,49,0,0
811,11/05/2021,3,2,88,32,56,55,0,0
57,12/05/2021,3,1,139,35,104,49,0,0
221,05/05/2021,3,1,61,23,38,55,0,0
703,07/05/2021,3,0,91,11,80,49,0,0
755,11/05/2021,3,0,87,54,33,72,0,0
919,12/05/2021,3,1,122,13,109,49,0,0
608,20/05/2021,3,9,131,67,64,49,0,0
474,11/05/2021,3,0,112,45,67,49,0,0
637,12/05/2021,3,4,70,39,31,49,0,0
110,15/05/2021,3,1,86,9,77,49,0,0
190,07/05/2021,3,6,74,9,65,49,0,0
17,13/05/2021,3,1,93,77,16,67,0,0
543,06/05/2021,3,1,64,22,42,49,0,0
556,15/05/2021,3,0,117,52,65,49,0,0
206,18/05/2021,3,16,197,126,71,59,0,0
476,01/05/2021,3,0,173,5,168,49,0,0
339,20/05/2021,3,15,579,52,527,49,0,0
675,03/05/2021,3,2,54,17,37,49,0,0
314,14/05/2021,3,2,67,13,54,49,0,0
26,05/05/2021,3,1,65,36,29,55,0,0
254,17/05/2021,3,1,77,45,32,49,0,0
58,05/05/2021,3,1,66,53,13,74,0,0
275,14/05/2021,3,5,112,34,78,49,0,0
177,08/05/2021,3,0,48,5,43,49,0,0
28,05/05/2021,3,2,126,100,26,85,0,0
653,11/05/2021,3,2,113,34,79,49,0,0
334,15/05/2021,3,0,58,11,47,49,0,0
697,09/05/2021,3,1,108,20,88,49,0,0
175,14/05/2021,3,0,120,11,109,49,0,0
535,04/05/2021,3,0,83,21,62,49,0,0
483,12/05/2021,3,4,95,19,76,49,0,0
260,11/05/2021,3,0,120,37,83,49,0,0
377,02/05/2021,3,2,147,27,120,49,0,0
181,12/05/2021,3,1,33,18,15,59,0,0
646,09/05/2021,3,17,119,22,97,49,0,0
129,03/05/2021,3,9,191,37,154,49,0,0
786,02/05/2021,3,1,61,6,55,49,0,0
813,14/05/2021,3,1,129,13,116,49,0,0
684,17/05/2021,3,2,96,50,46,49,0,0
394,06/05/2021,3,4,64,14,50,49,0,0
575,04/05/2021,3,1,49,23,26,59,0,0
572,03/05/2021,3,1,60,9,51,55,0,0
615,07/05/2021,3,0,71,19,52,49,0,0
540,04/05/2021,3,2,80,39,41,49,0,0
239,15/05/2021,3,0,40,23,17,55,0,0
734,03/05/2021,3,2,59,16,43,59,0,0
866,02/05/2021,3,0,100,5,95,49,0,0
90,11/05/2021,3,0,78,53,25,74,0,0
57,13/05/2021,3,1,139,36,103,49,0,0
47,03/05/2021,3,2,55,28,27,59,0,0
263,08/05/2021,3,0,66,24,42,49,0,0
193,10/05/2021,3,1,107,37,70,49,0,0
295,13/05/2021,3,3,102,19,83,49,0,0
687,20/05/2021,3,2,85,49,36,49,0,0
186,13/05/2021,3,1,57,35,22,49,0,0
114,12/05/2021,3,0,75,75,0,NA,NA,NA
838,15/05/2021,3,3,62,24,38,49,0,0
593,07/05/2021,3,3,78,35,43,49,0,0
589,12/05/2021,3,2,141,58,83,55,0,0
582,07/05/2021,3,0,53,24,29,49,0,0
544,16/05/2021,3,0,53,5,48,49,0,0
385,18/05/2021,3,3,60,37,23,59,0,0
476,03/05/2021,3,0,173,5,168,49,0,0
486,20/05/2021,3,0,124,50,74,49,0,0
235,03/05/2021,3,6,151,13,138,49,0,0
855,15/05/2021,3,1,175,49,126,49,0,0
317,04/05/2021,3,20,60,32,28,67,0,0
282,17/05/2021,3,28,673,74,599,49,0,0
579,04/05/2021,3,0,44,11,33,49,0,0
452,14/05/2021,3,3,57,13,44,55,0,0
623,08/05/2021,3,0,78,8,70,49,0,0
28,06/05/2021,3,2,126,86,40,60,0,0
641,12/05/2021,3,0,160,13,147,49,0,0
485,15/05/2021,3,0,65,9,56,49,0,0
97,16/05/2021,3,6,101,33,68,49,0,0
93,13/05/2021,3,3,138,41,97,49,0,0
248,03/05/2021,3,0,82,20,62,49,0,0
208,11/05/2021,3,0,60,29,31,59,0,0
517,09/05/2021,3,1,57,12,45,49,0,0
395,02/05/2021,3,4,68,13,55,49,0,0
319,12/05/2021,3,8,106,68,38,60,0,0
798,07/05/2021,3,1,80,26,54,49,0,0
9,01/05/2021,3,0,27,27,0,NA,NA,NA
178,01/05/2021,3,0,38,12,26,49,0,0
202,14/05/2021,3,0,76,63,13,60,0,0
163,17/05/2021,3,2,60,60,0,NA,NA,NA
390,07/05/2021,3,2,134,10,124,49,0,0
551,04/05/2021,3,0,115,68,47,52,0,0
374,04/05/2021,3,0,56,23,33,60,0,0
700,07/05/2021,3,4,128,49,79,49,0,0
249,02/05/2021,3,1,126,92,34,52,0,0
182,08/05/2021,3,2,78,6,72,49,0,0
364,03/05/2021,3,3,127,65,62,59,0,0
638,02/05/2021,3,21,80,5,75,49,0,0
164,12/05/2021,3,0,62,27,35,49,0,0
368,13/05/2021,3,1,84,43,41,49,0,0
765,03/05/2021,3,1,100,26,74,55,0,0
216,08/05/2021,3,1,57,3,54,49,0,0
519,10/05/2021,3,0,64,39,25,55,0,0
639,13/05/2021,3,0,59,4,55,49,0,0
231,12/05/2021,3,0,41,23,18,60,0,0
436,13/05/2021,3,2,204,70,134,49,0,0
217,11/05/2021,3,1,40,39,1,103,0,0
832,15/05/2021,3,1,99,7,92,49,0,0
190,06/05/2021,3,7,73,24,49,49,0,0
607,13/05/2021,3,1,74,35,39,55,0,0
102,08/05/2021,3,0,60,22,38,49,0,0
619,13/05/2021,3,0,101,28,73,55,0,0
857,17/05/2021,3,1,209,51,158,49,0,0
476,02/05/2021,3,0,173,5,168,49,0,0
490,20/05/2021,3,6,159,19,140,49,0,0
418,03/05/2021,3,2,114,13,101,49,0,0
176,14/05/2021,3,3,97,9,88,49,0,0
146,03/05/2021,3,2,39,21,18,55,0,0
207,16/05/2021,3,2,61,8,53,49,0,0
509,04/05/2021,3,1,111,28,83,49,0,0
222,14/05/2021,3,1,76,3,73,49,0,0
366,07/05/2021,3,0,80,17,63,49,0,0
187,05/05/2021,3,1,40,17,23,52,0,0
621,12/05/2021,3,1,59,47,12,82,0,0
485,14/05/2021,3,0,65,3,62,49,0,0
610,16/05/2021,3,1,66,13,53,49,0,0
175,13/05/2021,3,0,120,33,87,49,0,0
934,03/05/2021,3,64,35,6,29,35,0,0
208,12/05/2021,3,0,60,24,36,59,0,0
694,11/05/2021,3,3,106,36,70,49,0,0
640,02/05/2021,3,5,121,28,93,49,0,0
808,12/05/2021,3,11,157,81,76,55,0,0
166,08/05/2021,3,4,62,25,37,49,0,0
115,09/05/2021,3,0,115,13,102,49,0,0
565,01/05/2021,3,0,62,20,42,49,0,0
202,15/05/2021,3,0,76,58,18,67,0,0
51,08/05/2021,3,2,78,10,68,49,0,0
167,05/05/2021,3,0,84,80,4,127,0,0
872,03/05/2021,3,1,64,27,37,59,0,0
435,01/05/2021,3,49,71,12,59,49,0,0
122,06/05/2021,3,6,115,55,60,49,0,0
557,03/05/2021,3,1,103,15,88,55,0,0
784,07/05/2021,3,3,46,12,34,49,0,0
364,02/05/2021,3,3,127,90,37,64,0,0
717,02/05/2021,3,3,190,16,174,49,0,0
168,11/05/2021,3,0,48,26,22,72,0,0
437,13/05/2021,3,2,163,86,77,49,0,0
242,05/05/2021,3,3,135,71,64,52,0,0
86,07/05/2021,3,1,47,20,27,49,0,0
755,10/05/2021,3,0,87,40,47,64,0,0
674,13/05/2021,3,1,97,11,86,49,0,0
677,12/05/2021,3,0,40,16,24,49,0,0
512,13/05/2021,3,2,60,29,31,49,0,0
500,11/05/2021,3,5,74,28,46,52,0,0
686,14/05/2021,3,0,46,6,40,49,0,0
778,07/05/2021,3,1,80,51,29,49,0,0
147,11/05/2021,3,0,80,36,44,49,0,0
126,08/05/2021,3,1,119,44,75,49,0,0
384,12/05/2021,3,0,101,52,49,59,0,0
857,18/05/2021,3,1,209,65,144,49,0,0
530,03/05/2021,3,1,59,14,45,55,0,0
256,20/05/2021,3,0,109,70,39,49,0,0
863,03/05/2021,3,8,87,7,80,49,0,0
434,15/05/2021,3,3,57,10,47,49,0,0
240,01/05/2021,3,0,71,66,5,57,0,0
396,16/05/2021,3,1,29,15,14,49,0,0
218,05/05/2021,3,3,75,44,31,49,0,0
691,14/05/2021,3,1,31,16,15,49,0,0
480,07/05/2021,3,0,28,6,22,49,0,0
696,05/05/2021,3,1,88,39,49,60,0,0
562,11/05/2021,3,1,67,39,28,49,0,0
868,08/05/2021,3,4,79,4,75,49,0,0
697,16/05/2021,3,1,108,26,82,49,0,0
477,13/05/2021,3,4,116,45,71,49,0,0
264,04/05/2021,3,1,59,21,38,55,0,0
31,02/05/2021,3,1,62,4,58,49,0,0
469,07/05/2021,3,4,192,18,174,66,0,0
283,03/05/2021,3,1,75,9,66,49,0,0
459,12/05/2021,3,3,89,49,40,49,0,0
646,08/05/2021,3,11,125,31,94,49,0,0
9,06/05/2021,3,0,27,18,9,60,0,0
279,02/05/2021,3,0,57,6,51,49,0,0
3,14/05/2021,3,6,107,40,67,49,0,0
163,08/05/2021,3,1,61,41,20,52,0,0
527,05/05/2021,3,8,53,53,0,NA,NA,NA
650,01/05/2021,3,1,127,24,103,49,0,0
205,02/05/2021,3,1,125,31,94,49,0,0
700,06/05/2021,3,4,128,29,99,49,0,0
348,04/05/2021,3,46,94,79,15,70,0,0
491,08/05/2021,3,6,173,19,154,49,0,0
539,01/05/2021,3,2,95,6,89,49,0,0
614,01/05/2021,3,2,80,11,69,49,0,0
713,13/05/2021,3,1,60,60,0,NA,NA,NA
560,13/05/2021,3,0,80,42,38,49,0,0
826,03/05/2021,3,2,96,20,76,55,0,0
624,08/05/2021,3,1,78,12,66,49,0,0
848,10/05/2021,3,6,132,17,115,35,0,0
919,13/05/2021,3,1,122,16,106,49,0,0
25,13/05/2021,3,1,51,30,21,49,0,0
269,12/05/2021,3,1,79,11,68,49,0,0
79,12/05/2021,3,2,44,31,13,72,0,0
352,14/05/2021,3,0,64,13,51,49,0,0
342,06/05/2021,3,0,114,38,76,49,0,0
287,11/05/2021,3,3,120,55,65,49,0,0
199,06/05/2021,3,2,80,48,32,49,0,0
619,12/05/2021,3,0,101,35,66,59,0,0
805,17/05/2021,3,0,113,62,51,49,0,0
174,03/05/2021,3,2,26,1,25,55,0,0
643,20/05/2021,3,2,101,58,43,49,0,0
534,04/05/2021,3,0,85,24,61,49,0,0
314,06/05/2021,3,1,68,68,0,NA,NA,NA
345,03/05/2021,3,0,101,27,74,59,0,0
254,16/05/2021,3,1,77,7,70,49,0,0
218,04/05/2021,3,1,77,37,40,49,0,0
742,14/05/2021,3,1,73,7,66,49,0,0
588,07/05/2021,3,1,58,13,45,49,0,0
696,06/05/2021,3,1,88,24,64,55,0,0
201,12/05/2021,3,4,134,13,121,49,0,0
334,08/05/2021,3,0,58,15,43,49,0,0
870,16/05/2021,3,4,42,18,24,49,0,0
795,13/05/2021,3,4,101,57,44,55,0,0
402,04/05/2021,3,0,155,36,119,49,0,0
827,02/05/2021,3,1,69,69,0,NA,NA,NA
469,10/05/2021,3,4,192,45,147,66,0,0
405,03/05/2021,3,1,89,23,66,49,0,0
301,13/05/2021,3,1,100,40,60,49,0,0
298,09/05/2021,3,2,227,40,187,49,0,0
662,06/05/2021,3,3,104,25,79,49,0,0
155,02/05/2021,3,0,93,5,88,49,0,0
3,15/05/2021,3,7,106,32,74,49,0,0
128,09/05/2021,3,1,20,1,19,49,0,0
209,06/05/2021,3,1,113,83,30,67,0,0
758,01/05/2021,3,0,73,33,40,49,0,0
435,02/05/2021,3,49,71,9,62,49,0,0
122,08/05/2021,3,5,116,37,79,49,0,0
670,04/05/2021,3,5,103,62,41,55,0,0
267,07/05/2021,3,2,81,26,55,49,0,0
734,01/05/2021,3,2,59,33,26,49,0,0
11,02/05/2021,3,2,82,6,76,49,0,0
149,11/05/2021,3,0,88,49,39,55,0,0
560,14/05/2021,3,0,80,20,60,49,0,0
826,04/05/2021,3,2,96,28,68,55,0,0
233,08/05/2021,3,4,63,5,58,49,0,0
183,11/05/2021,3,1,79,35,44,64,0,0
270,11/05/2021,3,1,59,32,27,64,0,0
25,12/05/2021,3,1,51,30,21,60,0,0
474,12/05/2021,3,0,112,46,66,49,0,0
217,12/05/2021,3,1,40,27,13,62,0,0
506,15/05/2021,3,0,195,9,186,49,0,0
342,08/05/2021,3,0,114,14,100,49,0,0
413,11/05/2021,3,1,115,50,65,49,0,0
706,06/05/2021,3,2,72,38,34,49,0,0
323,12/05/2021,3,0,31,24,7,82,0,0
750,19/05/2021,3,2,110,110,0,NA,NA,NA
821,01/05/2021,3,2,77,41,36,49,0,0
818,20/05/2021,3,1,80,80,0,NA,NA,NA
235,05/05/2021,3,6,151,20,131,49,0,0
121,06/05/2021,3,0,110,68,42,60,0,0
345,04/05/2021,3,0,101,70,31,64,0,0
347,17/05/2021,3,14,48,38,10,62,0,0
308,05/05/2021,3,2,46,9,37,49,0,0
481,14/05/2021,3,0,56,3,53,49,0,0
33,07/05/2021,3,4,76,43,33,57,0,0
777,06/05/2021,3,3,117,49,68,49,0,0
414,12/05/2021,3,18,168,17,151,49,0,0
485,07/05/2021,3,0,65,6,59,49,0,0
499,17/05/2021,3,0,31,17,14,49,0,0
702,14/05/2021,3,1,49,10,39,55,0,0
112,03/05/2021,3,2,82,19,63,49,0,0
225,02/05/2021,3,10,70,5,65,49,0,0
425,11/05/2021,3,3,247,27,220,66,0,0
468,03/05/2021,3,0,96,18,78,49,0,0
319,13/05/2021,3,8,106,68,38,49,0,0
7,08/05/2021,3,5,98,28,70,49,0,0
344,07/05/2021,3,1,64,14,50,49,0,0
735,01/05/2021,3,1,28,2,26,49,0,0
92,16/05/2021,3,1,121,29,92,49,0,0
321,09/05/2021,3,1,39,2,37,49,0,0
433,07/05/2021,3,2,316,21,295,66,0,0
839,01/05/2021,3,4,151,51,100,49,0,0
572,02/05/2021,3,1,60,14,46,49,0,0
171,08/05/2021,3,2,47,10,37,49,0,0
898,01/05/2021,3,0,100,27,73,49,0,0
790,07/05/2021,3,1,98,23,75,66,0,0
284,01/05/2021,3,1,25,13,12,49,0,0
614,02/05/2021,3,2,80,11,69,49,0,0
794,11/05/2021,3,0,137,22,115,55,0,0
57,14/05/2021,3,1,139,13,126,49,0,0
18,03/05/2021,3,2,90,19,71,49,0,0
487,08/05/2021,3,0,39,2,37,49,0,0
228,10/05/2021,3,2,40,15,25,49,0,0
659,11/05/2021,3,1,42,11,31,55,0,0
119,12/05/2021,3,3,65,19,46,49,0,0
251,13/05/2021,3,0,124,49,75,49,0,0
712,11/05/2021,3,2,83,15,68,49,0,0
598,15/05/2021,3,0,146,36,110,49,0,0
259,05/05/2021,3,0,60,42,18,60,0,0
589,13/05/2021,3,2,141,83,58,49,0,0
199,08/05/2021,3,2,80,12,68,49,0,0
75,13/05/2021,3,0,81,23,58,49,0,0
857,08/05/2021,3,4,206,73,133,49,0,0
174,02/05/2021,3,2,26,1,25,49,0,0
203,16/05/2021,3,0,40,4,36,49,0,0
418,01/05/2021,3,2,114,28,86,49,0,0
389,04/05/2021,3,2,124,29,95,49,0,0
240,04/05/2021,3,1,70,51,19,52,0,0
869,17/05/2021,3,3,57,51,6,80,0,0
218,06/05/2021,3,3,75,38,37,49,0,0
772,14/05/2021,3,0,57,8,49,49,0,0
120,08/05/2021,3,2,152,24,128,49,0,0
423,07/05/2021,3,3,47,28,19,49,0,0
741,11/05/2021,3,0,70,36,34,49,0,0
485,08/05/2021,3,0,65,5,60,49,0,0
601,18/05/2021,3,5,63,34,29,49,0,0
883,14/05/2021,3,6,98,20,78,45,0,0
688,03/05/2021,3,7,112,35,77,49,0,0
21,03/05/2021,3,1,59,5,54,49,0,0
24,10/05/2021,3,1,83,62,21,52,0,0
468,04/05/2021,3,1,95,23,72,49,0,0
329,13/05/2021,3,9,98,14,84,49,0,0
298,08/05/2021,3,2,227,68,159,49,0,0
428,06/05/2021,3,4,88,55,33,55,0,0
735,02/05/2021,3,1,28,2,26,49,0,0
422,15/05/2021,3,1,78,23,55,49,0,0
213,09/05/2021,3,3,145,40,105,49,0,0
209,05/05/2021,3,1,113,82,31,67,0,0
839,02/05/2021,3,4,151,44,107,49,0,0
246,01/05/2021,3,3,109,37,72,55,0,0
745,06/05/2021,3,3,102,53,49,55,0,0
898,02/05/2021,3,0,100,24,76,49,0,0
281,08/05/2021,3,0,83,7,76,49,0,0
234,02/05/2021,3,1,61,20,41,49,0,0
866,01/05/2021,3,0,100,9,91,49,0,0
567,13/05/2021,3,0,61,24,37,55,0,0
437,12/05/2021,3,2,163,71,92,49,0,0
759,03/05/2021,3,2,85,25,60,49,0,0
369,08/05/2021,3,6,84,7,77,49,0,0
865,10/05/2021,3,1,84,10,74,49,0,0
659,12/05/2021,3,2,41,10,31,55,0,0
200,12/05/2021,3,6,113,90,23,74,0,0
192,13/05/2021,3,0,86,33,53,49,0,0
907,11/05/2021,3,3,77,41,36,55,0,0
506,14/05/2021,3,0,195,14,181,49,0,0
259,07/05/2021,3,0,60,27,33,49,0,0
361,05/05/2021,3,38,27,16,11,80,0,0
341,08/05/2021,3,2,112,39,73,49,0,0
75,16/05/2021,3,0,81,8,73,49,0,0
385,08/05/2021,3,1,62,20,42,49,0,0
357,02/05/2021,3,2,81,11,70,49,0,0
818,14/05/2021,3,1,80,80,0,NA,NA,NA
534,02/05/2021,3,0,85,18,67,49,0,0
176,05/05/2021,3,4,96,24,72,49,0,0
812,01/05/2021,3,2,135,21,114,49,0,0
20,17/05/2021,3,3,79,72,7,74,0,0
715,04/05/2021,3,2,86,82,4,125,0,0
742,06/05/2021,3,1,73,24,49,55,0,0
274,08/05/2021,3,2,208,7,201,39,0,0
777,07/05/2021,3,3,117,24,93,49,0,0
445,05/05/2021,3,1,168,52,116,49,0,0
520,08/05/2021,3,0,58,14,44,49,0,0
859,18/05/2021,3,1,84,11,73,49,0,0
69,08/05/2021,3,1,59,4,55,49,0,0
804,04/05/2021,3,3,142,16,126,49,0,0
208,03/05/2021,3,0,60,19,41,55,0,0
24,11/05/2021,3,1,83,64,19,57,0,0
405,04/05/2021,3,1,89,35,54,49,0,0
856,13/05/2021,3,0,120,14,106,49,0,0
166,09/05/2021,3,4,62,12,50,49,0,0
756,06/05/2021,3,0,106,66,40,59,0,0
786,01/05/2021,3,1,61,6,55,49,0,0
813,15/05/2021,3,1,129,24,105,49,0,0
684,09/05/2021,3,3,95,5,90,49,0,0
390,06/05/2021,3,2,134,28,106,49,0,0
650,03/05/2021,3,4,124,18,106,49,0,0
625,06/05/2021,3,0,161,51,110,49,0,0
171,06/05/2021,3,2,47,32,15,52,0,0
670,03/05/2021,3,0,108,21,87,49,0,0
416,07/05/2021,3,0,34,4,30,49,0,0
284,02/05/2021,3,1,25,10,15,49,0,0
424,01/05/2021,3,1,27,27,0,NA,NA,NA
746,12/05/2021,3,3,57,37,20,64,0,0
669,13/05/2021,3,0,87,36,51,49,0,0
154,04/05/2021,3,1,103,30,73,49,0,0
634,08/05/2021,3,1,19,17,2,77,0,0
451,09/05/2021,3,2,81,30,51,66,0,0
372,13/05/2021,3,4,88,49,39,64,0,0
608,12/05/2021,3,14,126,36,90,49,0,0
825,12/05/2021,3,3,143,32,111,49,0,0
311,11/05/2021,3,1,96,42,54,55,0,0
484,14/05/2021,3,0,40,11,29,49,0,0
271,06/05/2021,3,0,70,24,46,49,0,0
147,04/05/2021,3,1,79,43,36,52,0,0
706,05/05/2021,3,3,71,38,33,49,0,0
215,16/05/2021,3,0,46,13,33,49,0,0
750,08/05/2021,3,2,110,53,57,49,0,0
679,02/05/2021,3,2,87,69,18,72,0,0
818,15/05/2021,3,1,80,80,0,NA,NA,NA
632,02/05/2021,3,0,82,11,71,49,0,0
277,06/05/2021,3,4,68,26,42,49,0,0
63,02/05/2021,3,2,62,8,54,49,0,0
207,17/05/2021,3,1,62,30,32,59,0,0
58,06/05/2021,3,1,66,55,11,67,0,0
691,06/05/2021,3,1,31,11,20,64,0,0
429,08/05/2021,3,3,122,7,115,49,0,0
895,07/05/2021,3,0,69,17,52,49,0,0
343,05/05/2021,3,1,61,39,22,67,0,0
803,08/05/2021,3,1,68,14,54,49,0,0
733,16/05/2021,3,0,100,10,90,49,0,0
537,08/05/2021,3,3,99,79,20,62,0,0
899,04/05/2021,3,9,96,29,67,49,0,0
827,03/05/2021,3,1,69,19,50,55,0,0
580,11/05/2021,3,0,98,41,57,55,0,0
395,01/05/2021,3,3,69,16,53,49,0,0
814,13/05/2021,3,1,67,40,27,55,0,0
497,09/05/2021,3,2,191,30,161,49,0,0
9,08/05/2021,3,0,27,23,4,57,0,0
178,02/05/2021,3,0,38,7,31,49,0,0
422,16/05/2021,3,1,78,15,63,49,0,0
128,08/05/2021,3,1,20,4,16,49,0,0
12,07/05/2021,3,1,42,9,33,49,0,0
872,02/05/2021,3,1,64,25,39,49,0,0
205,07/05/2021,3,1,125,21,104,49,0,0
615,12/05/2021,3,0,71,30,41,49,0,0
397,01/05/2021,3,0,75,4,71,49,0,0
416,08/05/2021,3,0,34,6,28,49,0,0
118,03/05/2021,3,4,55,5,50,49,0,0
11,04/05/2021,3,2,82,26,56,55,0,0
811,12/05/2021,3,2,88,36,52,55,0,0
152,12/05/2021,3,0,91,26,65,55,0,0
826,14/05/2021,3,2,96,31,65,49,0,0
263,07/05/2021,3,0,66,23,43,49,0,0
183,10/05/2021,3,3,77,36,41,64,0,0
665,13/05/2021,3,1,105,50,55,55,0,0
792,12/05/2021,3,5,97,21,76,49,0,0
436,11/05/2021,3,2,204,72,132,49,0,0
360,11/05/2021,3,1,43,10,33,59,0,0
686,15/05/2021,3,0,46,18,28,49,0,0
526,08/05/2021,3,0,38,5,33,49,0,0
153,04/05/2021,3,1,63,39,24,52,0,0
45,07/05/2021,3,3,153,5,148,49,0,0
556,16/05/2021,3,0,117,31,86,49,0,0
220,09/05/2021,3,29,74,11,63,49,0,0
530,01/05/2021,3,1,59,59,0,NA,NA,NA
667,14/05/2021,3,0,10,0,10,NA,NA,NA
918,02/05/2021,3,0,201,25,176,39,0,0
434,06/05/2021,3,3,57,8,49,49,0,0
63,04/05/2021,3,2,62,23,39,49,0,0
130,16/05/2021,3,3,78,13,65,49,0,0
403,06/05/2021,3,2,96,55,41,60,0,0
222,06/05/2021,3,1,76,13,63,49,0,0
860,08/05/2021,3,11,81,12,69,49,0,0
380,06/05/2021,3,2,158,41,117,49,0,0
201,05/05/2021,3,7,131,16,115,49,0,0
172,07/05/2021,3,2,83,24,59,49,0,0
697,18/05/2021,3,3,106,52,54,55,0,0
883,08/05/2021,3,6,98,8,90,45,0,0
402,03/05/2021,3,0,155,11,144,49,0,0
346,03/05/2021,3,5,115,25,90,55,0,0
517,11/05/2021,3,1,57,49,8,77,0,0
36,02/05/2021,3,1,62,7,55,49,0,0
508,13/05/2021,3,22,58,48,10,62,0,0
7,07/05/2021,3,5,98,23,75,49,0,0
115,06/05/2021,3,0,115,26,89,49,0,0
565,02/05/2021,3,0,62,15,47,49,0,0
622,16/05/2021,3,1,43,30,13,49,0,0
163,09/05/2021,3,1,61,22,39,49,0,0
167,06/05/2021,3,0,84,81,3,123,0,0
569,03/05/2021,3,0,120,15,105,49,0,0
374,08/05/2021,3,0,56,12,44,49,0,0
700,12/05/2021,3,5,127,34,93,49,0,0
397,04/05/2021,3,0,75,54,21,60,0,0
882,08/05/2021,3,0,130,20,110,39,0,0
325,03/05/2021,3,1,44,13,31,49,0,0
717,04/05/2021,3,3,190,61,129,55,0,0
159,12/05/2021,3,0,77,33,44,49,0,0
525,12/05/2021,3,1,74,47,27,60,0,0
879,15/05/2021,3,3,161,12,149,39,0,0
634,07/05/2021,3,1,19,12,7,74,0,0
451,10/05/2021,3,2,81,41,40,66,0,0
270,13/05/2021,3,1,59,31,28,59,0,0
904,12/05/2021,3,4,270,3,267,66,0,0
512,11/05/2021,3,2,60,36,24,49,0,0
797,11/05/2021,3,0,67,43,24,64,0,0
136,15/05/2021,3,0,128,31,97,49,0,0
342,07/05/2021,3,0,114,16,98,49,0,0
153,05/05/2021,3,1,63,46,17,57,0,0
39,08/05/2021,3,1,60,25,35,49,0,0
619,15/05/2021,3,0,101,7,94,49,0,0
180,08/05/2021,3,0,41,8,33,49,0,0
5,01/05/2021,3,69,20,20,0,NA,NA,NA
667,16/05/2021,3,0,10,0,10,NA,NA,NA
863,01/05/2021,3,4,91,4,87,49,0,0
103,04/05/2021,3,1,160,49,111,55,0,0
148,03/05/2021,3,0,25,5,20,49,0,0
224,16/05/2021,3,1,56,15,41,49,0,0
603,05/05/2021,3,5,79,40,39,49,0,0
481,05/05/2021,3,0,56,30,26,52,0,0
250,07/05/2021,3,1,114,57,57,59,0,0
785,06/05/2021,3,2,108,28,80,49,0,0
828,05/05/2021,3,4,71,9,62,49,0,0
815,07/05/2021,3,12,117,23,94,49,0,0
340,16/05/2021,3,17,117,3,114,49,0,0
175,08/05/2021,3,1,119,13,106,49,0,0
272,04/05/2021,3,1,126,27,99,49,0,0
363,03/05/2021,3,1,98,47,51,59,0,0
421,09/05/2021,3,0,19,16,3,62,0,0
605,09/05/2021,3,3,157,14,143,49,0,0
891,13/05/2021,3,3,79,64,15,57,0,0
166,07/05/2021,3,3,63,15,48,49,0,0
129,07/05/2021,3,7,193,124,69,49,0,0
478,01/05/2021,3,1,19,15,4,62,0,0
642,07/05/2021,3,5,90,11,79,49,0,0
266,08/05/2021,3,0,61,14,47,49,0,0
496,06/05/2021,3,1,59,12,47,49,0,0
650,04/05/2021,3,4,124,57,67,49,0,0
572,06/05/2021,3,0,61,30,31,55,0,0
71,13/05/2021,3,3,59,19,40,49,0,0
898,04/05/2021,3,0,100,37,63,49,0,0
882,07/05/2021,3,0,130,24,106,39,0,0
873,03/05/2021,3,4,97,15,82,49,0,0
717,06/05/2021,3,3,190,73,117,55,0,0
456,12/05/2021,3,4,86,43,43,49,0,0
560,12/05/2021,3,0,80,53,27,80,0,0
765,16/05/2021,3,3,98,19,79,49,0,0
841,08/05/2021,3,0,182,14,168,49,0,0
594,10/05/2021,3,43,64,60,4,80,0,0
376,13/05/2021,3,2,62,49,13,67,0,0
904,13/05/2021,3,3,271,3,268,66,0,0
683,11/05/2021,3,1,65,35,30,49,0,0
333,10/05/2021,3,1,56,56,0,NA,NA,NA
598,14/05/2021,3,0,146,41,105,49,0,0
184,07/05/2021,3,0,51,20,31,49,0,0
198,04/05/2021,3,0,135,76,59,59,0,0
743,08/05/2021,3,1,125,16,109,49,0,0
619,16/05/2021,3,0,101,8,93,49,0,0
84,08/05/2021,3,0,20,8,12,49,0,0
38,02/05/2021,3,4,46,12,34,49,0,0
667,15/05/2021,3,0,10,0,10,NA,NA,NA
235,02/05/2021,3,6,151,16,135,49,0,0
257,04/05/2021,3,1,43,40,3,119,0,0
576,01/05/2021,3,1,57,10,47,49,0,0
592,16/05/2021,3,2,82,33,49,49,0,0
603,06/05/2021,3,5,79,33,46,49,0,0
861,06/05/2021,3,0,61,53,8,74,0,0
250,08/05/2021,3,1,114,61,53,59,0,0
380,07/05/2021,3,2,158,25,133,49,0,0
494,07/05/2021,3,2,137,13,124,49,0,0
460,07/05/2021,3,10,99,20,79,49,0,0
859,17/05/2021,3,1,84,9,75,49,0,0
406,08/05/2021,3,1,38,18,20,49,0,0
688,04/05/2021,3,6,113,50,63,49,0,0
225,03/05/2021,3,10,70,13,57,55,0,0
580,06/05/2021,3,0,98,43,55,49,0,0
395,10/05/2021,3,1,71,32,39,49,0,0
716,12/05/2021,3,0,104,74,30,67,0,0
298,07/05/2021,3,2,227,54,173,49,0,0
428,07/05/2021,3,4,88,37,51,49,0,0
54,01/05/2021,3,1,60,20,40,49,0,0
782,06/05/2021,3,0,20,17,3,189,0,0
875,08/05/2021,3,0,92,28,64,49,0,0
173,07/05/2021,3,3,68,16,52,49,0,0
839,05/05/2021,3,4,151,50,101,49,0,0
246,08/05/2021,3,1,111,26,85,55,0,0
615,13/05/2021,3,0,71,31,40,49,0,0
397,03/05/2021,3,0,75,8,67,55,0,0
790,08/05/2021,3,1,98,15,83,66,0,0
230,01/05/2021,3,0,80,38,42,49,0,0
711,06/05/2021,3,1,88,37,51,55,0,0
456,13/05/2021,3,4,86,53,33,49,0,0
368,12/05/2021,3,1,84,23,61,55,0,0
242,12/05/2021,3,2,136,71,65,52,0,0
841,07/05/2021,3,0,182,19,163,49,0,0
475,11/05/2021,3,1,98,49,49,60,0,0
627,13/05/2021,3,0,41,16,25,59,0,0
555,12/05/2021,3,0,117,57,60,59,0,0
654,12/05/2021,3,6,53,15,38,66,0,0
114,11/05/2021,3,0,75,75,0,NA,NA,NA
404,15/05/2021,3,0,67,16,51,49,0,0
526,07/05/2021,3,0,38,5,33,49,0,0
332,04/05/2021,3,0,40,26,14,55,0,0
706,08/05/2021,3,2,72,4,68,49,0,0
556,14/05/2021,3,0,117,23,94,49,0,0
699,09/05/2021,3,0,62,8,54,49,0,0
821,02/05/2021,3,2,77,26,51,49,0,0
921,16/05/2021,3,13,162,11,151,45,0,0
675,02/05/2021,3,1,55,14,41,49,0,0
709,04/05/2021,3,1,82,66,16,112,0,0
576,02/05/2021,3,1,57,10,47,49,0,0
789,16/05/2021,3,0,72,40,32,49,0,0
509,01/05/2021,3,1,111,16,95,49,0,0
691,05/05/2021,3,1,31,12,19,64,0,0
860,07/05/2021,3,4,88,9,79,49,0,0
238,05/05/2021,3,0,66,36,30,49,0,0
494,05/05/2021,3,1,138,38,100,49,0,0
868,07/05/2021,3,4,79,9,70,49,0,0
188,16/05/2021,3,7,114,19,95,49,0,0
504,09/05/2021,3,1,82,6,76,49,0,0
83,03/05/2021,3,16,152,41,111,49,0,0
363,02/05/2021,3,1,98,79,19,80,0,0
694,06/05/2021,3,6,103,41,62,49,0,0
599,09/05/2021,3,2,151,24,127,49,0,0
716,13/05/2021,3,0,104,74,30,60,0,0
585,08/05/2021,3,5,55,21,34,49,0,0
756,08/05/2021,3,0,106,72,34,49,0,0
155,01/05/2021,3,0,93,24,69,49,0,0
760,06/05/2021,3,2,34,10,24,52,0,0
138,09/05/2021,3,5,93,19,74,49,0,0
167,07/05/2021,3,0,84,49,35,52,0,0
373,01/05/2021,3,1,102,20,82,49,0,0
852,13/05/2021,3,0,80,39,41,49,0,0
397,02/05/2021,3,0,75,5,70,49,0,0
182,07/05/2021,3,2,78,7,71,49,0,0
873,01/05/2021,3,4,97,8,89,49,0,0
866,04/05/2021,3,0,100,21,79,55,0,0
524,13/05/2021,3,2,108,51,57,49,0,0
4,13/05/2021,3,1,63,58,5,80,0,0
879,14/05/2021,3,3,161,13,148,39,0,0
703,08/05/2021,3,0,91,14,77,49,0,0
519,09/05/2021,3,0,64,26,38,49,0,0
659,13/05/2021,3,2,41,12,29,55,0,0
231,13/05/2021,3,0,41,36,5,70,0,0
192,11/05/2021,3,0,86,44,42,52,0,0
783,10/05/2021,3,1,79,49,30,64,0,0
136,14/05/2021,3,0,128,40,88,49,0,0
342,05/05/2021,3,0,114,35,79,49,0,0
332,05/05/2021,3,0,40,24,16,55,0,0
45,04/05/2021,3,9,147,19,128,49,0,0
215,13/05/2021,3,0,46,25,21,59,0,0
699,08/05/2021,3,0,62,15,47,49,0,0
5,02/05/2021,3,69,20,20,0,NA,NA,NA
158,14/05/2021,3,1,23,9,14,49,0,0
658,01/05/2021,3,1,80,40,40,71,0,0
32,05/05/2021,3,1,104,101,3,85,0,0
317,03/05/2021,3,20,60,8,52,49,0,0
515,17/05/2021,3,3,109,67,42,52,0,0
764,02/05/2021,3,2,67,5,62,49,0,0
222,05/05/2021,3,1,76,22,54,49,0,0
429,07/05/2021,3,3,122,10,112,49,0,0
777,05/05/2021,3,3,117,71,46,49,0,0
343,07/05/2021,3,1,61,19,42,49,0,0
172,08/05/2021,3,2,83,34,49,49,0,0
601,16/05/2021,3,3,65,12,53,49,0,0
889,08/05/2021,3,1,123,12,111,45,0,0
272,03/05/2021,3,1,126,27,99,49,0,0
725,02/05/2021,3,0,17,15,2,67,0,0
694,03/05/2021,3,3,106,15,91,49,0,0
605,10/05/2021,3,2,158,40,118,49,0,0
856,12/05/2021,3,0,120,11,109,49,0,0
157,07/05/2021,3,1,82,21,61,49,0,0
135,09/05/2021,3,4,62,18,44,49,0,0
628,01/05/2021,3,1,58,8,50,49,0,0
3,08/05/2021,3,6,107,22,85,49,0,0
138,08/05/2021,3,2,96,41,55,49,0,0
173,05/05/2021,3,2,69,36,33,60,0,0
137,02/05/2021,3,23,123,15,108,49,0,0
700,10/05/2021,3,4,128,37,91,49,0,0
898,03/05/2021,3,0,100,11,89,49,0,0
239,07/05/2021,3,0,40,18,22,49,0,0
49,02/05/2021,3,2,146,11,135,49,0,0
638,03/05/2021,3,21,80,17,63,55,0,0
721,13/05/2021,3,29,111,45,66,49,0,0
4,14/05/2021,3,1,63,61,2,80,0,0
826,12/05/2021,3,2,96,38,58,49,0,0
511,08/05/2021,3,2,74,20,54,49,0,0
594,09/05/2021,3,43,64,37,27,49,0,0
665,12/05/2021,3,1,105,42,63,55,0,0
591,12/05/2021,3,1,67,46,21,64,0,0
462,13/05/2021,3,4,185,7,178,55,0,0
797,12/05/2021,3,0,67,42,25,59,0,0
714,14/05/2021,3,0,59,24,35,49,0,0
365,07/05/2021,3,0,68,21,47,55,0,0
776,05/05/2021,3,0,104,30,74,49,0,0
199,04/05/2021,3,2,80,37,43,49,0,0
75,15/05/2021,3,0,81,12,69,49,0,0
206,08/05/2021,3,17,196,42,154,55,0,0
316,03/05/2021,3,1,38,12,26,59,0,0
490,14/05/2021,3,5,160,6,154,49,0,0
918,01/05/2021,3,0,201,15,186,39,0,0
257,05/05/2021,3,1,43,42,1,142,0,0
63,05/05/2021,3,1,63,32,31,49,0,0
629,17/05/2021,3,0,62,44,18,52,0,0
322,03/05/2021,3,0,100,42,58,49,0,0
861,05/05/2021,3,0,61,55,6,77,0,0
232,08/05/2021,3,2,63,33,30,49,0,0
400,06/05/2021,3,1,29,7,22,49,0,0
828,07/05/2021,3,0,75,10,65,49,0,0
460,08/05/2021,3,15,94,32,62,49,0,0
636,16/05/2021,3,1,119,42,77,49,0,0
858,09/05/2021,3,1,80,22,58,49,0,0
479,03/05/2021,3,2,53,13,40,49,0,0
725,03/05/2021,3,0,17,8,9,59,0,0
694,05/05/2021,3,3,106,44,62,49,0,0
503,11/05/2021,3,0,184,13,171,49,0,0
698,12/05/2021,3,2,114,33,81,49,0,0
105,08/05/2021,3,1,74,12,62,49,0,0
129,08/05/2021,3,7,193,160,33,52,0,0
458,02/05/2021,3,0,181,29,152,49,0,0
139,06/05/2021,3,2,57,16,41,49,0,0
266,09/05/2021,3,0,61,22,39,49,0,0
433,05/05/2021,3,2,316,84,232,66,0,0
563,03/05/2021,3,1,69,7,62,49,0,0
753,12/05/2021,3,1,126,43,83,49,0,0
833,04/05/2021,3,0,83,35,48,49,0,0
239,08/05/2021,3,0,40,25,15,49,0,0
230,02/05/2021,3,0,80,7,73,49,0,0
866,05/05/2021,3,0,100,23,77,55,0,0
736,13/05/2021,3,1,104,16,88,49,0,0
211,13/05/2021,3,3,57,40,17,60,0,0
18,13/05/2021,3,2,90,53,37,49,0,0
685,08/05/2021,3,4,136,24,112,49,0,0
228,09/05/2021,3,3,39,6,33,49,0,0
372,12/05/2021,3,4,88,51,37,59,0,0
353,13/05/2021,3,1,51,27,24,64,0,0
683,12/05/2021,3,1,65,31,34,49,0,0
311,10/05/2021,3,0,97,42,55,55,0,0
431,15/05/2021,3,2,128,44,84,55,0,0
778,05/05/2021,3,1,80,64,16,80,0,0
147,05/05/2021,3,0,80,52,28,62,0,0
126,01/05/2021,3,0,120,57,63,49,0,0
544,14/05/2021,3,0,53,3,50,49,0,0
143,08/05/2021,3,6,114,22,92,49,0,0
357,03/05/2021,3,2,81,16,65,55,0,0
339,14/05/2021,3,17,577,14,563,49,0,0
675,01/05/2021,3,1,55,21,34,49,0,0
277,05/05/2021,3,4,68,30,38,62,0,0
513,02/05/2021,3,2,75,16,59,49,0,0
789,17/05/2021,3,1,71,70,1,83,0,0
58,01/05/2021,3,0,67,35,32,49,0,0
310,05/05/2021,3,1,71,45,26,55,0,0
274,07/05/2021,3,1,209,15,194,39,0,0
305,06/05/2021,3,2,57,12,45,49,0,0
621,06/05/2021,3,0,60,35,25,67,0,0
815,08/05/2021,3,12,117,27,90,49,0,0
29,08/05/2021,3,0,54,0,54,NA,NA,NA
558,08/05/2021,3,0,44,3,41,49,0,0
535,03/05/2021,3,0,83,3,80,49,0,0
208,02/05/2021,3,0,60,11,49,49,0,0
24,06/05/2021,3,1,83,43,40,49,0,0
640,11/05/2021,3,4,122,31,91,49,0,0
459,13/05/2021,3,3,89,46,43,49,0,0
798,09/05/2021,3,1,80,14,66,49,0,0
135,06/05/2021,3,4,62,58,4,123,0,0
318,01/05/2021,3,0,59,15,44,49,0,0
139,07/05/2021,3,2,57,19,38,49,0,0
600,09/05/2021,3,1,49,16,33,49,0,0
142,06/05/2021,3,1,61,35,26,59,0,0
839,03/05/2021,3,4,151,31,120,49,0,0
700,14/05/2021,3,5,127,62,65,49,0,0
249,03/05/2021,3,1,126,40,86,49,0,0
446,08/05/2021,3,8,125,24,101,49,0,0
521,02/05/2021,3,1,54,9,45,49,0,0
866,03/05/2021,3,0,100,11,89,49,0,0
811,13/05/2021,3,2,88,60,28,49,0,0
67,13/05/2021,3,0,52,26,26,59,0,0
154,13/05/2021,3,6,98,32,66,49,0,0
216,07/05/2021,3,1,57,3,54,49,0,0
475,10/05/2021,3,1,98,49,49,49,0,0
554,02/05/2021,3,1,41,2,39,49,0,0
145,13/05/2021,3,4,54,20,34,55,0,0
825,11/05/2021,3,3,143,32,111,49,0,0
465,10/05/2021,3,5,262,69,193,55,0,0
431,14/05/2021,3,3,127,41,86,49,0,0
817,05/05/2021,3,2,81,29,52,49,0,0
361,04/05/2021,3,38,27,24,3,80,0,0
39,02/05/2021,3,1,60,27,33,49,0,0
556,01/05/2021,3,1,116,24,92,49,0,0
34,09/05/2021,3,3,85,42,43,49,0,0
38,01/05/2021,3,5,45,19,26,49,0,0
386,14/05/2021,3,5,80,10,70,49,0,0
60,02/05/2021,3,0,57,8,49,49,0,0
32,06/05/2021,3,1,104,75,29,64,0,0
63,03/05/2021,3,2,62,8,54,49,0,0
419,17/05/2021,3,4,106,55,51,66,0,0
322,01/05/2021,3,0,100,50,50,49,0,0
452,06/05/2021,3,1,59,34,25,60,0,0
767,07/05/2021,3,0,67,15,52,49,0,0
238,07/05/2021,3,1,65,29,36,49,0,0
621,07/05/2021,3,1,59,18,41,49,0,0
466,07/05/2021,3,0,140,15,125,49,0,0
29,07/05/2021,3,0,54,0,54,NA,NA,NA
613,09/05/2021,3,0,56,13,43,49,0,0
264,03/05/2021,3,1,59,11,48,55,0,0
483,02/05/2021,3,3,96,20,76,49,0,0
651,06/05/2021,3,1,77,12,65,49,0,0
405,09/05/2021,3,1,89,30,59,49,0,0
891,12/05/2021,3,3,79,52,27,60,0,0
123,01/05/2021,3,1,94,8,86,49,0,0
115,07/05/2021,3,0,115,22,93,49,0,0
237,02/05/2021,3,4,117,22,95,49,0,0
139,08/05/2021,3,2,57,18,39,49,0,0
213,08/05/2021,3,4,144,118,26,57,0,0
12,05/05/2021,3,1,42,17,25,49,0,0
839,04/05/2021,3,4,151,60,91,49,0,0
71,10/05/2021,3,1,61,19,42,49,0,0
833,01/05/2021,3,0,83,26,57,49,0,0
784,08/05/2021,3,4,45,14,31,49,0,0
734,02/05/2021,3,2,59,11,48,49,0,0
705,03/05/2021,3,1,90,10,80,49,0,0
164,13/05/2021,3,0,62,29,33,49,0,0
226,13/05/2021,3,0,47,30,17,64,0,0
242,13/05/2021,3,4,134,92,42,49,0,0
583,08/05/2021,3,1,80,25,55,49,0,0
228,11/05/2021,3,2,40,22,18,49,0,0
627,03/05/2021,3,0,41,5,36,59,0,0
581,13/05/2021,3,60,165,104,61,52,0,0
162,12/05/2021,3,0,122,43,79,49,0,0
356,10/05/2021,3,3,133,72,61,55,0,0
574,14/05/2021,3,1,86,15,71,49,0,0
151,08/05/2021,3,7,69,17,52,49,0,0
607,04/05/2021,3,3,72,30,42,60,0,0
126,03/05/2021,3,0,120,23,97,49,0,0
215,01/05/2021,3,0,46,8,38,49,0,0
285,08/05/2021,3,0,80,19,61,49,0,0
559,02/05/2021,3,43,142,21,121,49,0,0
339,15/05/2021,3,17,577,21,556,49,0,0
681,01/05/2021,3,2,69,12,57,49,0,0
257,06/05/2021,3,1,43,39,4,83,0,0
812,05/05/2021,3,2,135,45,90,49,0,0
779,17/05/2021,3,0,104,38,66,55,0,0
322,02/05/2021,3,0,100,43,57,49,0,0
52,05/05/2021,3,9,133,65,68,59,0,0
108,07/05/2021,3,0,78,12,66,49,0,0
276,07/05/2021,3,0,204,25,179,49,0,0
741,07/05/2021,3,1,69,10,59,49,0,0
334,07/05/2021,3,0,58,9,49,49,0,0
29,06/05/2021,3,0,54,0,54,NA,NA,NA
492,09/05/2021,3,3,34,10,24,49,0,0
104,03/05/2021,3,3,59,33,26,59,0,0
618,02/05/2021,3,14,137,18,119,49,0,0
24,03/05/2021,3,0,84,32,52,49,0,0
36,10/05/2021,3,1,62,15,47,49,0,0
724,13/05/2021,3,2,84,69,15,80,0,0
497,01/05/2021,3,1,192,56,136,49,0,0
115,08/05/2021,3,0,115,15,100,49,0,0
528,02/05/2021,3,1,118,15,103,49,0,0
518,06/05/2021,3,1,16,15,1,75,0,0
417,08/05/2021,3,0,103,16,87,49,0,0
862,06/05/2021,3,2,108,43,65,49,0,0
137,05/05/2021,3,23,123,17,106,49,0,0
753,11/05/2021,3,2,125,43,82,49,0,0
300,03/05/2021,3,0,210,61,149,49,0,0
666,08/05/2021,3,2,64,12,52,49,0,0
49,01/05/2021,3,2,146,15,131,49,0,0
70,05/05/2021,3,2,37,17,20,49,0,0
164,11/05/2021,3,1,61,28,33,49,0,0
525,14/05/2021,3,1,74,13,61,49,0,0
221,14/05/2021,3,1,61,17,44,49,0,0
731,08/05/2021,3,7,92,19,73,49,0,0
917,01/05/2021,3,2,104,0,104,35,0,0
372,04/05/2021,3,3,89,65,24,67,0,0
145,12/05/2021,3,4,54,20,34,55,0,0
393,12/05/2021,3,1,59,19,40,49,0,0
360,10/05/2021,3,1,43,8,35,55,0,0
838,14/05/2021,3,3,62,21,41,49,0,0
243,05/05/2021,3,1,126,23,103,49,0,0
648,05/05/2021,3,1,63,39,24,80,0,0
706,03/05/2021,3,1,73,20,53,49,0,0
219,01/05/2021,3,6,71,8,63,49,0,0
76,09/05/2021,3,1,92,19,73,49,0,0
407,03/05/2021,3,1,40,7,33,49,0,0
410,16/05/2021,3,1,55,12,43,49,0,0
383,01/05/2021,3,3,82,43,39,49,0,0
314,05/05/2021,3,2,67,29,38,60,0,0
513,09/05/2021,3,1,76,5,71,49,0,0
65,17/05/2021,3,1,77,39,38,49,0,0
509,02/05/2021,3,1,111,7,104,49,0,0
52,06/05/2021,3,6,136,69,67,49,0,0
392,07/05/2021,3,0,176,24,152,49,0,0
276,05/05/2021,3,4,200,47,153,49,0,0
653,05/05/2021,3,2,113,48,65,49,0,0
520,07/05/2021,3,0,58,14,44,49,0,0
549,06/05/2021,3,0,61,0,61,NA,NA,NA
537,09/05/2021,3,3,99,81,18,57,0,0
248,04/05/2021,3,0,82,42,40,55,0,0
618,03/05/2021,3,13,138,18,120,49,0,0
260,03/05/2021,3,0,120,17,103,49,0,0
395,11/05/2021,3,1,71,36,35,49,0,0
808,13/05/2021,3,11,157,79,78,55,0,0
646,01/05/2021,3,9,127,45,82,49,0,0
129,06/05/2021,3,9,191,41,150,49,0,0
237,01/05/2021,3,4,117,41,76,49,0,0
464,07/05/2021,3,1,265,21,244,66,0,0
836,08/05/2021,3,3,98,43,55,49,0,0
496,07/05/2021,3,1,59,10,49,49,0,0
563,05/05/2021,3,1,69,30,39,49,0,0
71,12/05/2021,3,1,61,18,43,49,0,0
348,01/05/2021,3,43,97,70,27,49,0,0
296,07/05/2021,3,1,59,20,39,49,0,0
787,01/05/2021,3,2,106,52,54,49,0,0
705,05/05/2021,3,0,91,21,70,49,0,0
736,12/05/2021,3,1,104,24,80,49,0,0
368,14/05/2021,3,2,83,21,62,49,0,0
826,15/05/2021,3,2,96,47,49,49,0,0
233,07/05/2021,3,4,63,7,56,49,0,0
617,01/05/2021,3,1,43,4,39,49,0,0
307,03/05/2021,3,1,78,8,70,49,0,0
442,12/05/2021,3,1,157,46,111,49,0,0
162,13/05/2021,3,0,122,42,80,49,0,0
797,10/05/2021,3,0,67,45,22,55,0,0
439,15/05/2021,3,6,85,10,75,49,0,0
689,08/05/2021,3,1,129,21,108,49,0,0
198,05/05/2021,3,0,135,72,63,64,0,0
412,04/05/2021,3,7,94,20,74,49,0,0
564,01/05/2021,3,4,70,19,51,49,0,0
750,09/05/2021,3,3,109,32,77,49,0,0
559,01/05/2021,3,43,142,34,108,49,0,0
531,16/05/2021,3,1,58,8,50,49,0,0
752,01/05/2021,3,1,43,10,33,49,0,0
505,04/05/2021,3,0,84,24,60,49,0,0
345,08/05/2021,3,0,101,13,88,49,0,0
335,17/05/2021,3,4,82,32,50,49,0,0
603,02/05/2021,3,5,79,23,56,49,0,0
326,05/05/2021,3,3,78,33,45,55,0,0
366,08/05/2021,3,0,80,28,52,49,0,0
380,05/05/2021,3,2,158,35,123,49,0,0
156,06/05/2021,3,3,145,83,62,49,0,0
466,08/05/2021,3,0,140,16,124,49,0,0
549,07/05/2021,3,0,61,0,61,NA,NA,NA
883,09/05/2021,3,6,98,10,88,45,0,0
535,01/05/2021,3,0,83,7,76,49,0,0
845,03/05/2021,3,1,119,27,92,49,0,0
580,03/05/2021,3,0,98,30,68,49,0,0
468,12/05/2021,3,1,95,25,70,49,0,0
55,13/05/2021,3,1,32,23,9,52,0,0
774,01/05/2021,3,0,105,12,93,49,0,0
662,07/05/2021,3,3,104,10,94,49,0,0
279,01/05/2021,3,1,56,7,49,49,0,0
92,07/05/2021,3,1,121,14,107,49,0,0
252,08/05/2021,3,3,261,22,239,49,0,0
739,07/05/2021,3,2,73,4,69,49,0,0
758,02/05/2021,3,0,73,29,44,49,0,0
100,13/05/2021,3,86,138,26,112,49,0,0
833,02/05/2021,3,0,83,28,55,49,0,0
281,07/05/2021,3,0,83,8,75,49,0,0
787,02/05/2021,3,2,106,39,67,49,0,0
11,06/05/2021,3,2,82,31,51,49,0,0
587,13/05/2021,3,2,79,31,48,49,0,0
498,12/05/2021,3,0,87,36,51,49,0,0
685,07/05/2021,3,4,136,29,107,49,0,0
865,03/05/2021,3,2,83,4,79,49,0,0
270,04/05/2021,3,1,59,41,18,80,0,0
245,12/05/2021,3,5,92,27,65,49,0,0
393,13/05/2021,3,0,60,26,34,49,0,0
311,12/05/2021,3,0,97,43,54,55,0,0
574,15/05/2021,3,1,86,15,71,49,0,0
593,06/05/2021,3,5,76,44,32,72,0,0
648,04/05/2021,3,1,63,60,3,89,0,0
134,03/05/2021,3,2,46,29,17,49,0,0
544,01/05/2021,3,1,52,6,46,49,0,0
180,09/05/2021,3,0,41,14,27,49,0,0
290,02/05/2021,3,4,103,43,60,49,0,0
490,16/05/2021,3,6,159,7,152,49,0,0
383,02/05/2021,3,3,82,30,52,49,0,0
835,04/05/2021,3,5,99,64,35,64,0,0
317,09/05/2021,3,0,80,15,65,49,0,0
781,17/05/2021,3,5,78,38,40,49,0,0
603,03/05/2021,3,5,79,16,63,49,0,0
426,06/05/2021,3,13,150,82,68,55,0,0
177,07/05/2021,3,0,48,2,46,49,0,0
400,05/05/2021,3,1,29,7,22,49,0,0
201,06/05/2021,3,6,132,26,106,49,0,0
19,07/05/2021,3,1,93,8,85,49,0,0
549,08/05/2021,3,0,61,0,61,NA,NA,NA
93,08/05/2021,3,3,138,22,116,49,0,0
248,01/05/2021,3,0,82,41,41,49,0,0
664,02/05/2021,3,3,152,30,122,49,0,0
578,04/05/2021,3,2,56,16,40,55,0,0
468,10/05/2021,3,1,95,32,63,49,0,0
98,13/05/2021,3,1,94,56,38,59,0,0
125,01/05/2021,3,2,34,12,22,49,0,0
616,08/05/2021,3,3,72,22,50,49,0,0
528,01/05/2021,3,1,118,24,94,49,0,0
518,08/05/2021,3,1,16,5,11,49,0,0
321,08/05/2021,3,1,39,4,35,49,0,0
527,07/05/2021,3,9,52,13,39,49,0,0
650,05/05/2021,3,4,124,51,73,49,0,0
278,13/05/2021,3,0,105,7,98,49,0,0
348,03/05/2021,3,48,92,54,38,49,0,0
491,07/05/2021,3,6,173,17,156,49,0,0
49,03/05/2021,3,2,146,12,134,49,0,0
170,06/05/2021,3,1,104,30,74,49,0,0
149,13/05/2021,3,0,88,37,51,49,0,0
498,13/05/2021,3,0,87,36,51,49,0,0
748,07/05/2021,3,5,139,23,116,49,0,0
228,01/05/2021,3,2,40,26,14,52,0,0
659,04/05/2021,3,2,41,5,36,55,0,0
119,13/05/2021,3,2,66,20,46,49,0,0
474,13/05/2021,3,0,112,40,72,49,0,0
356,12/05/2021,3,3,133,58,75,55,0,0
584,15/05/2021,3,3,94,19,75,49,0,0
151,06/05/2021,3,6,70,34,36,55,0,0
17,04/05/2021,3,1,93,73,20,57,0,0
199,03/05/2021,3,3,79,19,60,49,0,0
323,01/05/2021,3,0,31,13,18,49,0,0
285,09/05/2021,3,0,80,14,66,49,0,0
107,03/05/2021,3,2,87,34,53,55,0,0
441,14/05/2021,3,0,168,11,157,55,0,0
863,02/05/2021,3,8,87,9,78,49,0,0
121,05/05/2021,3,1,109,82,27,67,0,0
676,17/05/2021,3,3,112,67,45,49,0,0
127,05/05/2021,3,1,59,33,26,72,0,0
767,08/05/2021,3,0,67,14,53,49,0,0
570,06/05/2021,3,0,149,48,101,49,0,0
343,06/05/2021,3,1,61,35,26,49,0,0
738,07/05/2021,3,1,123,14,109,49,0,0
733,06/05/2021,3,0,100,11,89,49,0,0
69,09/05/2021,3,1,59,6,53,49,0,0
479,01/05/2021,3,0,55,15,40,49,0,0
664,03/05/2021,3,5,150,35,115,49,0,0
421,03/05/2021,3,0,19,12,7,64,0,0
336,09/05/2021,3,0,74,23,51,49,0,0
301,12/05/2021,3,1,100,35,65,49,0,0
105,01/05/2021,3,1,74,17,57,49,0,0
9,07/05/2021,3,0,27,18,9,49,0,0
54,02/05/2021,3,1,60,10,50,49,0,0
622,08/05/2021,3,1,43,36,7,85,0,0
600,08/05/2021,3,1,49,9,40,49,0,0
529,05/05/2021,3,5,36,18,18,60,0,0
373,02/05/2021,3,2,101,15,86,49,0,0
370,13/05/2021,3,0,40,12,28,49,0,0
557,01/05/2021,3,1,103,42,61,49,0,0
296,08/05/2021,3,4,56,19,37,49,0,0
787,03/05/2021,3,2,106,14,92,49,0,0
866,06/05/2021,3,0,100,21,79,49,0,0
673,13/05/2021,3,0,123,25,98,49,0,0
152,13/05/2021,3,0,91,27,64,49,0,0
263,13/05/2021,3,0,66,23,43,49,0,0
848,02/05/2021,3,8,130,19,111,35,0,0
627,04/05/2021,3,0,41,14,27,59,0,0
119,16/05/2021,3,2,66,6,60,49,0,0
192,17/05/2021,3,0,86,67,19,62,0,0
465,12/05/2021,3,5,262,98,164,55,0,0
352,07/05/2021,3,2,62,9,53,49,0,0
151,07/05/2021,3,6,70,15,55,49,0,0
153,09/05/2021,3,1,63,6,57,49,0,0
126,04/05/2021,3,1,119,41,78,49,0,0
564,07/05/2021,3,3,71,10,61,49,0,0
805,09/05/2021,3,3,110,17,93,49,0,0
107,09/05/2021,3,34,55,22,33,49,0,0
256,16/05/2021,3,2,107,12,95,49,0,0
235,01/05/2021,3,6,151,21,130,49,0,0
835,05/05/2021,3,5,99,68,31,72,0,0
869,13/05/2021,3,3,57,45,12,85,0,0
452,05/05/2021,3,7,53,41,12,67,0,0
623,07/05/2021,3,0,78,7,71,49,0,0
28,07/05/2021,3,2,126,30,96,49,0,0
343,09/05/2021,3,1,61,4,57,49,0,0
19,08/05/2021,3,1,93,11,82,49,0,0
733,08/05/2021,3,0,100,6,94,49,0,0
537,10/05/2021,3,3,99,97,2,115,0,0
248,02/05/2021,3,0,82,31,51,49,0,0
208,07/05/2021,3,0,60,6,54,49,0,0
517,04/05/2021,3,3,55,25,30,52,0,0
640,09/05/2021,3,4,122,12,110,49,0,0
508,12/05/2021,3,22,58,38,20,49,0,0
157,01/05/2021,3,1,82,15,67,49,0,0
756,09/05/2021,3,1,105,47,58,49,0,0
318,02/05/2021,3,0,59,12,47,49,0,0
622,07/05/2021,3,1,43,29,14,60,0,0
684,08/05/2021,3,3,95,6,89,49,0,0
433,10/05/2021,3,2,316,66,250,66,0,0
569,01/05/2021,3,0,120,29,91,49,0,0
753,13/05/2021,3,1,126,47,79,49,0,0
670,01/05/2021,3,0,108,43,65,49,0,0
401,08/05/2021,3,0,79,13,66,49,0,0
234,07/05/2021,3,2,60,20,40,49,0,0
70,03/05/2021,3,2,37,13,24,49,0,0
27,11/05/2021,3,0,78,59,19,72,0,0
152,14/05/2021,3,0,91,22,69,49,0,0
841,12/05/2021,3,0,182,10,172,55,0,0
228,03/05/2021,3,3,39,12,27,49,0,0
659,03/05/2021,3,2,41,3,38,55,0,0
245,16/05/2021,3,5,92,11,81,49,0,0
399,17/05/2021,3,1,60,52,8,72,0,0
907,10/05/2021,3,3,77,40,37,49,0,0
647,08/05/2021,3,4,89,11,78,49,0,0
131,08/05/2021,3,2,47,8,39,49,0,0
332,10/05/2021,3,0,40,19,21,60,0,0
743,01/05/2021,3,1,125,32,93,49,0,0
77,08/05/2021,3,1,102,39,63,49,0,0
34,08/05/2021,3,3,85,42,43,49,0,0
559,09/05/2021,3,80,105,18,87,49,0,0
2,15/05/2021,3,3,56,44,12,57,0,0
60,01/05/2021,3,0,57,12,45,49,0,0
837,11/05/2021,3,3,323,59,264,66,0,0
347,13/05/2021,3,12,50,32,18,57,0,0
426,05/05/2021,3,13,150,77,73,55,0,0
392,13/05/2021,3,0,176,55,121,49,0,0
570,11/05/2021,3,0,149,72,77,49,0,0
653,09/05/2021,3,2,113,12,101,49,0,0
466,12/05/2021,3,0,140,26,114,49,0,0
697,06/05/2021,3,1,108,24,84,49,0,0
586,10/05/2021,3,4,79,65,14,72,0,0
535,02/05/2021,3,0,83,2,81,49,0,0
214,07/05/2021,3,4,82,22,60,49,0,0
469,03/05/2021,3,4,192,11,181,66,0,0
503,10/05/2021,3,0,184,11,173,49,0,0
337,13/05/2021,3,0,60,16,44,49,0,0
125,02/05/2021,3,2,34,5,29,49,0,0
458,01/05/2021,3,0,181,36,145,49,0,0
292,07/05/2021,3,0,239,53,186,49,0,0
51,09/05/2021,3,2,78,40,38,49,0,0
816,10/05/2021,3,3,79,54,25,59,0,0
137,01/05/2021,3,23,123,32,91,49,0,0
745,14/05/2021,3,1,104,18,86,49,0,0
300,02/05/2021,3,0,210,123,87,49,0,0
239,13/05/2021,3,0,40,27,13,64,0,0
734,07/05/2021,3,2,59,16,43,49,0,0
614,03/05/2021,3,2,80,27,53,49,0,0
587,12/05/2021,3,2,79,26,53,55,0,0
560,11/05/2021,3,0,80,61,19,82,0,0
440,12/05/2021,3,0,265,19,246,66,0,0
193,03/05/2021,3,1,107,19,88,49,0,0
197,02/05/2021,3,0,118,15,103,49,0,0
448,16/05/2021,3,3,150,23,127,66,0,0
253,19/05/2021,3,1,57,31,26,67,0,0
43,10/05/2021,3,1,72,29,43,55,0,0
484,07/05/2021,3,0,40,9,31,49,0,0
817,12/05/2021,3,1,82,34,48,55,0,0
287,09/05/2021,3,3,120,29,91,49,0,0
582,01/05/2021,3,1,52,34,18,52,0,0
556,08/05/2021,3,1,116,25,91,49,0,0
34,14/05/2021,3,3,85,11,74,49,0,0
476,10/05/2021,3,1,172,26,146,49,0,0
818,16/05/2021,3,1,80,77,3,80,0,0
418,02/05/2021,3,2,114,26,88,49,0,0
709,10/05/2021,3,0,83,20,63,55,0,0
224,12/05/2021,3,1,56,25,31,49,0,0
742,10/05/2021,3,1,73,27,46,49,0,0
366,13/05/2021,3,0,80,64,16,72,0,0
785,11/05/2021,3,2,108,45,63,49,0,0
414,10/05/2021,3,18,168,9,159,49,0,0
868,12/05/2021,3,0,83,21,62,49,0,0
499,07/05/2021,3,0,31,11,20,49,0,0
795,10/05/2021,3,7,98,51,47,55,0,0
899,01/05/2021,3,3,102,36,66,49,0,0
664,07/05/2021,3,4,151,39,112,49,0,0
425,06/05/2021,3,3,247,39,208,66,0,0
640,10/05/2021,3,4,122,22,100,49,0,0
319,15/05/2021,3,1,113,19,94,49,0,0
298,04/05/2021,3,2,227,61,166,49,0,0
54,06/05/2021,3,1,60,36,24,60,0,0
754,08/05/2021,3,0,62,7,55,49,0,0
213,10/05/2021,3,3,145,97,48,49,0,0
527,11/05/2021,3,7,54,42,12,59,0,0
538,01/05/2021,3,1,43,5,38,49,0,0
745,13/05/2021,3,2,103,56,47,55,0,0
670,02/05/2021,3,0,108,20,88,49,0,0
707,12/05/2021,3,2,38,26,12,80,0,0
521,06/05/2021,3,1,54,31,23,49,0,0
409,06/05/2021,3,1,106,45,61,49,0,0
149,12/05/2021,3,0,88,39,49,55,0,0
67,11/05/2021,3,1,51,26,25,59,0,0
487,06/05/2021,3,4,35,4,31,49,0,0
617,03/05/2021,3,1,43,11,32,55,0,0
639,02/05/2021,3,1,58,15,43,49,0,0
507,16/05/2021,3,3,197,10,187,49,0,0
269,17/05/2021,3,1,79,15,64,49,0,0
712,10/05/2021,3,2,83,14,69,49,0,0
686,07/05/2021,3,0,46,6,40,49,0,0
420,15/05/2021,3,1,68,66,2,59,0,0
589,09/05/2021,3,4,139,16,123,49,0,0
341,04/05/2021,3,2,112,95,17,74,0,0
556,09/05/2021,3,1,116,16,100,49,0,0
220,14/05/2021,3,26,77,16,61,49,0,0
668,10/05/2021,3,0,303,7,296,49,0,0
441,15/05/2021,3,0,168,13,155,55,0,0
658,02/05/2021,3,0,81,39,42,49,0,0
121,12/05/2021,3,0,110,90,20,72,0,0
396,12/05/2021,3,1,29,14,15,52,0,0
227,12/05/2021,3,3,41,8,33,49,0,0
767,13/05/2021,3,0,67,38,29,55,0,0
380,12/05/2021,3,2,158,41,117,49,0,0
741,08/05/2021,3,1,69,14,55,49,0,0
99,13/05/2021,3,0,167,55,112,49,0,0
80,07/05/2021,3,1,124,13,111,49,0,0
378,11/05/2021,3,1,83,37,46,55,0,0
264,02/05/2021,3,1,59,27,32,49,0,0
214,08/05/2021,3,4,82,26,56,49,0,0
24,04/05/2021,3,0,84,63,21,57,0,0
640,12/05/2021,3,5,121,31,90,49,0,0
808,15/05/2021,3,11,157,67,90,49,0,0
774,02/05/2021,3,0,105,10,95,49,0,0
178,06/05/2021,3,0,38,23,15,64,0,0
760,08/05/2021,3,1,35,9,26,49,0,0
252,10/05/2021,3,3,261,84,177,49,0,0
527,12/05/2021,3,9,52,44,8,59,0,0
575,02/05/2021,3,1,49,6,43,49,0,0
122,10/05/2021,3,6,115,59,56,55,0,0
300,04/05/2021,3,0,210,91,119,49,0,0
707,13/05/2021,3,2,38,28,10,72,0,0
787,06/05/2021,3,1,107,24,83,49,0,0
170,03/05/2021,3,2,103,15,88,49,0,0
27,13/05/2021,3,0,78,43,35,59,0,0
525,11/05/2021,3,1,74,46,28,60,0,0
233,05/05/2021,3,3,64,29,35,59,0,0
848,03/05/2021,3,8,130,5,125,35,0,0
372,03/05/2021,3,3,89,24,65,49,0,0
591,16/05/2021,3,0,68,14,54,49,0,0
436,17/05/2021,3,2,204,79,125,49,0,0
637,10/05/2021,3,1,73,33,40,49,0,0
714,07/05/2021,3,0,59,6,53,49,0,0
131,13/05/2021,3,2,47,20,27,49,0,0
42,10/05/2021,3,2,97,51,46,49,0,0
102,03/05/2021,3,0,60,8,52,55,0,0
564,09/05/2021,3,3,71,11,60,49,0,0
76,13/05/2021,3,1,92,28,64,49,0,0
357,10/05/2021,3,1,82,43,39,55,0,0
441,16/05/2021,3,0,168,13,155,55,0,0
752,02/05/2021,3,1,43,9,34,49,0,0
277,11/05/2021,3,4,68,34,34,65,0,0
867,12/05/2021,3,1,59,39,20,64,0,0
481,10/05/2021,3,0,56,50,6,65,0,0
177,04/05/2021,3,0,48,11,37,60,0,0
570,12/05/2021,3,0,149,59,90,49,0,0
562,09/05/2021,3,1,67,8,59,49,0,0
466,13/05/2021,3,0,140,32,108,49,0,0
80,08/05/2021,3,1,124,11,113,49,0,0
795,12/05/2021,3,5,100,51,49,55,0,0
688,01/05/2021,3,9,110,32,78,49,0,0
664,09/05/2021,3,5,150,48,102,49,0,0
580,02/05/2021,3,0,98,11,87,49,0,0
503,12/05/2021,3,0,184,14,170,49,0,0
98,15/05/2021,3,1,94,18,76,49,0,0
585,02/05/2021,3,5,55,20,35,49,0,0
565,06/05/2021,3,0,62,43,19,72,0,0
202,08/05/2021,3,1,75,76,-1,NA,NA,NA
213,11/05/2021,3,3,145,91,54,49,0,0
496,10/05/2021,3,1,59,19,40,49,0,0
551,03/05/2021,3,1,114,11,103,49,0,0
370,10/05/2021,3,0,40,21,19,52,0,0
312,04/05/2021,3,4,93,44,49,55,0,0
296,12/05/2021,3,3,57,38,19,67,0,0
49,07/05/2021,3,2,146,16,130,49,0,0
424,04/05/2021,3,1,27,15,12,49,0,0
770,11/05/2021,3,4,31,17,14,55,0,0
4,09/05/2021,3,1,63,50,13,57,0,0
583,04/05/2021,3,1,80,69,11,63,0,0
262,01/05/2021,3,2,49,45,4,57,0,0
376,02/05/2021,3,1,63,27,36,49,0,0
677,16/05/2021,3,0,40,4,36,49,0,0
474,17/05/2021,3,0,112,61,51,49,0,0
356,11/05/2021,3,3,133,66,67,55,0,0
714,08/05/2021,3,0,59,8,51,49,0,0
243,13/05/2021,3,1,126,60,66,49,0,0
147,10/05/2021,3,0,80,28,52,49,0,0
743,03/05/2021,3,1,125,23,102,55,0,0
619,09/05/2021,3,0,101,9,92,49,0,0
294,13/05/2021,3,1,116,77,39,52,0,0
679,10/05/2021,3,2,87,76,11,80,0,0
256,14/05/2021,3,0,109,15,94,49,0,0
534,01/05/2021,3,0,85,24,61,49,0,0
835,12/05/2021,3,5,99,59,40,64,0,0
629,12/05/2021,3,0,62,38,24,57,0,0
310,12/05/2021,3,1,71,53,18,55,0,0
177,05/05/2021,3,0,48,14,34,60,0,0
276,03/05/2021,3,5,199,40,159,49,0,0
828,08/05/2021,3,0,75,22,53,49,0,0
334,13/05/2021,3,0,58,32,26,49,0,0
499,08/05/2021,3,0,31,10,21,49,0,0
69,10/05/2021,3,1,59,36,23,49,0,0
479,02/05/2021,3,2,53,12,41,49,0,0
225,09/05/2021,3,14,66,7,59,49,0,0
24,01/05/2021,3,0,84,43,41,49,0,0
13,09/05/2021,3,4,77,16,61,49,0,0
337,15/05/2021,3,0,60,9,51,49,0,0
646,02/05/2021,3,12,124,23,101,49,0,0
155,05/05/2021,3,0,93,49,44,55,0,0
202,07/05/2021,3,1,75,70,5,71,0,0
836,11/05/2021,3,3,98,36,62,49,0,0
527,10/05/2021,3,6,55,27,28,49,0,0
563,02/05/2021,3,0,70,6,64,49,0,0
745,10/05/2021,3,3,102,42,60,55,0,0
312,01/05/2021,3,5,92,75,17,62,0,0
296,13/05/2021,3,3,57,35,22,52,0,0
787,07/05/2021,3,1,107,18,89,49,0,0
638,09/05/2021,3,21,80,18,62,49,0,0
524,11/05/2021,3,1,109,43,66,55,0,0
4,11/05/2021,3,1,63,46,17,72,0,0
86,06/05/2021,3,1,47,25,22,52,0,0
755,01/05/2021,3,1,86,73,13,57,0,0
674,02/05/2021,3,1,97,4,93,49,0,0
46,16/05/2021,3,1,59,18,41,49,0,0
597,17/05/2021,3,5,96,55,41,49,0,0
465,11/05/2021,3,5,262,77,185,55,0,0
728,07/05/2021,3,0,47,11,36,49,0,0
243,14/05/2021,3,1,126,93,33,49,0,0
198,09/05/2021,3,1,134,27,107,49,0,0
582,03/05/2021,3,0,53,8,45,55,0,0
564,10/05/2021,3,3,71,27,44,49,0,0
857,14/05/2021,3,1,209,64,145,55,0,0
679,09/05/2021,3,2,87,69,18,72,0,0
486,14/05/2021,3,0,124,10,114,49,0,0
632,01/05/2021,3,0,82,11,71,49,0,0
855,11/05/2021,3,1,175,70,105,49,0,0
282,12/05/2021,3,26,675,18,657,49,0,0
326,12/05/2021,3,6,75,58,17,79,0,0
767,04/05/2021,3,0,67,36,31,60,0,0
785,04/05/2021,3,3,107,34,73,49,0,0
741,02/05/2021,3,1,69,6,63,49,0,0
485,13/05/2021,3,0,65,16,49,49,0,0
610,08/05/2021,3,1,66,14,52,49,0,0
477,10/05/2021,3,4,116,30,86,49,0,0
272,01/05/2021,3,1,126,25,101,49,0,0
31,07/05/2021,3,1,62,10,52,49,0,0
421,02/05/2021,3,0,19,18,1,62,0,0
36,09/05/2021,3,1,62,1,61,49,0,0
716,15/05/2021,3,0,104,19,85,49,0,0
497,04/05/2021,3,2,191,59,132,49,0,0
528,06/05/2021,3,1,118,40,78,55,0,0
464,06/05/2021,3,1,265,33,232,66,0,0
321,03/05/2021,3,1,39,7,32,49,0,0
862,10/05/2021,3,0,110,43,67,49,0,0
569,04/05/2021,3,0,120,13,107,49,0,0
122,13/05/2021,3,8,113,61,52,55,0,0
249,01/05/2021,3,1,126,114,12,67,0,0
267,12/05/2021,3,3,80,41,39,49,0,0
539,07/05/2021,3,2,95,11,84,49,0,0
170,10/05/2021,3,0,105,41,64,49,0,0
547,11/05/2021,3,1,73,48,25,64,0,0
368,09/05/2021,3,1,84,16,68,49,0,0
86,05/05/2021,3,1,47,30,17,79,0,0
183,01/05/2021,3,2,78,21,57,49,0,0
674,03/05/2021,3,1,97,4,93,49,0,0
200,16/05/2021,3,58,61,37,24,49,0,0
683,17/05/2021,3,1,65,24,41,49,0,0
637,11/05/2021,3,4,70,47,23,49,0,0
832,08/05/2021,3,1,99,17,82,49,0,0
778,14/05/2021,3,2,79,54,25,49,0,0
571,10/05/2021,3,0,161,11,150,49,0,0
412,10/05/2021,3,3,98,9,89,49,0,0
219,11/05/2021,3,4,73,22,51,49,0,0
285,13/05/2021,3,0,80,37,43,55,0,0
290,11/05/2021,3,3,104,56,48,55,0,0
203,15/05/2021,3,0,40,4,36,49,0,0
681,02/05/2021,3,2,69,6,63,49,0,0
176,10/05/2021,3,4,96,27,69,49,0,0
335,12/05/2021,3,4,82,27,55,55,0,0
772,12/05/2021,3,0,57,37,20,67,0,0
250,05/05/2021,3,0,115,85,30,72,0,0
400,04/05/2021,3,1,29,7,22,49,0,0
494,02/05/2021,3,1,138,17,121,49,0,0
520,13/05/2021,3,0,58,19,39,49,0,0
870,06/05/2021,3,7,39,25,14,67,0,0
93,11/05/2021,3,3,138,63,75,49,0,0
272,02/05/2021,3,1,126,32,94,49,0,0
21,08/05/2021,3,1,59,1,58,49,0,0
517,01/05/2021,3,2,56,15,41,49,0,0
377,09/05/2021,3,1,148,29,119,49,0,0
891,15/05/2021,3,2,80,41,39,49,0,0
774,04/05/2021,3,6,99,38,61,49,0,0
528,05/05/2021,3,1,118,56,62,55,0,0
464,08/05/2021,3,1,265,15,250,66,0,0
321,04/05/2021,3,1,39,19,20,49,0,0
739,10/05/2021,3,2,73,22,51,49,0,0
569,05/05/2021,3,0,120,15,105,49,0,0
710,13/05/2021,3,0,20,12,8,55,0,0
300,01/05/2021,3,0,210,191,19,62,0,0
182,13/05/2021,3,2,78,27,51,49,0,0
364,06/05/2021,3,2,128,84,44,59,0,0
409,10/05/2021,3,7,100,51,49,49,0,0
721,11/05/2021,3,29,111,42,69,115,0,0
915,09/05/2021,3,5,184,5,179,35,0,0
487,04/05/2021,3,4,35,8,27,49,0,0
451,01/05/2021,3,2,81,45,36,66,0,0
307,04/05/2021,3,1,78,22,56,49,0,0
608,16/05/2021,3,9,131,16,115,49,0,0
251,17/05/2021,3,0,124,77,47,49,0,0
79,11/05/2021,3,2,44,38,6,82,0,0
832,07/05/2021,3,1,99,15,84,49,0,0
593,14/05/2021,3,7,74,38,36,49,0,0
607,10/05/2021,3,1,74,37,37,60,0,0
45,11/05/2021,3,2,154,26,128,49,0,0
556,11/05/2021,3,6,111,29,82,49,0,0
886,13/05/2021,3,0,152,90,62,49,0,0
821,10/05/2021,3,2,77,61,16,80,0,0
256,15/05/2021,3,0,109,18,91,49,0,0
434,10/05/2021,3,3,57,26,31,49,0,0
592,12/05/2021,3,19,65,62,3,115,0,0
222,10/05/2021,3,1,76,21,55,49,0,0
767,05/05/2021,3,0,67,36,31,60,0,0
423,04/05/2021,3,3,47,18,29,55,0,0
201,01/05/2021,3,2,136,10,126,49,0,0
868,13/05/2021,3,0,83,19,64,49,0,0
636,08/05/2021,3,1,119,116,3,71,0,0
93,12/05/2021,3,3,138,49,89,49,0,0
83,01/05/2021,3,39,129,81,48,49,0,0
31,08/05/2021,3,1,62,17,45,49,0,0
425,01/05/2021,3,3,247,10,237,66,0,0
468,09/05/2021,3,1,95,13,82,49,0,0
891,14/05/2021,3,2,80,37,43,49,0,0
157,02/05/2021,3,1,82,25,57,49,0,0
318,06/05/2021,3,0,59,41,18,60,0,0
782,07/05/2021,3,0,20,17,3,62,0,0
600,04/05/2021,3,1,49,26,23,55,0,0
12,12/05/2021,3,1,42,14,28,49,0,0
758,11/05/2021,3,0,73,25,48,55,0,0
171,10/05/2021,3,2,47,39,8,62,0,0
853,03/05/2021,3,6,96,12,84,55,0,0
491,13/05/2021,3,5,174,28,146,49,0,0
230,06/05/2021,3,0,80,50,30,52,0,0
711,07/05/2021,3,1,88,26,62,49,0,0
456,11/05/2021,3,2,88,37,51,49,0,0
226,11/05/2021,3,0,47,32,15,90,0,0
487,05/05/2021,3,4,35,7,28,49,0,0
228,02/05/2021,3,2,40,13,27,49,0,0
554,04/05/2021,3,1,41,9,32,49,0,0
809,16/05/2021,3,5,96,14,82,49,0,0
825,17/05/2021,3,3,143,43,100,49,0,0
114,10/05/2021,3,0,75,54,21,64,0,0
110,07/05/2021,3,1,86,14,72,49,0,0
271,13/05/2021,3,0,70,37,33,49,0,0
648,10/05/2021,3,0,64,44,20,64,0,0
39,09/05/2021,3,1,60,27,33,49,0,0
887,09/05/2021,3,17,306,5,301,39,0,0
699,13/05/2021,3,0,62,52,10,80,0,0
38,10/05/2021,3,1,49,29,20,60,0,0
531,14/05/2021,3,2,57,11,46,49,0,0
505,10/05/2021,3,0,84,26,58,49,0,0
130,13/05/2021,3,3,78,42,36,52,0,0
742,12/05/2021,3,1,73,25,48,49,0,0
480,06/05/2021,3,0,28,16,12,52,0,0
570,04/05/2021,3,0,149,55,94,49,0,0
201,02/05/2021,3,6,132,8,124,49,0,0
19,04/05/2021,3,1,93,16,77,49,0,0
601,08/05/2021,3,5,63,21,42,49,0,0
175,12/05/2021,3,0,120,38,82,49,0,0
402,01/05/2021,3,1,154,29,125,49,0,0
31,01/05/2021,3,1,62,5,57,49,0,0
469,01/05/2021,3,4,192,13,179,66,0,0
36,11/05/2021,3,1,62,29,33,49,0,0
459,15/05/2021,3,4,88,29,59,49,0,0
166,02/05/2021,3,1,65,31,34,49,0,0
628,07/05/2021,3,1,58,6,52,49,0,0
3,06/05/2021,3,6,107,30,77,49,0,0
128,04/05/2021,3,1,20,17,3,115,0,0
394,12/05/2021,3,4,64,31,33,49,0,0
137,12/05/2021,3,24,122,16,106,49,0,0
745,01/05/2021,3,3,102,19,83,49,0,0
557,04/05/2021,3,1,103,53,50,55,0,0
522,12/05/2021,3,1,61,33,28,52,0,0
258,06/05/2021,3,0,143,50,93,55,0,0
11,09/05/2021,3,1,83,19,64,49,0,0
794,12/05/2021,3,0,137,17,120,55,0,0
657,11/05/2021,3,0,48,30,18,59,0,0
685,06/05/2021,3,4,136,53,83,49,0,0
475,02/05/2021,3,1,98,42,56,49,0,0
639,04/05/2021,3,1,58,27,31,49,0,0
687,16/05/2021,3,3,84,21,63,49,0,0
251,19/05/2021,3,0,124,85,39,49,0,0
846,11/05/2021,3,3,186,15,171,45,0,0
584,07/05/2021,3,1,96,27,69,49,0,0
184,15/05/2021,3,0,51,17,34,49,0,0
864,10/05/2021,3,1,84,23,61,67,0,0
706,10/05/2021,3,1,73,35,38,49,0,0
887,10/05/2021,3,17,306,17,289,39,0,0
143,14/05/2021,3,0,120,17,103,49,0,0
357,11/05/2021,3,1,82,49,33,55,0,0
410,15/05/2021,3,1,55,21,34,49,0,0
855,10/05/2021,3,1,175,61,114,49,0,0
207,13/05/2021,3,2,61,24,37,59,0,0
861,12/05/2021,3,0,61,50,11,72,0,0
366,05/05/2021,3,0,80,72,8,77,0,0
187,03/05/2021,3,1,40,7,33,49,0,0
494,01/05/2021,3,1,138,12,126,49,0,0
19,05/05/2021,3,1,93,20,73,49,0,0
80,06/05/2021,3,1,124,34,90,49,0,0
558,05/05/2021,3,0,44,15,29,49,0,0
402,02/05/2021,3,1,154,15,139,49,0,0
827,01/05/2021,3,1,69,69,0,NA,NA,NA
469,02/05/2021,3,4,192,6,186,66,0,0
336,07/05/2021,3,0,74,28,46,49,0,0
181,14/05/2021,3,1,33,11,22,49,0,0
298,02/05/2021,3,2,227,60,167,49,0,0
279,05/05/2021,3,0,57,23,34,49,0,0
422,06/05/2021,3,1,78,27,51,49,0,0
163,03/05/2021,3,1,61,14,47,55,0,0
390,12/05/2021,3,3,133,47,86,49,0,0
113,10/05/2021,3,1,31,9,22,57,0,0
71,02/05/2021,3,2,60,10,50,49,0,0
853,04/05/2021,3,6,96,37,59,55,0,0
239,12/05/2021,3,0,40,34,6,85,0,0
364,07/05/2021,3,2,128,94,34,64,0,0
705,09/05/2021,3,1,90,8,82,49,0,0
794,13/05/2021,3,0,137,13,124,55,0,0
226,09/05/2021,3,0,47,13,34,49,0,0
731,06/05/2021,3,7,92,32,60,49,0,0
755,02/05/2021,3,0,87,36,51,49,0,0
197,03/05/2021,3,0,118,10,108,49,0,0
25,16/05/2021,3,1,51,17,34,49,0,0
825,19/05/2021,3,3,143,67,76,49,0,0
43,12/05/2021,3,1,72,29,43,64,0,0
647,07/05/2021,3,1,92,20,72,49,0,0
259,15/05/2021,3,0,60,39,21,49,0,0
153,10/05/2021,3,1,63,29,34,55,0,0
45,12/05/2021,3,1,155,33,122,49,0,0
887,11/05/2021,3,17,306,17,289,39,0,0
699,14/05/2021,3,0,62,32,30,49,0,0
38,09/05/2021,3,1,49,13,36,49,0,0
96,16/05/2021,3,13,56,26,30,49,0,0
434,12/05/2021,3,3,57,28,29,49,0,0
779,12/05/2021,3,0,104,33,71,55,0,0
772,10/05/2021,3,0,57,34,23,52,0,0
623,05/05/2021,3,0,78,14,64,49,0,0
895,04/05/2021,3,0,69,29,40,49,0,0
562,01/05/2021,3,1,67,14,53,49,0,0
803,06/05/2021,3,1,68,30,38,49,0,0
188,06/05/2021,3,5,116,33,83,49,0,0
175,04/05/2021,3,1,119,37,82,49,0,0
804,01/05/2021,3,3,142,56,86,49,0,0
208,01/05/2021,3,0,60,5,55,49,0,0
578,02/05/2021,3,2,56,8,48,49,0,0
405,07/05/2021,3,1,89,24,65,49,0,0
55,14/05/2021,3,1,32,7,25,49,0,0
298,03/05/2021,3,2,227,42,185,49,0,0
237,07/05/2021,3,5,116,21,95,49,0,0
518,07/05/2021,3,1,16,8,8,49,0,0
51,03/05/2021,3,2,78,16,62,55,0,0
142,10/05/2021,3,1,61,61,0,NA,NA,NA
575,12/05/2021,3,1,49,23,26,59,0,0
122,02/05/2021,3,4,117,32,85,49,0,0
312,08/05/2021,3,2,95,17,78,49,0,0
666,12/05/2021,3,3,63,27,36,49,0,0
325,06/05/2021,3,1,44,28,16,57,0,0
11,10/05/2021,3,1,83,37,46,49,0,0
90,13/05/2021,3,0,78,55,23,57,0,0
657,09/05/2021,3,0,48,7,41,49,0,0
263,04/05/2021,3,0,66,17,49,49,0,0
475,03/05/2021,3,1,98,26,72,49,0,0
35,04/05/2021,3,1,109,26,83,49,0,0
133,16/05/2021,3,2,62,28,34,49,0,0
253,08/05/2021,3,1,57,6,51,49,0,0
783,12/05/2021,3,1,79,47,32,59,0,0
431,07/05/2021,3,4,126,37,89,49,0,0
689,15/05/2021,3,0,130,11,119,49,0,0
17,10/05/2021,3,1,93,80,13,67,0,0
126,11/05/2021,3,1,119,43,76,49,0,0
219,07/05/2021,3,4,73,6,67,49,0,0
805,07/05/2021,3,0,113,19,94,49,0,0
357,09/05/2021,3,2,81,17,64,49,0,0
158,16/05/2021,3,2,22,4,18,49,0,0
855,12/05/2021,3,1,175,69,106,49,0,0
779,13/05/2021,3,0,104,28,76,55,0,0
127,11/05/2021,3,1,59,31,28,64,0,0
588,04/05/2021,3,1,58,35,23,60,0,0
189,03/05/2021,3,0,165,41,124,59,0,0
621,01/05/2021,3,1,59,15,44,49,0,0
460,04/05/2021,3,16,93,25,68,49,0,0
656,06/05/2021,3,0,115,45,70,49,0,0
175,05/05/2021,3,1,119,36,83,49,0,0
112,02/05/2021,3,1,83,15,68,49,0,0
725,01/05/2021,3,0,17,10,7,55,0,0
421,01/05/2021,3,0,19,19,0,NA,NA,NA
468,07/05/2021,3,1,95,16,79,49,0,0
319,14/05/2021,3,8,106,34,72,49,0,0
497,03/05/2021,3,1,192,35,157,49,0,0
155,06/05/2021,3,0,93,39,54,49,0,0
92,08/05/2021,3,1,121,16,105,49,0,0
51,04/05/2021,3,2,78,30,48,55,0,0
433,03/05/2021,3,1,317,44,273,66,0,0
538,11/05/2021,3,1,43,23,20,49,0,0
122,03/05/2021,3,5,116,33,83,49,0,0
397,08/05/2021,3,0,75,10,65,49,0,0
416,13/05/2021,3,0,34,2,32,49,0,0
521,01/05/2021,3,1,54,17,37,49,0,0
424,08/05/2021,3,1,27,14,13,49,0,0
168,13/05/2021,3,0,48,33,15,72,0,0
498,11/05/2021,3,0,87,35,52,49,0,0
263,05/05/2021,3,0,66,18,48,49,0,0
519,03/05/2021,3,0,64,19,45,55,0,0
919,04/05/2021,3,0,123,15,108,49,0,0
145,16/05/2021,3,4,54,5,49,49,0,0
253,09/05/2021,3,1,57,5,52,49,0,0
846,10/05/2021,3,3,186,16,170,45,0,0
439,08/05/2021,3,4,87,16,71,49,0,0
342,12/05/2021,3,0,114,60,54,49,0,0
198,10/05/2021,3,1,134,75,59,64,0,0
412,11/05/2021,3,3,98,16,82,49,0,0
219,08/05/2021,3,5,72,5,67,49,0,0
886,07/05/2021,3,4,148,45,103,49,0,0
559,11/05/2021,3,53,132,76,56,49,0,0
327,16/05/2021,3,1,67,16,51,49,0,0
831,11/05/2021,3,2,148,39,109,49,0,0
629,13/05/2021,3,1,61,28,33,49,0,0
772,11/05/2021,3,0,57,40,17,67,0,0
588,05/05/2021,3,1,58,28,30,60,0,0
28,03/05/2021,3,1,127,21,106,55,0,0
741,01/05/2021,3,1,69,10,59,49,0,0
868,04/05/2021,3,4,79,25,54,49,0,0
859,06/05/2021,3,1,84,20,64,49,0,0
93,04/05/2021,3,3,138,37,101,49,0,0
688,02/05/2021,3,8,111,41,70,49,0,0
363,01/05/2021,3,1,98,96,2,82,0,0
694,02/05/2021,3,3,106,7,99,49,0,0
377,08/05/2021,3,1,148,49,99,49,0,0
329,14/05/2021,3,9,98,7,91,49,0,0
157,03/05/2021,3,3,80,31,49,55,0,0
54,07/05/2021,3,1,60,11,49,49,0,0
292,06/05/2021,3,6,233,34,199,49,0,0
417,04/05/2021,3,2,101,51,50,55,0,0
862,03/05/2021,3,3,107,25,82,49,0,0
538,12/05/2021,3,1,43,21,22,49,0,0
171,03/05/2021,3,2,47,20,27,49,0,0
300,07/05/2021,3,0,210,136,74,49,0,0
522,13/05/2021,3,2,60,45,15,52,0,0
258,01/05/2021,3,0,143,23,120,49,0,0
717,07/05/2021,3,3,190,32,158,49,0,0
567,11/05/2021,3,0,61,33,28,55,0,0
498,04/05/2021,3,0,87,34,53,49,0,0
216,04/05/2021,3,1,57,15,42,49,0,0
519,02/05/2021,3,0,64,47,17,49,0,0
674,04/05/2021,3,1,97,9,88,49,0,0
442,16/05/2021,3,1,157,19,138,49,0,0
597,08/05/2021,3,2,99,11,88,49,0,0
500,12/05/2021,3,5,74,17,57,49,0,0
404,08/05/2021,3,0,67,21,46,49,0,0
259,13/05/2021,3,0,60,49,11,64,0,0
332,09/05/2021,3,0,40,8,32,49,0,0
706,09/05/2021,3,2,72,9,63,49,0,0
323,10/05/2021,3,0,31,19,12,64,0,0
84,07/05/2021,3,0,20,14,6,67,0,0
174,10/05/2021,3,2,26,8,18,55,0,0
386,16/05/2021,3,4,81,11,70,49,0,0
389,10/05/2021,3,2,124,64,60,49,0,0
781,13/05/2021,3,5,78,42,36,49,0,0
127,10/05/2021,3,1,59,25,34,55,0,0
33,04/05/2021,3,5,75,36,39,49,0,0
696,03/05/2021,3,2,87,13,74,55,0,0
358,02/05/2021,3,1,92,15,77,49,0,0
868,06/05/2021,3,4,79,14,65,49,0,0
610,07/05/2021,3,1,66,11,55,49,0,0
93,05/05/2021,3,3,138,41,97,49,0,0
899,02/05/2021,3,3,102,28,74,49,0,0
483,01/05/2021,3,3,96,25,71,49,0,0
580,01/05/2021,3,0,98,14,84,49,0,0
468,08/05/2021,3,1,95,19,76,49,0,0
508,14/05/2021,3,23,57,17,40,49,0,0
585,03/05/2021,3,4,56,19,37,59,0,0
458,07/05/2021,3,3,178,45,133,49,0,0
3,07/05/2021,3,6,107,24,83,49,0,0
128,03/05/2021,3,1,20,7,13,55,0,0
167,04/05/2021,3,0,84,64,20,72,0,0
113,14/05/2021,3,1,31,2,29,49,0,0
71,04/05/2021,3,1,61,23,38,49,0,0
833,07/05/2021,3,0,83,22,61,49,0,0
182,12/05/2021,3,2,78,22,56,49,0,0
234,03/05/2021,3,3,59,11,48,49,0,0
780,07/05/2021,3,3,57,37,20,49,0,0
27,12/05/2021,3,0,78,42,36,59,0,0
669,04/05/2021,3,0,87,30,57,49,0,0
583,05/05/2021,3,1,80,69,11,62,0,0
475,01/05/2021,3,1,98,30,68,49,0,0
372,02/05/2021,3,3,89,36,53,49,0,0
444,16/05/2021,3,4,115,24,91,49,0,0
162,09/05/2021,3,0,122,9,113,49,0,0
293,11/05/2021,3,1,59,23,36,49,0,0
574,07/05/2021,3,0,87,18,69,49,0,0
365,03/05/2021,3,0,68,14,54,59,0,0
17,09/05/2021,3,1,93,10,83,49,0,0
134,09/05/2021,3,1,47,13,34,49,0,0
384,11/05/2021,3,0,101,62,39,64,0,0
857,07/05/2021,3,2,208,44,164,49,0,0
476,09/05/2021,3,1,172,4,168,49,0,0
643,16/05/2021,3,1,102,16,86,49,0,0
831,10/05/2021,3,3,147,40,107,49,0,0
869,12/05/2021,3,3,57,45,12,82,0,0
452,10/05/2021,3,2,58,37,21,55,0,0
429,04/05/2021,3,3,122,17,105,49,0,0
696,04/05/2021,3,1,88,38,50,55,0,0
343,02/05/2021,3,1,61,28,33,49,0,0
803,05/05/2021,3,0,69,37,32,52,0,0
870,07/05/2021,3,6,40,12,28,49,0,0
492,05/05/2021,3,2,35,12,23,49,0,0
104,01/05/2021,3,4,58,30,28,49,0,0
618,01/05/2021,3,14,137,22,115,49,0,0
680,01/05/2021,3,3,77,57,20,49,0,0
599,05/05/2021,3,3,150,83,67,49,0,0
698,14/05/2021,3,2,114,42,72,49,0,0
166,04/05/2021,3,5,61,36,25,52,0,0
458,06/05/2021,3,0,181,79,102,49,0,0
813,07/05/2021,3,1,129,18,111,49,0,0
836,04/05/2021,3,3,98,63,35,55,0,0
529,04/05/2021,3,3,38,12,26,55,0,0
551,14/05/2021,3,0,115,12,103,49,0,0
122,05/05/2021,3,4,117,75,42,67,0,0
348,08/05/2021,3,51,89,57,32,49,0,0
281,12/05/2021,3,3,80,24,56,49,0,0
521,03/05/2021,3,1,54,14,40,49,0,0
717,08/05/2021,3,3,190,29,161,49,0,0
547,13/05/2021,3,0,74,35,39,49,0,0
498,05/05/2021,3,0,87,28,59,49,0,0
634,04/05/2021,3,1,19,19,0,NA,NA,NA
262,03/05/2021,3,2,49,11,38,55,0,0
627,02/05/2021,3,0,41,9,32,49,0,0
555,16/05/2021,3,0,117,21,96,49,0,0
269,08/05/2021,3,1,79,6,73,49,0,0
566,11/05/2021,3,1,74,38,36,52,0,0
728,08/05/2021,3,0,47,7,40,49,0,0
526,02/05/2021,3,0,38,6,32,49,0,0
287,10/05/2021,3,3,120,48,72,49,0,0
543,09/05/2021,3,1,64,8,56,49,0,0
384,09/05/2021,3,0,101,26,75,49,0,0
385,06/05/2021,3,1,62,37,25,55,0,0
407,10/05/2021,3,1,40,4,36,49,0,0
791,14/05/2021,3,21,107,23,84,49,0,0
389,12/05/2021,3,2,124,48,76,49,0,0
592,13/05/2021,3,20,64,44,20,64,0,0
612,10/05/2021,3,3,39,11,28,55,0,0
232,06/05/2021,3,3,62,32,30,55,0,0
189,04/05/2021,3,0,165,119,46,72,0,0
156,01/05/2021,3,3,145,18,127,49,0,0
485,04/05/2021,3,0,65,27,38,49,0,0
188,08/05/2021,3,5,116,19,97,49,0,0
477,04/05/2021,3,6,114,16,98,49,0,0
112,01/05/2021,3,1,83,13,70,49,0,0
845,01/05/2021,3,1,119,14,105,49,0,0
680,02/05/2021,3,3,77,40,37,49,0,0
605,05/05/2021,3,4,156,40,116,49,0,0
337,14/05/2021,3,0,60,7,53,49,0,0
798,03/05/2021,3,0,81,10,71,55,0,0
279,07/05/2021,3,0,57,18,39,49,0,0
760,07/05/2021,3,1,35,11,24,49,0,0
875,04/05/2021,3,4,88,58,30,55,0,0
142,04/05/2021,3,1,61,46,15,72,0,0
569,10/05/2021,3,0,120,9,111,49,0,0
852,02/05/2021,3,0,80,78,2,63,0,0
768,05/05/2021,3,1,86,27,59,49,0,0
446,12/05/2021,3,8,125,53,72,49,0,0
539,03/05/2021,3,2,95,13,82,49,0,0
170,07/05/2021,3,1,104,13,91,49,0,0
673,11/05/2021,3,0,123,31,92,49,0,0
226,05/05/2021,3,0,47,28,19,67,0,0
634,06/05/2021,3,1,19,19,0,NA,NA,NA
755,03/05/2021,3,0,87,30,57,59,0,0
659,02/05/2021,3,2,41,14,27,49,0,0
792,16/05/2021,3,0,102,24,78,49,0,0
683,08/05/2021,3,1,65,3,62,49,0,0
783,11/05/2021,3,1,79,58,21,72,0,0
404,07/05/2021,3,0,67,21,46,49,0,0
271,02/05/2021,3,1,69,5,64,49,0,0
413,10/05/2021,3,2,114,56,58,49,0,0
706,11/05/2021,3,1,73,33,40,49,0,0
633,11/05/2021,3,1,49,24,25,60,0,0
626,06/05/2021,3,2,100,53,47,55,0,0
5,05/05/2021,3,69,20,20,0,NA,NA,NA
643,14/05/2021,3,2,101,19,82,49,0,0
831,12/05/2021,3,0,150,41,109,49,0,0
207,12/05/2021,3,2,61,23,38,59,0,0
222,11/05/2021,3,1,76,15,61,49,0,0
623,06/05/2021,3,0,78,18,60,49,0,0
28,04/05/2021,3,1,127,89,38,72,0,0
653,01/05/2021,3,3,112,14,98,49,0,0
803,04/05/2021,3,0,69,34,35,49,0,0
656,08/05/2021,3,0,115,18,97,49,0,0
378,05/05/2021,3,1,83,37,46,55,0,0
264,01/05/2021,3,1,59,30,29,49,0,0
214,01/05/2021,3,5,81,46,35,49,0,0
260,01/05/2021,3,0,120,24,96,49,0,0
605,06/05/2021,3,3,157,32,125,49,0,0
329,09/05/2021,3,9,98,1,97,49,0,0
105,04/05/2021,3,1,74,44,30,59,0,0
786,07/05/2021,3,1,61,4,57,49,0,0
422,08/05/2021,3,1,78,47,31,49,0,0
213,04/05/2021,3,4,144,143,1,65,0,0
173,04/05/2021,3,1,70,40,30,60,0,0
839,07/05/2021,3,4,151,34,117,49,0,0
745,04/05/2021,3,3,102,43,59,55,0,0
557,07/05/2021,3,1,103,20,83,49,0,0
784,12/05/2021,3,3,46,19,27,49,0,0
325,02/05/2021,3,4,41,20,21,57,0,0
424,07/05/2021,3,1,27,14,13,49,0,0
673,12/05/2021,3,0,123,14,109,49,0,0
657,05/05/2021,3,0,48,32,16,60,0,0
233,04/05/2021,3,3,64,21,43,64,0,0
594,03/05/2021,3,43,64,35,29,59,0,0
270,02/05/2021,3,1,59,18,41,49,0,0
581,16/05/2021,3,202,23,28,-5,NA,NA,NA
399,09/05/2021,3,1,60,20,40,49,0,0
79,10/05/2021,3,2,44,40,4,85,0,0
598,08/05/2021,3,0,146,54,92,49,0,0
243,03/05/2021,3,1,126,18,108,49,0,0
589,10/05/2021,3,3,140,61,79,49,0,0
510,12/05/2021,3,1,142,19,123,49,0,0
633,08/05/2021,3,1,49,7,42,49,0,0
206,06/05/2021,3,17,196,129,67,59,0,0
5,04/05/2021,3,69,20,20,0,NA,NA,NA
820,14/05/2021,3,1,126,38,88,49,0,0
176,12/05/2021,3,3,97,33,64,49,0,0
224,13/05/2021,3,1,56,22,34,49,0,0
452,12/05/2021,3,2,58,42,16,55,0,0
232,04/05/2021,3,2,63,47,16,74,0,0
423,03/05/2021,3,1,49,11,38,55,0,0
445,01/05/2021,3,1,168,17,151,49,0,0
520,05/05/2021,3,0,58,16,42,49,0,0
733,07/05/2021,3,0,100,5,95,49,0,0
883,04/05/2021,3,2,102,16,86,45,0,0
104,02/05/2021,3,4,58,28,30,49,0,0
225,01/05/2021,3,11,69,15,54,49,0,0
24,02/05/2021,3,0,84,33,51,49,0,0
599,07/05/2021,3,2,151,47,104,49,0,0
911,09/05/2021,3,0,158,2,156,49,0,0
298,01/05/2021,3,2,227,108,119,49,0,0
458,05/05/2021,3,0,181,78,103,49,0,0
642,08/05/2021,3,5,90,18,72,49,0,0
213,03/05/2021,3,4,144,50,94,49,0,0
12,04/05/2021,3,1,42,18,24,49,0,0
650,09/05/2021,3,3,125,15,110,49,0,0
171,01/05/2021,3,3,46,7,39,52,0,0
768,07/05/2021,3,2,85,18,67,49,0,0
267,13/05/2021,3,3,80,45,35,49,0,0
325,01/05/2021,3,4,41,18,23,52,0,0
614,09/05/2021,3,1,81,15,66,49,0,0
159,13/05/2021,3,0,77,33,44,49,0,0
4,04/05/2021,3,2,62,42,20,64,0,0
583,06/05/2021,3,1,80,59,21,57,0,0
106,02/05/2021,3,1,30,7,23,49,0,0
639,03/05/2021,3,1,58,30,28,49,0,0
231,11/05/2021,3,0,41,30,11,74,0,0
186,08/05/2021,3,1,57,25,32,49,0,0
217,10/05/2021,3,1,40,33,7,63,0,0
686,08/05/2021,3,0,46,13,33,49,0,0
190,04/05/2021,3,5,75,22,53,52,0,0
776,10/05/2021,3,0,104,33,71,49,0,0
706,12/05/2021,3,1,73,36,37,49,0,0
544,09/05/2021,3,1,52,5,47,49,0,0
699,06/05/2021,3,0,62,26,36,59,0,0
316,05/05/2021,3,1,38,38,0,NA,NA,NA
96,15/05/2021,3,13,56,31,25,49,0,0
389,11/05/2021,3,2,124,57,67,49,0,0
254,12/05/2021,3,1,77,27,50,55,0,0
452,11/05/2021,3,2,58,44,14,67,0,0
250,06/05/2021,3,1,114,76,38,64,0,0
305,03/05/2021,3,3,56,6,50,49,0,0
828,01/05/2021,3,5,70,29,41,49,0,0
334,06/05/2021,3,0,58,19,39,49,0,0
499,06/05/2021,3,0,31,16,15,55,0,0
883,05/05/2021,3,2,102,19,83,45,0,0
804,02/05/2021,3,3,142,33,109,49,0,0
346,01/05/2021,3,6,114,64,50,49,0,0
260,02/05/2021,3,0,120,13,107,49,0,0
640,07/05/2021,3,4,122,28,94,49,0,0
911,08/05/2021,3,0,158,6,152,49,0,0
585,01/05/2021,3,5,55,29,26,49,0,0
565,07/05/2021,3,0,62,29,33,49,0,0
813,08/05/2021,3,1,129,16,113,49,0,0
684,03/05/2021,3,3,95,10,85,49,0,0
394,04/05/2021,3,4,64,24,40,49,0,0
872,09/05/2021,3,1,64,37,27,49,0,0
700,01/05/2021,3,7,125,125,0,NA,NA,NA
833,06/05/2021,3,0,83,42,41,49,0,0
446,13/05/2021,3,8,125,60,65,49,0,0
364,01/05/2021,3,3,127,124,3,80,0,0
705,11/05/2021,3,1,90,42,48,49,0,0
90,12/05/2021,3,0,78,50,28,67,0,0
67,03/05/2021,3,1,51,9,42,59,0,0
685,04/05/2021,3,3,137,66,71,55,0,0
617,02/05/2021,3,1,43,3,40,49,0,0
197,04/05/2021,3,0,118,27,91,49,0,0
652,11/05/2021,3,0,69,56,13,64,0,0
436,08/05/2021,3,2,204,19,185,49,0,0
566,10/05/2021,3,1,74,39,35,52,0,0
136,08/05/2021,3,0,128,66,62,49,0,0
778,04/05/2021,3,3,78,65,13,82,0,0
42,09/05/2021,3,2,97,15,82,49,0,0
45,09/05/2021,3,2,154,8,146,49,0,0
323,09/05/2021,3,0,31,11,20,49,0,0
84,06/05/2021,3,0,20,13,7,60,0,0
107,04/05/2021,3,2,87,66,21,82,0,0
158,15/05/2021,3,1,23,11,12,49,0,0
505,11/05/2021,3,0,84,23,61,49,0,0
20,12/05/2021,3,1,81,29,52,55,0,0
691,10/05/2021,3,1,31,16,15,72,0,0
854,04/05/2021,3,10,100,20,80,55,0,0
187,04/05/2021,3,1,40,16,24,49,0,0
621,02/05/2021,3,1,59,12,47,49,0,0
815,04/05/2021,3,12,117,31,86,49,0,0
636,06/05/2021,3,2,118,91,27,52,0,0
586,05/05/2021,3,3,80,50,30,64,0,0
934,01/05/2021,3,59,40,1,39,35,0,0
664,01/05/2021,3,3,152,41,111,49,0,0
468,05/05/2021,3,1,95,22,73,49,0,0
55,08/05/2021,3,1,32,0,32,49,0,0
798,01/05/2021,3,0,81,31,50,49,0,0
318,07/05/2021,3,0,59,10,49,49,0,0
754,06/05/2021,3,0,62,16,46,49,0,0
266,03/05/2021,3,1,60,18,42,49,0,0
167,03/05/2021,3,0,84,26,58,55,0,0
563,06/05/2021,3,1,69,26,43,49,0,0
670,08/05/2021,3,0,108,24,84,49,0,0
666,13/05/2021,3,2,64,24,40,49,0,0
258,03/05/2021,3,0,143,26,117,55,0,0
866,07/05/2021,3,0,100,9,91,49,0,0
561,12/05/2021,3,1,59,43,16,67,0,0
152,04/05/2021,3,1,90,27,63,55,0,0
369,06/05/2021,3,5,85,53,32,55,0,0
519,01/05/2021,3,0,64,63,1,49,0,0
665,02/05/2021,3,0,106,46,60,49,0,0
25,11/05/2021,3,1,51,28,23,60,0,0
512,08/05/2021,3,2,60,9,51,49,0,0
43,11/05/2021,3,1,72,32,40,64,0,0
574,08/05/2021,3,0,87,14,73,49,0,0
151,02/05/2021,3,7,69,13,56,49,0,0
413,09/05/2021,3,2,114,21,93,49,0,0
199,09/05/2021,3,2,80,14,66,49,0,0
215,11/05/2021,3,0,46,46,0,NA,NA,NA
886,06/05/2021,3,4,148,53,95,49,0,0
174,04/05/2021,3,2,26,7,19,60,0,0
327,15/05/2021,3,1,67,11,56,49,0,0
505,12/05/2021,3,0,84,22,62,49,0,0
789,12/05/2021,3,0,72,61,11,80,0,0
481,12/05/2021,3,0,56,32,24,67,0,0
120,04/05/2021,3,2,152,66,86,59,0,0
305,04/05/2021,3,2,57,19,38,49,0,0
828,02/05/2021,3,5,70,25,45,49,0,0
88,04/05/2021,3,1,41,6,35,55,0,0
859,07/05/2021,3,1,84,63,21,72,0,0
537,05/05/2021,3,2,100,96,4,119,0,0
112,07/05/2021,3,1,83,10,73,49,0,0
21,01/05/2021,3,1,59,4,55,49,0,0
283,06/05/2021,3,1,75,20,55,49,0,0
55,09/05/2021,3,1,32,3,29,49,0,0
7,01/05/2021,3,2,101,46,55,49,0,0
786,05/05/2021,3,11,51,8,43,49,0,0
642,06/05/2021,3,5,90,35,55,49,0,0
163,04/05/2021,3,1,61,44,17,80,0,0
12,03/05/2021,3,1,42,7,35,49,0,0
650,06/05/2021,3,2,126,59,67,49,0,0
249,06/05/2021,3,1,126,84,42,49,0,0
790,12/05/2021,3,1,98,42,56,66,0,0
787,04/05/2021,3,2,106,20,86,49,0,0
170,09/05/2021,3,0,105,8,97,49,0,0
746,13/05/2021,3,2,58,33,25,55,0,0
368,04/05/2021,3,1,84,40,44,55,0,0
841,04/05/2021,3,0,182,34,148,55,0,0
193,02/05/2021,3,1,107,11,96,49,0,0
554,03/05/2021,3,2,40,22,18,49,0,0
133,11/05/2021,3,3,61,39,22,49,0,0
350,08/05/2021,3,5,55,18,37,49,0,0
333,11/05/2021,3,1,56,54,2,85,0,0
598,07/05/2021,3,0,146,67,79,49,0,0
131,03/05/2021,3,2,47,4,43,49,0,0
607,09/05/2021,3,2,73,25,48,49,0,0
412,09/05/2021,3,3,98,6,92,49,0,0
349,02/05/2021,3,1,89,26,63,49,0,0
143,06/05/2021,3,5,115,65,50,49,0,0
174,05/05/2021,3,2,26,7,19,55,0,0
339,16/05/2021,3,17,577,22,555,49,0,0
314,10/05/2021,3,2,67,27,40,57,0,0
867,13/05/2021,3,1,59,51,8,72,0,0
612,11/05/2021,3,2,40,8,32,55,0,0
120,05/05/2021,3,2,152,71,81,59,0,0
276,04/05/2021,3,4,200,47,153,49,0,0
179,02/05/2021,3,2,90,7,83,49,0,0
738,05/05/2021,3,1,123,39,84,55,0,0
355,06/05/2021,3,3,96,28,68,55,0,0
858,05/05/2021,3,1,80,51,29,74,0,0
899,05/05/2021,3,8,97,18,79,49,0,0
214,02/05/2021,3,6,80,31,49,49,0,0
405,06/05/2021,3,1,89,33,56,49,0,0
319,08/05/2021,3,8,106,28,78,49,0,0
166,01/05/2021,3,2,64,52,12,52,0,0
528,07/05/2021,3,1,118,15,103,49,0,0
72,07/05/2021,3,2,58,31,27,49,0,0
684,04/05/2021,3,3,95,42,53,49,0,0
390,03/05/2021,3,2,134,14,120,49,0,0
569,07/05/2021,3,0,120,24,96,49,0,0
249,07/05/2021,3,1,126,71,55,49,0,0
790,13/05/2021,3,1,98,53,45,66,0,0
734,05/05/2021,3,2,59,59,0,NA,NA,NA
746,11/05/2021,3,3,57,37,20,64,0,0
211,05/05/2021,3,5,55,20,35,55,0,0
216,06/05/2021,3,1,57,15,42,49,0,0
594,02/05/2021,3,43,64,39,25,49,0,0
919,03/05/2021,3,0,123,6,117,49,0,0
245,11/05/2021,3,5,92,31,61,49,0,0
56,09/05/2021,3,4,61,7,54,49,0,0
293,10/05/2021,3,1,59,27,32,49,0,0
136,07/05/2021,3,0,128,94,34,52,0,0
151,03/05/2021,3,6,70,3,67,55,0,0
648,09/05/2021,3,0,64,25,39,49,0,0
126,09/05/2021,3,1,119,24,95,49,0,0
556,04/05/2021,3,1,116,31,85,49,0,0
143,07/05/2021,3,5,115,26,89,49,0,0
357,05/05/2021,3,2,81,34,47,55,0,0
791,16/05/2021,3,21,107,26,81,49,0,0
835,10/05/2021,3,4,100,79,21,74,0,0
419,13/05/2021,3,3,107,38,69,66,0,0
227,10/05/2021,3,3,41,9,32,49,0,0
232,05/05/2021,3,3,62,36,26,55,0,0
380,04/05/2021,3,2,158,34,124,49,0,0
445,02/05/2021,3,1,168,13,155,49,0,0
172,04/05/2021,3,2,83,32,51,55,0,0
188,07/05/2021,3,5,116,17,99,49,0,0
858,04/05/2021,3,1,80,50,30,67,0,0
83,06/05/2021,3,38,130,25,105,49,0,0
346,02/05/2021,3,4,116,31,85,49,0,0
377,07/05/2021,3,1,148,32,116,49,0,0
724,09/05/2021,3,2,84,53,31,49,0,0
125,06/05/2021,3,2,34,23,11,55,0,0
178,07/05/2021,3,0,38,11,27,49,0,0
292,08/05/2021,3,0,239,82,157,49,0,0
266,04/05/2021,3,1,60,44,16,57,0,0
394,03/05/2021,3,4,64,5,59,49,0,0
650,07/05/2021,3,2,126,24,102,49,0,0
557,08/05/2021,3,1,103,24,79,49,0,0
401,13/05/2021,3,0,79,56,23,67,0,0
118,04/05/2021,3,5,54,12,42,55,0,0
770,12/05/2021,3,4,31,9,22,55,0,0
57,03/05/2021,3,1,139,16,123,49,0,0
263,06/05/2021,3,0,66,16,50,49,0,0
106,01/05/2021,3,1,30,6,24,49,0,0
35,02/05/2021,3,1,109,13,96,49,0,0
145,11/05/2021,3,5,53,15,38,55,0,0
825,09/05/2021,3,3,143,6,137,49,0,0
500,10/05/2021,3,5,74,23,51,49,0,0
484,08/05/2021,3,0,40,13,27,49,0,0
190,03/05/2021,3,7,73,5,68,49,0,0
864,09/05/2021,3,1,84,15,69,49,0,0
126,10/05/2021,3,1,119,44,75,49,0,0
349,05/05/2021,3,1,89,35,54,59,0,0
180,06/05/2021,3,0,41,26,15,49,0,0
821,05/05/2021,3,2,77,54,23,60,0,0
203,14/05/2021,3,0,40,3,37,49,0,0
32,12/05/2021,3,1,104,93,11,80,0,0
419,12/05/2021,3,3,107,41,66,66,0,0
227,11/05/2021,3,3,41,17,24,49,0,0
274,06/05/2021,3,1,209,50,159,39,0,0
570,03/05/2021,3,0,149,22,127,49,0,0
343,01/05/2021,3,1,61,16,45,49,0,0
738,06/05/2021,3,1,123,36,87,55,0,0
97,06/05/2021,3,6,101,55,46,59,0,0
69,05/05/2021,3,1,59,43,16,62,0,0
804,06/05/2021,3,3,142,19,123,49,0,0
483,03/05/2021,3,3,96,19,77,49,0,0
468,06/05/2021,3,1,95,21,74,49,0,0
891,08/05/2021,3,2,80,7,73,49,0,0
798,06/05/2021,3,1,80,36,44,55,0,0
318,04/05/2021,3,0,59,59,0,NA,NA,NA
92,06/05/2021,3,1,121,28,93,49,0,0
138,03/05/2021,3,0,98,21,77,55,0,0
739,03/05/2021,3,5,70,11,59,49,0,0
872,08/05/2021,3,1,64,35,29,49,0,0
300,06/05/2021,3,0,210,106,104,49,0,0
401,12/05/2021,3,0,79,44,35,55,0,0
325,04/05/2021,3,1,44,36,8,55,0,0
770,13/05/2021,3,4,31,9,22,49,0,0
4,03/05/2021,3,2,62,33,29,55,0,0
86,04/05/2021,3,1,47,33,14,79,0,0
865,01/05/2021,3,2,83,6,77,49,0,0
307,02/05/2021,3,1,78,7,71,49,0,0
904,11/05/2021,3,5,269,11,258,66,0,0
56,08/05/2021,3,4,61,5,56,49,0,0
360,12/05/2021,3,1,43,15,28,59,0,0
362,08/05/2021,3,3,117,84,33,59,0,0
420,03/05/2021,3,10,59,8,51,59,0,0
17,01/05/2021,3,1,93,11,82,49,0,0
543,10/05/2021,3,1,64,34,30,49,0,0
633,05/05/2021,3,1,49,17,32,49,0,0
285,06/05/2021,3,0,80,35,45,49,0,0
290,05/05/2021,3,3,104,40,64,55,0,0
53,14/05/2021,3,0,70,29,41,49,0,0
837,10/05/2021,3,6,320,34,286,66,0,0
20,13/05/2021,3,1,81,42,39,55,0,0
742,02/05/2021,3,2,72,6,66,49,0,0
860,04/05/2021,3,13,79,27,52,49,0,0
238,04/05/2021,3,1,65,34,31,49,0,0
179,01/05/2021,3,2,90,8,82,49,0,0
334,05/05/2021,3,0,58,28,30,49,0,0
601,07/05/2021,3,3,65,17,48,49,0,0
492,04/05/2021,3,3,34,11,23,52,0,0
272,07/05/2021,3,1,126,19,107,49,0,0
214,03/05/2021,3,6,80,15,65,49,0,0
640,05/05/2021,3,1,125,37,88,49,0,0
98,08/05/2021,3,1,94,25,69,49,0,0
497,05/05/2021,3,2,191,57,134,49,0,0
54,03/05/2021,3,2,59,13,46,55,0,0
813,06/05/2021,3,1,129,38,91,49,0,0
417,03/05/2021,3,2,101,30,71,55,0,0
390,04/05/2021,3,2,134,36,98,49,0,0
137,09/05/2021,3,24,122,5,117,49,0,0
670,07/05/2021,3,0,108,23,85,49,0,0
281,13/05/2021,3,3,80,30,50,49,0,0
521,05/05/2021,3,1,54,27,27,55,0,0
736,11/05/2021,3,1,104,18,86,49,0,0
915,05/05/2021,3,4,185,18,167,35,0,0
369,04/05/2021,3,5,85,55,30,55,0,0
183,02/05/2021,3,3,77,18,59,49,0,0
919,02/05/2021,3,1,122,9,113,49,0,0
353,11/05/2021,3,1,51,50,1,59,0,0
654,09/05/2021,3,5,54,8,46,66,0,0
566,12/05/2021,3,1,74,36,38,52,0,0
362,07/05/2021,3,3,117,89,28,64,0,0
131,04/05/2021,3,2,47,9,38,49,0,0
361,01/05/2021,3,38,27,25,2,80,0,0
126,12/05/2021,3,1,119,44,75,49,0,0
619,02/05/2021,3,0,101,11,90,49,0,0
294,06/05/2021,3,1,116,44,72,49,0,0
316,04/05/2021,3,1,38,36,2,147,0,0
757,14/05/2021,3,0,117,33,84,49,0,0
837,12/05/2021,3,3,323,48,275,66,0,0
789,13/05/2021,3,0,72,27,45,55,0,0
227,04/05/2021,3,3,41,7,34,49,0,0
33,05/05/2021,3,6,74,26,48,49,0,0
777,03/05/2021,3,4,116,31,85,49,0,0
358,01/05/2021,3,1,92,16,76,49,0,0
172,06/05/2021,3,2,83,33,50,49,0,0
697,07/05/2021,3,1,108,28,80,49,0,0
702,04/05/2021,3,1,49,36,13,55,0,0
479,07/05/2021,3,0,55,12,43,49,0,0
21,02/05/2021,3,1,59,4,55,49,0,0
405,08/05/2021,3,1,89,23,66,49,0,0
550,08/05/2021,3,4,108,11,97,49,0,0
497,06/05/2021,3,1,192,48,144,49,0,0
628,04/05/2021,3,4,55,21,34,59,0,0
754,07/05/2021,3,0,62,6,56,49,0,0
836,03/05/2021,3,6,95,41,54,55,0,0
862,04/05/2021,3,2,108,39,69,49,0,0
758,09/05/2021,3,0,73,18,55,49,0,0
249,08/05/2021,3,1,126,90,36,55,0,0
416,05/05/2021,3,0,34,3,31,49,0,0
230,05/05/2021,3,0,80,38,42,52,0,0
229,11/05/2021,3,1,55,43,12,90,0,0
67,04/05/2021,3,1,51,32,19,59,0,0
703,09/05/2021,3,0,91,15,76,49,0,0
917,03/05/2021,3,4,102,19,83,35,0,0
35,03/05/2021,3,1,109,26,83,49,0,0
444,15/05/2021,3,4,115,37,78,49,0,0
654,08/05/2021,3,5,54,11,43,66,0,0
712,12/05/2021,3,1,84,10,74,49,0,0
838,07/05/2021,3,4,61,52,9,57,0,0
420,04/05/2021,3,12,57,27,30,59,0,0
361,02/05/2021,3,38,27,18,9,80,0,0
743,09/05/2021,3,1,125,13,112,49,0,0
75,05/05/2021,3,0,81,28,53,49,0,0
750,06/05/2021,3,4,108,55,53,49,0,0
559,03/05/2021,3,43,142,31,111,49,0,0
830,15/05/2021,3,0,66,17,49,49,0,0
176,02/05/2021,3,4,96,5,91,49,0,0
781,12/05/2021,3,5,78,32,46,49,0,0
452,03/05/2021,3,7,53,15,38,55,0,0
860,05/05/2021,3,6,86,18,68,49,0,0
785,03/05/2021,3,3,107,10,97,49,0,0
156,02/05/2021,3,3,145,42,103,49,0,0
101,04/05/2021,3,1,59,24,35,49,0,0
97,08/05/2021,3,7,100,16,84,49,0,0
558,15/05/2021,3,0,44,5,39,49,0,0
83,05/05/2021,3,38,130,34,96,49,0,0
845,02/05/2021,3,1,119,20,99,49,0,0
605,07/05/2021,3,2,158,20,138,49,0,0
181,09/05/2021,3,1,33,8,25,49,0,0
774,06/05/2021,3,6,99,45,54,49,0,0
237,03/05/2021,3,4,117,13,104,49,0,0
422,07/05/2021,3,1,78,36,42,49,0,0
252,03/05/2021,3,3,261,37,224,49,0,0
862,09/05/2021,3,0,110,24,86,49,0,0
839,09/05/2021,3,4,151,27,124,49,0,0
300,08/05/2021,3,0,210,180,30,57,0,0
281,05/05/2021,3,3,80,62,18,65,0,0
258,05/05/2021,3,0,143,58,85,55,0,0
713,11/05/2021,3,1,60,54,6,85,0,0
525,04/05/2021,3,4,71,46,25,52,0,0
216,09/05/2021,3,1,57,5,52,49,0,0
594,01/05/2021,3,43,64,61,3,62,0,0
270,03/05/2021,3,1,59,16,43,59,0,0
507,15/05/2021,3,2,198,20,178,49,0,0
56,10/05/2021,3,4,61,44,17,64,0,0
360,18/05/2021,3,1,43,19,24,59,0,0
838,08/05/2021,3,4,61,54,7,52,0,0
259,04/05/2021,3,0,60,36,24,55,0,0
607,03/05/2021,3,2,73,11,62,55,0,0
510,10/05/2021,3,1,142,12,130,49,0,0
323,06/05/2021,3,0,31,15,16,55,0,0
805,06/05/2021,3,0,113,49,64,49,0,0
821,03/05/2021,3,2,77,29,48,55,0,0
486,15/05/2021,3,0,124,14,110,49,0,0
314,02/05/2021,3,2,67,6,61,49,0,0
789,15/05/2021,3,0,72,15,57,49,0,0
275,04/05/2021,3,6,111,35,76,55,0,0
588,10/05/2021,3,0,59,44,15,60,0,0
895,09/05/2021,3,0,69,11,58,49,0,0
653,02/05/2021,3,3,112,8,104,49,0,0
19,09/05/2021,3,1,93,13,80,49,0,0
355,08/05/2021,3,3,96,9,87,49,0,0
613,16/05/2021,3,0,56,15,41,49,0,0
402,05/05/2021,3,0,155,32,123,49,0,0
31,03/05/2021,3,1,62,8,54,49,0,0
395,08/05/2021,3,2,70,15,55,49,0,0
301,09/05/2021,3,1,100,15,85,49,0,0
123,06/05/2021,3,0,95,7,88,49,0,0
735,04/05/2021,3,1,28,8,20,49,0,0
813,10/05/2021,3,1,129,71,58,49,0,0
252,04/05/2021,3,3,261,76,185,49,0,0
209,08/05/2021,3,1,113,87,26,60,0,0
137,08/05/2021,3,24,122,14,108,49,0,0
557,05/05/2021,3,1,103,59,44,55,0,0
784,05/05/2021,3,3,46,27,19,52,0,0
284,05/05/2021,3,1,25,18,7,62,0,0
524,12/05/2021,3,1,109,43,66,55,0,0
915,04/05/2021,3,8,181,25,156,35,0,0
216,11/05/2021,3,1,57,28,29,49,0,0
451,02/05/2021,3,2,81,29,52,66,0,0
665,03/05/2021,3,1,105,51,54,55,0,0
555,15/05/2021,3,0,117,16,101,49,0,0
399,10/05/2021,3,0,61,48,13,72,0,0
79,16/05/2021,3,2,44,13,31,49,0,0
686,13/05/2021,3,0,46,20,26,49,0,0
271,04/05/2021,3,0,70,40,30,55,0,0
864,01/05/2021,3,2,83,25,58,49,0,0
215,02/05/2021,3,0,46,6,40,49,0,0
143,10/05/2021,3,1,119,28,91,49,0,0
290,01/05/2021,3,0,107,87,20,52,0,0
486,16/05/2021,3,0,124,9,115,49,0,0
434,02/05/2021,3,3,57,5,52,49,0,0
779,14/05/2021,3,0,104,15,89,49,0,0
326,04/05/2021,3,3,78,39,39,55,0,0
854,11/05/2021,3,0,110,21,89,55,0,0
895,10/05/2021,3,0,69,35,34,49,0,0
562,02/05/2021,3,1,67,9,58,49,0,0
723,10/05/2021,3,1,80,37,43,49,0,0
697,08/05/2021,3,1,108,28,80,49,0,0
504,16/05/2021,3,0,83,7,76,49,0,0
804,05/05/2021,3,3,142,17,125,49,0,0
664,05/05/2021,3,3,152,77,75,49,0,0
550,17/05/2021,3,2,110,36,74,49,0,0
786,04/05/2021,3,1,61,10,51,49,0,0
3,09/05/2021,3,6,107,10,97,49,0,0
600,03/05/2021,3,1,49,11,38,55,0,0
739,08/05/2021,3,2,73,3,70,49,0,0
650,08/05/2021,3,3,125,17,108,49,0,0
249,05/05/2021,3,1,126,99,27,52,0,0
707,05/05/2021,3,2,38,30,8,80,0,0
284,04/05/2021,3,1,25,18,7,52,0,0
547,16/05/2021,3,0,74,20,54,49,0,0
368,05/05/2021,3,1,84,26,58,55,0,0
624,11/05/2021,3,2,77,21,56,49,0,0
183,03/05/2021,3,2,78,16,62,59,0,0
376,04/05/2021,3,1,63,51,12,74,0,0
591,15/05/2021,3,0,68,26,42,49,0,0
247,10/05/2021,3,3,90,46,44,55,0,0
79,18/05/2021,3,2,44,39,5,95,0,0
598,13/05/2021,3,0,146,75,71,55,0,0
259,03/05/2021,3,0,60,14,46,55,0,0
287,02/05/2021,3,3,120,20,100,49,0,0
215,04/05/2021,3,0,46,46,0,NA,NA,NA
220,10/05/2021,3,28,75,20,55,49,0,0
38,03/05/2021,3,4,46,13,33,55,0,0
830,16/05/2021,3,0,66,30,36,49,0,0
855,03/05/2021,3,1,175,25,150,49,0,0
629,14/05/2021,3,1,61,19,42,49,0,0
452,04/05/2021,3,7,53,34,19,60,0,0
108,10/05/2021,3,0,78,21,57,49,0,0
696,10/05/2021,3,2,87,39,48,49,0,0
828,06/05/2021,3,1,74,8,66,49,0,0
803,10/05/2021,3,1,68,33,35,49,0,0
610,06/05/2021,3,1,66,32,34,55,0,0
492,15/05/2021,3,3,34,19,15,49,0,0
402,06/05/2021,3,0,155,32,123,49,0,0
208,04/05/2021,3,0,60,46,14,59,0,0
856,17/05/2021,3,1,119,32,87,49,0,0
735,03/05/2021,3,1,28,2,26,49,0,0
139,09/05/2021,3,2,57,11,46,49,0,0
875,03/05/2021,3,4,88,27,61,55,0,0
167,09/05/2021,3,0,84,24,60,49,0,0
373,09/05/2021,3,4,99,18,81,49,0,0
348,06/05/2021,3,54,86,79,7,65,0,0
522,05/05/2021,3,1,61,30,31,52,0,0
364,04/05/2021,3,3,127,99,28,72,0,0
168,14/05/2021,3,0,48,16,32,49,0,0
806,05/05/2021,3,2,134,85,49,55,0,0
369,10/05/2021,3,5,85,49,36,55,0,0
848,01/05/2021,3,8,130,28,102,35,0,0
376,03/05/2021,3,1,63,16,47,55,0,0
119,15/05/2021,3,2,66,25,41,49,0,0
350,09/05/2021,3,5,55,20,35,49,0,0
217,18/05/2021,3,2,39,22,17,52,0,0
404,12/05/2021,3,0,67,39,28,59,0,0
420,02/05/2021,3,5,64,62,2,63,0,0
153,01/05/2021,3,1,63,25,38,49,0,0
887,01/05/2021,3,5,318,7,311,49,0,0
206,11/05/2021,3,17,196,128,68,59,0,0
107,01/05/2021,3,2,87,33,54,49,0,0
2,14/05/2021,3,3,56,29,27,49,0,0
709,03/05/2021,3,1,82,6,76,55,0,0
396,15/05/2021,3,1,29,13,16,49,0,0
691,03/05/2021,3,1,31,7,24,59,0,0
120,10/05/2021,3,0,154,68,86,49,0,0
570,08/05/2021,3,0,149,21,128,49,0,0
445,07/05/2021,3,1,168,16,152,49,0,0
460,10/05/2021,3,4,105,27,78,49,0,0
636,07/05/2021,3,1,119,112,7,70,0,0
883,16/05/2021,3,6,98,10,88,45,0,0
804,07/05/2021,3,3,142,38,104,49,0,0
845,05/05/2021,3,1,119,53,66,60,0,0
698,17/05/2021,3,2,114,27,87,49,0,0
786,03/05/2021,3,1,61,3,58,49,0,0
139,10/05/2021,3,2,57,21,36,49,0,0
138,04/05/2021,3,1,97,49,48,55,0,0
173,09/05/2021,3,3,68,18,50,49,0,0
563,07/05/2021,3,1,69,11,58,49,0,0
557,06/05/2021,3,1,103,49,54,55,0,0
296,05/05/2021,3,3,57,23,34,49,0,0
521,04/05/2021,3,1,54,40,14,67,0,0
587,15/05/2021,3,2,79,12,67,49,0,0
657,04/05/2021,3,0,48,39,9,55,0,0
685,10/05/2021,3,4,136,75,61,55,0,0
262,02/05/2021,3,2,49,22,27,49,0,0
665,04/05/2021,3,1,105,36,69,55,0,0
46,14/05/2021,3,2,58,24,34,49,0,0
192,08/05/2021,3,0,86,12,74,49,0,0
311,18/05/2021,3,0,97,56,41,55,0,0
714,13/05/2021,3,0,59,53,6,79,0,0
593,03/05/2021,3,5,76,31,45,59,0,0
153,02/05/2021,3,1,63,16,47,49,0,0
75,01/05/2021,3,0,81,16,65,49,0,0
626,10/05/2021,3,1,101,42,59,55,0,0
316,01/05/2021,3,1,38,19,19,49,0,0
96,14/05/2021,3,14,55,23,32,49,0,0
505,02/05/2021,3,0,84,18,66,49,0,0
20,14/05/2021,3,1,81,12,69,49,0,0
127,04/05/2021,3,1,59,27,32,64,0,0
392,10/05/2021,3,0,176,58,118,49,0,0
189,08/05/2021,3,0,165,43,122,49,0,0
156,05/05/2021,3,0,148,89,59,60,0,0
868,10/05/2021,3,4,79,23,56,49,0,0
859,08/05/2021,3,1,84,83,1,85,0,0
795,15/05/2021,3,8,97,52,45,49,0,0
479,06/05/2021,3,0,55,22,33,49,0,0
363,04/05/2021,3,1,98,55,43,64,0,0
98,17/05/2021,3,1,94,84,10,89,0,0
565,04/05/2021,3,0,62,55,7,93,0,0
202,09/05/2021,3,1,75,28,47,49,0,0
252,09/05/2021,3,3,261,28,233,49,0,0
496,09/05/2021,3,1,59,12,47,49,0,0
563,09/05/2021,3,1,69,12,57,49,0,0
312,05/05/2021,3,4,93,45,48,55,0,0
666,05/05/2021,3,3,63,22,41,49,0,0
734,04/05/2021,3,2,59,56,3,59,0,0
770,14/05/2021,3,4,31,5,26,49,0,0
152,05/05/2021,3,1,90,38,52,55,0,0
841,09/05/2021,3,0,182,19,163,55,0,0
865,02/05/2021,3,2,83,4,79,49,0,0
627,06/05/2021,3,0,41,7,34,59,0,0
133,14/05/2021,3,2,62,15,47,49,0,0
251,08/05/2021,3,1,123,14,109,49,0,0
824,18/05/2021,3,0,339,34,305,55,0,0
136,13/05/2021,3,0,128,99,29,57,0,0
593,04/05/2021,3,5,76,54,22,89,0,0
147,01/05/2021,3,0,80,5,75,49,0,0
384,01/05/2021,3,0,101,45,56,49,0,0
206,12/05/2021,3,17,196,133,63,59,0,0
107,02/05/2021,3,2,87,28,59,49,0,0
256,13/05/2021,3,0,109,84,25,57,0,0
103,03/05/2021,3,1,160,27,133,55,0,0
65,14/05/2021,3,1,77,8,69,49,0,0
772,04/05/2021,3,1,56,37,19,67,0,0
108,09/05/2021,3,0,78,10,68,49,0,0
238,09/05/2021,3,0,66,16,50,49,0,0
358,05/05/2021,3,2,91,51,40,67,0,0
485,10/05/2021,3,0,65,23,42,49,0,0
656,07/05/2021,3,0,115,18,97,49,0,0
858,15/05/2021,3,0,81,39,42,49,0,0
479,05/05/2021,3,0,55,25,30,49,0,0
827,05/05/2021,3,1,69,19,50,55,0,0
337,17/05/2021,3,1,59,45,14,62,0,0
565,03/05/2021,3,0,62,22,40,59,0,0
422,09/05/2021,3,1,78,18,60,49,0,0
417,09/05/2021,3,0,103,19,84,49,0,0
862,08/05/2021,3,0,110,35,75,49,0,0
113,08/05/2021,3,1,31,3,28,49,0,0
853,06/05/2021,3,6,96,33,63,55,0,0
296,06/05/2021,3,3,57,28,29,49,0,0
539,05/05/2021,3,2,95,26,69,49,0,0
561,14/05/2021,3,1,59,23,36,49,0,0
211,04/05/2021,3,4,56,28,28,55,0,0
703,10/05/2021,3,0,91,45,46,55,0,0
917,02/05/2021,3,2,104,2,102,35,0,0
665,06/05/2021,3,2,104,41,63,55,0,0
200,14/05/2021,3,56,63,40,23,49,0,0
393,08/05/2021,3,1,59,13,46,49,0,0
712,09/05/2021,3,2,83,7,76,49,0,0
352,13/05/2021,3,0,64,29,35,55,0,0
689,02/05/2021,3,1,129,12,117,49,0,0
332,01/05/2021,3,0,40,8,32,49,0,0
619,01/05/2021,3,0,101,14,87,49,0,0
206,10/05/2021,3,17,196,127,69,59,0,0
316,02/05/2021,3,1,38,20,18,49,0,0
732,12/05/2021,3,0,60,14,46,57,0,0
121,03/05/2021,3,1,109,63,46,55,0,0
869,14/05/2021,3,1,59,52,7,89,0,0
52,02/05/2021,3,27,115,22,93,49,0,0
177,09/05/2021,3,0,48,13,35,49,0,0
570,09/05/2021,3,0,149,10,139,49,0,0
156,07/05/2021,3,4,144,33,111,49,0,0
19,10/05/2021,3,1,93,57,36,49,0,0
610,13/05/2021,3,1,66,29,37,55,0,0
378,16/05/2021,3,0,84,16,68,49,0,0
899,07/05/2021,3,7,98,26,72,49,0,0
208,06/05/2021,3,0,60,21,39,55,0,0
716,16/05/2021,3,0,104,23,81,49,0,0
155,04/05/2021,3,0,93,43,50,55,0,0
92,09/05/2021,3,1,121,17,104,49,0,0
836,09/05/2021,3,4,97,26,71,49,0,0
12,09/05/2021,3,2,41,6,35,49,0,0
551,09/05/2021,3,1,114,8,106,49,0,0
670,11/05/2021,3,6,102,74,28,64,0,0
401,06/05/2021,3,0,79,41,38,55,0,0
787,05/05/2021,3,1,107,26,81,49,0,0
736,14/05/2021,3,1,104,12,92,49,0,0
806,04/05/2021,3,5,131,90,41,55,0,0
86,10/05/2021,3,2,46,33,13,52,0,0
451,03/05/2021,3,2,81,16,65,66,0,0
376,06/05/2021,3,2,62,47,15,67,0,0
555,14/05/2021,3,1,116,25,91,49,0,0
399,08/05/2021,3,1,60,25,35,49,0,0
797,09/05/2021,3,0,67,12,55,49,0,0
431,12/05/2021,3,2,128,59,69,59,0,0
689,03/05/2021,3,1,129,10,119,49,0,0
776,01/05/2021,3,0,104,9,95,49,0,0
633,01/05/2021,3,2,48,11,37,49,0,0
180,10/05/2021,3,0,41,25,16,52,0,0
530,02/05/2021,3,1,59,48,11,57,0,0
732,11/05/2021,3,0,60,19,41,63,0,0
32,03/05/2021,3,1,104,51,53,59,0,0
869,15/05/2021,3,1,59,57,2,117,0,0
227,02/05/2021,3,3,41,8,33,49,0,0
366,09/05/2021,3,0,80,28,52,49,0,0
187,01/05/2021,3,2,39,28,11,52,0,0
179,06/05/2021,3,2,90,40,50,55,0,0
101,10/05/2021,3,1,59,31,28,49,0,0
870,13/05/2021,3,6,40,35,5,91,0,0
537,16/05/2021,3,3,99,79,20,57,0,0
112,05/05/2021,3,1,83,17,66,49,0,0
225,06/05/2021,3,11,69,19,50,55,0,0
313,17/05/2021,3,0,31,25,6,57,0,0
178,03/05/2021,3,0,38,10,28,59,0,0
642,09/05/2021,3,5,90,9,81,49,0,0
875,09/05/2021,3,1,91,27,64,49,0,0
390,09/05/2021,3,2,134,3,131,49,0,0
551,07/05/2021,3,0,115,13,102,49,0,0
853,11/05/2021,3,4,98,45,53,55,0,0
239,05/05/2021,3,0,40,37,3,93,0,0
234,05/05/2021,3,2,60,24,36,49,0,0
547,15/05/2021,3,1,73,17,56,49,0,0
560,04/05/2021,3,0,80,56,24,74,0,0
731,11/05/2021,3,4,95,58,37,52,0,0
106,03/05/2021,3,1,30,7,23,55,0,0
376,05/05/2021,3,1,63,44,19,67,0,0
687,14/05/2021,3,3,84,15,69,49,0,0
15,09/05/2021,3,0,31,9,22,49,0,0
566,08/05/2021,3,1,74,37,37,49,0,0
647,13/05/2021,3,2,91,68,23,52,0,0
817,04/05/2021,3,2,81,35,46,49,0,0
198,02/05/2021,3,0,135,6,129,49,0,0
77,01/05/2021,3,1,102,65,37,49,0,0
699,10/05/2021,3,0,62,45,17,64,0,0
679,03/05/2021,3,2,87,48,39,59,0,0
410,11/05/2021,3,0,56,21,35,49,0,0
835,03/05/2021,3,5,99,22,77,55,0,0
130,14/05/2021,3,3,78,17,61,49,0,0
127,02/05/2021,3,1,59,9,50,49,0,0
588,09/05/2021,3,0,59,9,50,49,0,0
305,02/05/2021,3,2,57,0,57,49,0,0
562,06/05/2021,3,2,66,44,22,57,0,0
19,11/05/2021,3,1,93,37,56,49,0,0
859,15/05/2021,3,1,84,83,1,82,0,0
504,15/05/2021,3,0,83,18,65,49,0,0
688,05/05/2021,3,1,118,51,67,49,0,0
31,05/05/2021,3,1,62,14,48,49,0,0
55,17/05/2021,3,1,32,18,14,52,0,0
178,04/05/2021,3,0,38,30,8,64,0,0
292,10/05/2021,3,5,234,23,211,49,0,0
128,01/05/2021,3,1,20,8,12,49,0,0
496,08/05/2021,3,1,59,9,50,49,0,0
569,08/05/2021,3,0,120,30,90,49,0,0
348,12/05/2021,3,6,134,83,51,70,0,0
401,05/05/2021,3,0,79,49,30,55,0,0
49,04/05/2021,3,2,146,17,129,49,0,0
673,14/05/2021,3,0,123,13,110,49,0,0
211,03/05/2021,3,4,56,16,40,55,0,0
511,09/05/2021,3,5,71,20,51,49,0,0
193,01/05/2021,3,1,107,16,91,49,0,0
197,06/05/2021,3,0,118,37,81,49,0,0
687,15/05/2021,3,3,84,13,71,49,0,0
683,09/05/2021,3,1,65,6,59,49,0,0
217,07/05/2021,3,1,40,23,17,49,0,0
728,13/05/2021,3,4,43,31,12,52,0,0
271,03/05/2021,3,0,70,9,61,49,0,0
332,02/05/2021,3,0,40,1,39,49,0,0
349,01/05/2021,3,1,89,27,62,49,0,0
84,11/05/2021,3,0,20,15,5,127,0,0
357,01/05/2021,3,2,81,11,70,49,0,0
203,12/05/2021,3,0,40,4,36,49,0,0
837,03/05/2021,3,6,320,12,308,66,0,0
224,14/05/2021,3,1,56,13,43,49,0,0
222,03/05/2021,3,1,76,4,72,49,0,0
623,09/05/2021,3,0,78,8,70,49,0,0
777,02/05/2021,3,4,116,23,93,49,0,0
562,05/05/2021,3,2,66,32,34,49,0,0
803,11/05/2021,3,1,68,26,42,49,0,0
859,14/05/2021,3,1,84,64,20,64,0,0
795,16/05/2021,3,8,97,36,61,49,0,0
112,06/05/2021,3,1,83,22,61,49,0,0
618,05/05/2021,3,15,136,34,102,49,0,0
181,16/05/2021,3,1,33,5,28,49,0,0
279,03/05/2021,3,0,57,14,43,49,0,0
760,10/05/2021,3,3,33,5,28,49,0,0
321,01/05/2021,3,1,39,4,35,49,0,0
142,02/05/2021,3,1,61,32,29,52,0,0
569,09/05/2021,3,0,120,13,107,49,0,0
853,12/05/2021,3,4,98,37,61,55,0,0
522,06/05/2021,3,1,61,35,26,49,0,0
873,04/05/2021,3,4,97,38,59,49,0,0
159,15/05/2021,3,0,77,22,55,49,0,0
437,03/05/2021,3,2,163,37,126,49,0,0
216,10/05/2021,3,1,57,23,34,49,0,0
917,05/05/2021,3,3,103,24,79,35,0,0
376,07/05/2021,3,2,62,24,38,49,0,0
652,15/05/2021,3,0,69,7,62,49,0,0
162,10/05/2021,3,0,122,32,90,49,0,0
360,07/05/2021,3,1,43,1,42,49,0,0
431,13/05/2021,3,3,127,47,80,59,0,0
131,02/05/2021,3,2,47,6,41,49,0,0
153,03/05/2021,3,1,63,16,47,49,0,0
886,12/05/2021,3,3,149,90,59,49,0,0
679,01/05/2021,3,1,88,84,4,82,0,0
386,12/05/2021,3,5,80,44,36,52,0,0
257,03/05/2021,3,1,43,16,27,55,0,0
676,14/05/2021,3,3,112,45,67,49,0,0
222,04/05/2021,3,1,76,19,57,49,0,0
480,10/05/2021,3,0,28,12,16,49,0,0
785,02/05/2021,3,3,107,9,98,49,0,0
653,06/05/2021,3,2,113,47,66,49,0,0
815,11/05/2021,3,12,117,48,69,49,0,0
80,14/05/2021,3,1,124,16,108,49,0,0
858,16/05/2021,3,0,81,11,70,49,0,0
535,06/05/2021,3,1,82,27,55,49,0,0
911,17/05/2021,3,0,158,8,150,49,0,0
528,04/05/2021,3,1,118,44,74,55,0,0
3,11/05/2021,3,5,108,52,56,49,0,0
51,01/05/2021,3,2,78,16,62,49,0,0
433,01/05/2021,3,1,317,32,285,66,0,0
348,13/05/2021,3,7,133,78,55,57,0,0
707,06/05/2021,3,2,38,28,10,67,0,0
258,04/05/2021,3,0,143,66,77,55,0,0
229,09/05/2021,3,1,55,20,35,49,0,0
669,03/05/2021,3,0,87,13,74,49,0,0
511,10/05/2021,3,3,73,33,40,49,0,0
183,04/05/2021,3,2,78,32,46,64,0,0
554,05/05/2021,3,1,41,7,34,49,0,0
581,14/05/2021,3,163,62,29,33,49,0,0
825,10/05/2021,3,3,143,27,116,49,0,0
43,08/05/2021,3,1,72,15,57,49,0,0
584,12/05/2021,3,1,96,48,48,55,0,0
817,02/05/2021,3,1,82,16,66,49,0,0
361,03/05/2021,3,38,27,16,11,80,0,0
294,12/05/2021,3,0,117,39,78,49,0,0
407,01/05/2021,3,2,39,7,32,49,0,0
921,13/05/2021,3,13,162,11,151,45,0,0
837,02/05/2021,3,6,320,5,315,66,0,0
789,14/05/2021,3,0,72,15,57,49,0,0
612,04/05/2021,3,2,40,15,25,49,0,0
623,10/05/2021,3,0,78,20,58,49,0,0
305,01/05/2021,3,1,58,6,52,49,0,0
562,07/05/2021,3,2,66,23,43,49,0,0
466,11/05/2021,3,0,140,33,107,49,0,0
355,15/05/2021,3,3,96,14,82,49,0,0
586,07/05/2021,3,3,80,62,18,72,0,0
272,06/05/2021,3,1,126,35,91,49,0,0
98,16/05/2021,3,1,94,27,67,49,0,0
528,03/05/2021,3,1,118,23,95,55,0,0
422,11/05/2021,3,1,78,38,40,49,0,0
875,01/05/2021,3,4,88,20,68,49,0,0
527,02/05/2021,3,8,53,16,37,49,0,0
557,13/05/2021,3,1,103,63,40,60,0,0
882,06/05/2021,3,0,130,31,99,39,0,0
325,05/05/2021,3,1,44,25,19,60,0,0
713,10/05/2021,3,1,60,44,16,85,0,0
152,03/05/2021,3,1,90,21,69,49,0,0
624,10/05/2021,3,2,77,23,54,49,0,0
519,05/05/2021,3,0,64,30,34,55,0,0
639,06/05/2021,3,1,58,33,25,49,0,0
809,14/05/2021,3,5,96,21,75,49,0,0
269,10/05/2021,3,3,77,9,68,49,0,0
79,08/05/2021,3,1,45,18,27,49,0,0
832,12/05/2021,3,1,99,34,65,49,0,0
243,04/05/2021,3,1,126,26,100,49,0,0
648,03/05/2021,3,1,63,31,32,59,0,0
76,05/05/2021,3,1,92,73,19,57,0,0
5,03/05/2021,3,69,20,13,7,49,0,0
820,13/05/2021,3,1,126,86,40,64,0,0
389,02/05/2021,3,2,124,13,111,49,0,0
207,15/05/2021,3,2,61,13,48,49,0,0
612,03/05/2021,3,2,40,15,25,49,0,0
392,11/05/2021,3,0,176,54,122,49,0,0
400,02/05/2021,3,1,29,4,25,49,0,0
653,07/05/2021,3,2,113,18,95,49,0,0
172,09/05/2021,3,2,83,16,67,49,0,0
188,14/05/2021,3,3,118,70,48,49,0,0
406,07/05/2021,3,1,38,15,23,49,0,0
688,06/05/2021,3,1,118,57,61,49,0,0
844,17/05/2021,3,0,61,7,54,55,0,0
628,03/05/2021,3,4,55,8,47,55,0,0
642,11/05/2021,3,5,90,29,61,49,0,0
684,02/05/2021,3,3,95,5,90,49,0,0
12,01/05/2021,3,1,42,5,37,49,0,0
312,12/05/2021,3,2,95,38,57,55,0,0
267,05/05/2021,3,3,80,75,5,70,0,0
364,05/05/2021,3,2,128,86,42,64,0,0
567,09/05/2021,3,0,61,7,54,49,0,0
498,03/05/2021,3,0,87,19,68,49,0,0
583,10/05/2021,3,1,80,42,38,49,0,0
848,05/05/2021,3,9,129,16,113,35,0,0
919,06/05/2021,3,1,122,15,107,49,0,0
591,14/05/2021,3,1,67,17,50,49,0,0
597,10/05/2021,3,3,98,34,64,49,0,0
637,08/05/2021,3,1,73,24,49,49,0,0
832,13/05/2021,3,1,99,29,70,49,0,0
184,04/05/2021,3,0,51,37,14,80,0,0
864,02/05/2021,3,2,83,19,64,52,0,0
143,04/05/2021,3,2,118,51,67,49,0,0
290,03/05/2021,3,6,101,31,70,49,0,0
921,11/05/2021,3,12,163,33,130,45,0,0
709,02/05/2021,3,1,82,8,74,49,0,0
282,15/05/2021,3,27,674,31,643,49,0,0
52,04/05/2021,3,8,134,67,67,59,0,0
623,11/05/2021,3,0,78,21,57,49,0,0
570,01/05/2021,3,0,149,25,124,49,0,0
179,07/05/2021,3,2,90,14,76,49,0,0
868,09/05/2021,3,4,79,6,73,49,0,0
636,14/05/2021,3,0,120,23,97,49,0,0
175,07/05/2021,3,1,119,11,108,49,0,0
104,07/05/2021,3,1,61,20,41,49,0,0
313,16/05/2021,3,0,31,12,19,49,0,0
318,03/05/2021,3,0,59,12,47,55,0,0
622,09/05/2021,3,1,43,16,27,49,0,0
213,01/05/2021,3,4,144,144,0,NA,NA,NA
390,01/05/2021,3,2,134,19,115,49,0,0
557,12/05/2021,3,1,103,63,40,55,0,0
790,06/05/2021,3,1,98,34,64,66,0,0
118,05/05/2021,3,4,55,19,36,55,0,0
164,09/05/2021,3,1,61,12,49,49,0,0
525,03/05/2021,3,4,71,34,37,49,0,0
748,10/05/2021,3,4,140,57,83,49,0,0
193,06/05/2021,3,1,107,34,73,49,0,0
674,07/05/2021,3,1,97,7,90,49,0,0
46,15/05/2021,3,1,59,16,43,49,0,0
474,08/05/2021,3,0,112,18,94,49,0,0
797,08/05/2021,3,1,66,16,50,49,0,0
574,12/05/2021,3,1,86,16,70,49,0,0
184,02/05/2021,3,0,51,18,33,49,0,0
648,01/05/2021,3,1,63,32,31,57,0,0
220,04/05/2021,3,38,78,31,47,49,0,0
476,07/05/2021,3,1,172,5,167,49,0,0
158,13/05/2021,3,1,23,17,6,74,0,0
855,02/05/2021,3,1,175,27,148,49,0,0
207,14/05/2021,3,2,61,11,50,49,0,0
426,03/05/2021,3,1,162,30,132,55,0,0
767,10/05/2021,3,0,67,48,19,60,0,0
423,01/05/2021,3,4,46,46,0,NA,NA,NA
358,07/05/2021,3,2,91,17,74,49,0,0
460,09/05/2021,3,12,97,24,73,49,0,0
733,15/05/2021,3,0,100,6,94,49,0,0
858,07/05/2021,3,1,80,37,43,49,0,0
264,07/05/2021,3,1,59,11,48,49,0,0
337,16/05/2021,3,0,60,10,50,49,0,0
54,04/05/2021,3,2,59,58,1,74,0,0
518,09/05/2021,3,1,16,3,13,49,0,0
252,01/05/2021,3,1,263,31,232,49,0,0
390,02/05/2021,3,2,134,10,124,49,0,0
670,12/05/2021,3,6,102,67,35,64,0,0
491,05/05/2021,3,6,173,42,131,49,0,0
49,05/05/2021,3,2,146,19,127,49,0,0
561,10/05/2021,3,1,59,59,0,NA,NA,NA
57,04/05/2021,3,1,139,32,107,49,0,0
233,10/05/2021,3,4,63,37,26,49,0,0
228,06/05/2021,3,3,39,16,23,49,0,0
270,07/05/2021,3,1,59,15,44,49,0,0
200,15/05/2021,3,58,61,41,20,49,0,0
269,09/05/2021,3,3,77,5,72,49,0,0
43,09/05/2021,3,1,72,12,60,49,0,0
110,13/05/2021,3,1,86,53,33,49,0,0
342,02/05/2021,3,0,114,16,98,49,0,0
332,03/05/2021,3,0,40,3,37,55,0,0
750,04/05/2021,3,10,102,44,58,49,0,0
530,04/05/2021,3,1,59,31,28,55,0,0
643,12/05/2021,3,2,101,42,59,49,0,0
434,03/05/2021,3,3,57,11,46,49,0,0
254,14/05/2021,3,1,77,10,67,49,0,0
326,02/05/2021,3,5,76,17,59,49,0,0
177,11/05/2021,3,0,48,29,19,64,0,0
28,01/05/2021,3,1,127,49,78,49,0,0
494,06/05/2021,3,1,138,40,98,49,0,0
334,09/05/2021,3,0,58,12,46,49,0,0
733,13/05/2021,3,0,100,19,81,49,0,0
558,06/05/2021,3,0,44,12,32,49,0,0
248,06/05/2021,3,0,82,49,33,52,0,0
181,11/05/2021,3,1,33,24,9,72,0,0
237,04/05/2021,3,5,116,17,99,49,0,0
760,09/05/2021,3,1,35,6,29,49,0,0
51,02/05/2021,3,2,78,13,65,49,0,0
862,02/05/2021,3,3,107,33,74,49,0,0
833,12/05/2021,3,0,83,51,32,52,0,0
182,05/05/2021,3,2,78,21,57,49,0,0
873,05/05/2021,3,3,98,47,51,49,0,0
90,10/05/2021,3,0,78,54,24,52,0,0
669,05/05/2021,3,0,87,29,58,49,0,0
731,10/05/2021,3,4,95,57,38,49,0,0
475,06/05/2021,3,1,98,52,46,49,0,0
659,05/05/2021,3,2,41,7,34,55,0,0
792,15/05/2021,3,0,102,26,76,49,0,0
512,09/05/2021,3,2,60,5,55,49,0,0
333,07/05/2021,3,1,56,28,28,85,0,0
439,13/05/2021,3,5,86,16,70,49,0,0
190,02/05/2021,3,7,73,9,64,49,0,0
198,01/05/2021,3,0,135,39,96,49,0,0
143,05/05/2021,3,3,117,52,65,49,0,0
407,04/05/2021,3,1,40,5,35,49,0,0
256,11/05/2021,3,0,109,38,71,49,0,0
835,02/05/2021,3,5,99,44,55,49,0,0
282,14/05/2021,3,27,674,39,635,49,0,0
772,02/05/2021,3,0,57,10,47,49,0,0
120,11/05/2021,3,0,154,92,62,64,0,0
400,01/05/2021,3,1,29,6,23,49,0,0
741,06/05/2021,3,1,69,19,50,49,0,0
466,09/05/2021,3,0,140,20,120,49,0,0
340,13/05/2021,3,17,117,12,105,49,0,0
558,07/05/2021,3,0,44,3,41,49,0,0
264,05/05/2021,3,1,59,28,31,55,0,0
724,11/05/2021,3,1,85,83,2,114,0,0
155,03/05/2021,3,0,93,15,78,49,0,0
422,10/05/2021,3,1,78,24,54,49,0,0
836,02/05/2021,3,6,95,47,48,49,0,0
12,02/05/2021,3,1,42,3,39,49,0,0
397,10/05/2021,3,0,75,36,39,55,0,0
784,06/05/2021,3,3,46,24,22,49,0,0
229,10/05/2021,3,1,55,38,17,80,0,0
368,03/05/2021,3,1,84,20,64,49,0,0
748,11/05/2021,3,4,140,60,80,49,0,0
594,04/05/2021,3,43,64,57,7,93,0,0
627,05/05/2021,3,0,41,12,29,59,0,0
448,15/05/2021,3,3,150,17,133,66,0,0
393,09/05/2021,3,1,59,11,48,49,0,0
846,08/05/2021,3,3,186,7,179,45,0,0
838,13/05/2021,3,3,62,38,24,49,0,0
593,02/05/2021,3,5,76,20,56,49,0,0
589,01/05/2021,3,4,139,18,121,49,0,0
220,05/05/2021,3,28,88,24,64,49,0,0
407,05/05/2021,3,1,40,10,30,49,0,0
386,11/05/2021,3,3,82,39,43,49,0,0
32,02/05/2021,3,1,104,19,85,49,0,0
347,14/05/2021,3,12,50,7,43,49,0,0
481,02/05/2021,3,0,56,6,50,49,0,0
767,11/05/2021,3,0,67,49,18,67,0,0
785,01/05/2021,3,3,107,14,93,49,0,0
179,05/05/2021,3,2,90,37,53,55,0,0
99,09/05/2021,3,1,166,27,139,49,0,0
499,13/05/2021,3,0,31,12,19,49,0,0
504,07/05/2021,3,1,82,3,79,49,0,0
891,11/05/2021,3,2,80,52,28,60,0,0
458,04/05/2021,3,0,181,65,116,49,0,0
92,11/05/2021,3,1,121,25,96,49,0,0
684,01/05/2021,3,3,95,10,85,49,0,0
739,01/05/2021,3,5,70,6,64,49,0,0
397,13/05/2021,3,0,75,42,33,55,0,0
446,06/05/2021,3,8,125,32,93,49,0,0
721,10/05/2021,3,29,111,49,62,63,0,0
560,03/05/2021,3,0,80,24,56,49,0,0
369,02/05/2021,3,5,85,6,79,49,0,0
193,05/05/2021,3,1,107,26,81,49,0,0
372,06/05/2021,3,2,90,49,41,52,0,0
444,14/05/2021,3,4,115,38,77,49,0,0
15,08/05/2021,3,0,31,7,24,49,0,0
712,07/05/2021,3,2,83,6,77,49,0,0
838,05/05/2021,3,5,60,39,21,64,0,0
817,03/05/2021,3,2,81,18,63,49,0,0
607,01/05/2021,3,2,73,17,56,49,0,0
84,04/05/2021,3,0,20,19,1,85,0,0
559,04/05/2021,3,43,142,65,77,49,0,0
339,13/05/2021,3,22,572,30,542,49,0,0
103,02/05/2021,3,1,160,80,80,49,0,0
592,14/05/2021,3,9,75,13,62,49,0,0
222,02/05/2021,3,0,77,10,67,49,0,0
392,09/05/2021,3,0,176,16,160,49,0,0
238,02/05/2021,3,1,65,20,45,49,0,0
358,06/05/2021,3,2,91,48,43,55,0,0
723,09/05/2021,3,1,80,21,59,49,0,0
501,13/05/2021,3,9,224,7,217,49,0,0
477,07/05/2021,3,3,117,8,109,49,0,0
329,10/05/2021,3,9,98,11,87,49,0,0
279,04/05/2021,3,0,57,23,34,49,0,0
754,09/05/2021,3,0,62,6,56,49,0,0
128,02/05/2021,3,1,20,5,15,49,0,0
739,02/05/2021,3,5,70,6,64,49,0,0
249,10/05/2021,3,2,125,95,30,52,0,0
182,06/05/2021,3,2,78,21,57,49,0,0
770,10/05/2021,3,4,31,21,10,52,0,0
437,04/05/2021,3,2,163,56,107,49,0,0
487,02/05/2021,3,0,39,2,37,49,0,0
262,06/05/2021,3,2,49,33,16,60,0,0
270,06/05/2021,3,1,59,27,32,59,0,0
608,15/05/2021,3,7,133,10,123,49,0,0
186,09/05/2021,3,1,57,18,39,49,0,0
712,08/05/2021,3,2,83,8,75,49,0,0
584,05/05/2021,3,1,96,34,62,55,0,0
778,03/05/2021,3,3,78,35,43,55,0,0
17,02/05/2021,3,1,93,10,83,49,0,0
180,04/05/2021,3,0,41,22,19,52,0,0
38,05/05/2021,3,4,46,29,17,52,0,0
327,11/05/2021,3,1,67,46,21,64,0,0
314,03/05/2021,3,1,68,28,40,49,0,0
867,14/05/2021,3,1,59,25,34,49,0,0
275,02/05/2021,3,6,111,34,77,49,0,0
480,11/05/2021,3,0,28,8,20,49,0,0
380,02/05/2021,3,2,158,19,139,49,0,0
621,05/05/2021,3,0,60,44,16,80,0,0
738,09/05/2021,3,1,123,17,106,49,0,0
501,15/05/2021,3,26,207,8,199,49,0,0
613,07/05/2021,3,0,56,9,47,49,0,0
550,11/05/2021,3,6,106,23,83,49,0,0
458,03/05/2021,3,0,181,41,140,49,0,0
760,03/05/2021,3,3,33,2,31,49,0,0
266,02/05/2021,3,0,61,15,46,49,0,0
816,01/05/2021,3,2,80,63,17,57,0,0
853,13/05/2021,3,3,99,52,47,55,0,0
416,06/05/2021,3,0,34,5,29,49,0,0
794,09/05/2021,3,0,137,26,111,55,0,0
437,05/05/2021,3,2,163,64,99,49,0,0
233,02/05/2021,3,4,63,5,58,49,0,0
451,06/05/2021,3,2,81,40,41,66,0,0
197,07/05/2021,3,0,118,29,89,49,0,0
507,14/05/2021,3,3,197,11,186,49,0,0
683,10/05/2021,3,1,65,29,36,49,0,0
907,09/05/2021,3,3,77,11,66,49,0,0
647,05/05/2021,3,7,86,37,49,49,0,0
526,03/05/2021,3,0,38,4,34,55,0,0
147,02/05/2021,3,1,79,9,70,49,0,0
699,04/05/2021,3,0,62,36,26,64,0,0
107,05/05/2021,3,2,87,57,30,72,0,0
486,11/05/2021,3,0,124,20,104,49,0,0
389,03/05/2021,3,2,124,21,103,49,0,0
20,15/05/2021,3,1,81,19,62,49,0,0
310,02/05/2021,3,1,71,9,62,49,0,0
33,02/05/2021,3,5,75,53,22,57,0,0
696,01/05/2021,3,1,88,8,80,49,0,0
741,05/05/2021,3,1,69,26,43,49,0,0
738,10/05/2021,3,1,123,42,81,55,0,0
610,15/05/2021,3,1,66,16,50,49,0,0
537,07/05/2021,3,3,99,83,16,63,0,0
313,11/05/2021,3,0,31,27,4,77,0,0
464,03/05/2021,3,2,264,23,241,66,0,0
875,02/05/2021,3,4,88,20,68,49,0,0
433,02/05/2021,3,1,317,46,271,66,0,0
312,11/05/2021,3,2,95,39,56,55,0,0
666,06/05/2021,3,3,63,24,39,49,0,0
27,10/05/2021,3,0,78,62,16,72,0,0
57,05/05/2021,3,1,139,40,99,49,0,0
731,02/05/2021,3,7,92,9,83,49,0,0
519,06/05/2021,3,0,64,26,38,55,0,0
627,07/05/2021,3,0,41,8,33,49,0,0
608,14/05/2021,3,7,133,11,122,49,0,0
251,10/05/2021,3,0,124,55,69,49,0,0
500,09/05/2021,3,5,74,20,54,49,0,0
728,05/05/2021,3,1,46,26,20,49,0,0
365,04/05/2021,3,0,68,44,24,59,0,0
413,02/05/2021,3,2,114,10,104,49,0,0
84,05/05/2021,3,0,20,15,5,74,0,0
530,05/05/2021,3,1,59,30,29,55,0,0
818,11/05/2021,3,1,80,79,1,147,0,0
176,03/05/2021,3,4,96,13,83,49,0,0
335,15/05/2021,3,4,82,5,77,49,0,0
52,03/05/2021,3,10,132,29,103,49,0,0
250,03/05/2021,3,1,114,49,65,59,0,0
187,02/05/2021,3,1,40,21,19,49,0,0
445,06/05/2021,3,1,168,52,116,49,0,0
101,11/05/2021,3,1,59,32,27,52,0,0
355,14/05/2021,3,3,96,19,77,49,0,0
883,07/05/2021,3,6,98,13,85,45,0,0
856,11/05/2021,3,0,120,7,113,49,0,0
139,03/05/2021,3,2,57,2,55,49,0,0
266,01/05/2021,3,0,61,24,37,49,0,0
209,02/05/2021,3,1,113,59,54,55,0,0
397,11/05/2021,3,0,75,47,28,55,0,0
450,05/05/2021,3,12,172,62,110,49,0,0
794,10/05/2021,3,0,137,42,95,55,0,0
806,03/05/2021,3,5,131,25,106,55,0,0
748,02/05/2021,3,6,138,13,125,49,0,0
755,06/05/2021,3,0,87,59,28,64,0,0
35,07/05/2021,3,0,110,15,95,49,0,0
133,15/05/2021,3,2,62,19,43,49,0,0
251,09/05/2021,3,0,124,18,106,49,0,0
500,07/05/2021,3,5,74,9,65,49,0,0
574,06/05/2021,3,1,86,15,71,49,0,0
526,04/05/2021,3,0,38,17,21,55,0,0
589,02/05/2021,3,4,139,12,127,49,0,0
285,05/05/2021,3,0,80,37,43,55,0,0
290,04/05/2021,3,6,101,45,56,60,0,0
327,12/05/2021,3,1,67,48,19,64,0,0
277,03/05/2021,3,4,68,9,59,49,0,0
347,15/05/2021,3,3,59,16,43,49,0,0
452,02/05/2021,3,7,53,17,36,55,0,0
232,03/05/2021,3,1,64,30,34,55,0,0
189,02/05/2021,3,1,164,25,139,49,0,0
201,07/05/2021,3,3,135,11,124,49,0,0
723,11/05/2021,3,2,79,47,32,67,0,0
697,14/05/2021,3,1,108,32,76,49,0,0
69,07/05/2021,3,1,59,8,51,49,0,0
724,10/05/2021,3,2,84,84,0,NA,NA,NA
782,03/05/2021,3,0,20,12,8,64,0,0
600,01/05/2021,3,1,49,11,38,49,0,0
142,01/05/2021,3,1,61,15,46,49,0,0
446,05/05/2021,3,8,125,38,87,49,0,0
567,10/05/2021,3,0,61,34,27,60,0,0
915,03/05/2021,3,6,183,18,165,35,0,0
233,03/05/2021,3,3,64,4,60,49,0,0
917,06/05/2021,3,3,103,2,101,35,0,0
35,05/05/2021,3,1,109,25,84,49,0,0
353,15/05/2021,3,1,51,17,34,49,0,0
512,10/05/2021,3,2,60,29,31,49,0,0
114,07/05/2021,3,0,75,26,49,49,0,0
832,06/05/2021,3,1,99,21,78,49,0,0
778,02/05/2021,3,2,79,50,29,49,0,0
17,03/05/2021,3,1,93,14,79,49,0,0
699,05/05/2021,3,0,62,29,33,59,0,0
559,05/05/2021,3,43,142,72,70,49,0,0
2,12/05/2021,3,2,57,51,6,93,0,0
505,03/05/2021,3,0,84,16,68,49,0,0
676,15/05/2021,3,3,112,59,53,49,0,0
275,03/05/2021,3,6,111,22,89,55,0,0
854,03/05/2021,3,11,99,4,95,55,0,0
696,02/05/2021,3,1,88,8,80,49,0,0
494,04/05/2021,3,1,138,43,95,49,0,0
485,11/05/2021,3,0,65,30,35,55,0,0
80,15/05/2021,3,1,124,15,109,49,0,0
889,07/05/2021,3,1,123,11,112,45,0,0
98,11/05/2021,3,1,94,94,0,NA,NA,NA
754,01/05/2021,3,0,62,6,56,49,0,0
163,02/05/2021,3,1,61,15,46,49,0,0
173,01/05/2021,3,1,70,11,59,49,0,0
450,06/05/2021,3,12,172,57,115,49,0,0
168,10/05/2021,3,0,48,25,23,64,0,0
67,05/05/2021,3,1,51,26,25,59,0,0
216,02/05/2021,3,1,57,2,55,49,0,0
594,06/05/2021,3,43,64,37,27,64,0,0
35,06/05/2021,3,1,109,25,84,49,0,0
677,15/05/2021,3,1,39,3,36,49,0,0
825,08/05/2021,3,1,145,19,126,49,0,0
79,07/05/2021,3,2,44,19,25,52,0,0
362,06/05/2021,3,4,116,84,32,72,0,0
342,03/05/2021,3,0,114,21,93,49,0,0
42,03/05/2021,3,2,97,17,80,49,0,0
886,04/05/2021,3,0,152,56,96,49,0,0
679,04/05/2021,3,2,87,50,37,59,0,0
96,12/05/2021,3,14,55,40,15,62,0,0
831,02/05/2021,3,1,149,11,138,49,0,0
789,08/05/2021,3,0,72,14,58,49,0,0
310,03/05/2021,3,1,71,18,53,55,0,0
120,02/05/2021,3,2,152,26,126,49,0,0
895,02/05/2021,3,0,69,12,57,49,0,0
179,03/05/2021,3,2,90,12,78,55,0,0
803,02/05/2021,3,1,68,10,58,49,0,0
188,15/05/2021,3,7,114,73,41,49,0,0
406,06/05/2021,3,1,38,22,16,60,0,0
911,10/05/2021,3,0,158,3,155,49,0,0
422,02/05/2021,3,1,78,23,55,49,0,0
138,02/05/2021,3,0,98,35,63,49,0,0
394,01/05/2021,3,3,65,8,57,49,0,0
491,06/05/2021,3,6,173,36,137,49,0,0
746,10/05/2021,3,3,57,33,24,55,0,0
226,03/05/2021,3,0,47,5,42,55,0,0
624,02/05/2021,3,1,78,18,60,49,0,0
183,06/05/2021,3,1,79,30,49,59,0,0
665,07/05/2021,3,2,104,23,81,49,0,0
677,09/05/2021,3,0,40,6,34,49,0,0
247,09/05/2021,3,3,90,41,49,49,0,0
783,07/05/2021,3,1,79,67,12,57,0,0
838,06/05/2021,3,5,60,45,15,52,0,0
342,04/05/2021,3,0,114,43,71,49,0,0
147,03/05/2021,3,1,79,15,64,49,0,0
886,05/05/2021,3,0,152,56,96,49,0,0
476,04/05/2021,3,0,173,14,159,49,0,0
53,12/05/2021,3,0,70,40,30,72,0,0
257,02/05/2021,3,1,43,21,22,49,0,0
130,08/05/2021,3,3,78,7,71,49,0,0
772,03/05/2021,3,1,56,12,44,55,0,0
860,02/05/2021,3,10,82,12,70,49,0,0
570,02/05/2021,3,0,149,16,133,49,0,0
156,04/05/2021,3,2,146,90,56,60,0,0
88,03/05/2021,3,1,41,4,37,55,0,0
870,15/05/2021,3,4,42,21,21,49,0,0
586,06/05/2021,3,3,80,44,36,59,0,0
181,10/05/2021,3,1,33,20,13,60,0,0
622,02/05/2021,3,1,43,36,7,71,0,0
321,02/05/2021,3,1,39,8,31,49,0,0
862,01/05/2021,3,1,109,39,70,49,0,0
882,05/05/2021,3,0,130,51,79,39,0,0
713,09/05/2021,3,1,60,46,14,79,0,0
525,05/05/2021,3,4,71,49,22,57,0,0
86,03/05/2021,3,1,47,7,40,49,0,0
262,05/05/2021,3,2,49,26,23,55,0,0
919,07/05/2021,3,0,123,3,120,49,0,0
792,10/05/2021,3,0,102,21,81,49,0,0
399,15/05/2021,3,1,60,17,43,49,0,0
465,08/05/2021,3,4,263,66,197,55,0,0
584,06/05/2021,3,1,96,26,70,55,0,0
151,04/05/2021,3,6,70,41,29,60,0,0
287,03/05/2021,3,3,120,28,92,49,0,0
285,04/05/2021,3,0,80,42,38,55,0,0
38,04/05/2021,3,4,46,21,25,49,0,0
256,12/05/2021,3,0,109,89,20,62,0,0
121,02/05/2021,3,0,110,54,56,49,0,0
207,08/05/2021,3,3,60,15,45,49,0,0
426,04/05/2021,3,13,150,64,86,55,0,0
232,02/05/2021,3,1,64,38,26,49,0,0
895,01/05/2021,3,0,69,7,62,49,0,0
358,03/05/2021,3,1,92,18,74,55,0,0
520,03/05/2021,3,0,58,9,49,49,0,0
29,02/05/2021,3,0,54,0,54,NA,NA,NA
702,09/05/2021,3,1,49,15,34,49,0,0
313,10/05/2021,3,0,31,20,11,57,0,0
202,03/05/2021,3,0,76,20,56,59,0,0
252,02/05/2021,3,0,264,26,238,49,0,0
816,03/05/2021,3,3,79,22,57,59,0,0
267,06/05/2021,3,2,81,64,17,57,0,0
561,09/05/2021,3,1,59,10,49,49,0,0
4,05/05/2021,3,2,62,39,23,72,0,0
624,03/05/2021,3,1,78,10,68,49,0,0
865,05/05/2021,3,2,83,13,70,49,0,0
307,10/05/2021,3,1,78,23,55,49,0,0
46,09/05/2021,3,1,59,5,54,49,0,0
247,16/05/2021,3,2,91,31,60,49,0,0
43,07/05/2021,3,1,72,16,56,49,0,0
352,05/05/2021,3,2,62,39,23,60,0,0
365,02/05/2021,3,0,68,18,50,55,0,0
413,03/05/2021,3,2,114,19,95,49,0,0
805,05/05/2021,3,0,113,48,65,55,0,0
821,04/05/2021,3,2,77,56,21,67,0,0
490,13/05/2021,3,4,161,12,149,49,0,0
103,05/05/2021,3,2,159,51,108,55,0,0
224,08/05/2021,3,1,56,15,41,49,0,0
326,03/05/2021,3,4,77,13,64,55,0,0
120,06/05/2021,3,2,152,65,87,49,0,0
777,04/05/2021,3,4,116,63,53,49,0,0
201,03/05/2021,3,7,131,10,121,49,0,0
19,02/05/2021,3,2,92,13,79,49,0,0
29,05/05/2021,3,0,54,0,54,NA,NA,NA
586,08/05/2021,3,4,79,72,7,59,0,0
814,10/05/2021,3,2,66,31,35,55,0,0
518,01/05/2021,3,1,16,15,1,49,0,0
138,01/05/2021,3,0,98,48,50,49,0,0
433,04/05/2021,3,2,316,77,239,66,0,0
522,11/05/2021,3,1,61,31,30,49,0,0
673,09/05/2021,3,1,122,9,113,49,0,0
657,08/05/2021,3,0,48,12,36,49,0,0
634,02/05/2021,3,1,19,12,7,63,0,0
848,06/05/2021,3,9,129,11,118,35,0,0
665,08/05/2021,3,1,105,25,80,49,0,0
119,09/05/2021,3,3,65,6,59,49,0,0
474,16/05/2021,3,0,112,11,101,49,0,0
311,07/05/2021,3,0,97,26,71,49,0,0
686,10/05/2021,3,0,46,10,36,49,0,0
778,08/05/2021,3,2,79,49,30,49,0,0
589,03/05/2021,3,4,139,17,122,49,0,0
626,08/05/2021,3,1,101,36,65,49,0,0
679,05/05/2021,3,2,87,65,22,80,0,0
441,12/05/2021,3,0,168,15,153,55,0,0
103,06/05/2021,3,2,159,48,111,55,0,0
254,09/05/2021,3,1,77,9,68,49,0,0
275,06/05/2021,3,7,110,39,71,55,0,0
429,06/05/2021,3,3,122,27,95,49,0,0
380,03/05/2021,3,2,158,15,143,49,0,0
445,03/05/2021,3,1,168,26,142,49,0,0
19,03/05/2021,3,2,92,8,84,49,0,0
29,04/05/2021,3,0,54,0,54,NA,NA,NA
586,09/05/2021,3,4,79,54,25,59,0,0
301,10/05/2021,3,1,100,28,72,49,0,0
518,02/05/2021,3,1,16,7,9,49,0,0
163,01/05/2021,3,1,61,29,32,49,0,0
816,04/05/2021,3,3,79,59,20,64,0,0
401,10/05/2021,3,0,79,33,46,55,0,0
746,17/05/2021,3,2,58,42,16,60,0,0
4,07/05/2021,3,2,62,62,0,NA,NA,NA
634,03/05/2021,3,1,19,11,8,59,0,0
193,04/05/2021,3,1,107,37,70,49,0,0
554,10/05/2021,3,2,40,14,26,49,0,0
652,09/05/2021,3,0,69,9,60,49,0,0
192,14/05/2021,3,0,86,8,78,49,0,0
293,07/05/2021,3,0,60,30,30,49,0,0
484,11/05/2021,3,0,40,24,16,55,0,0
271,07/05/2021,3,0,70,13,57,49,0,0
776,03/05/2021,3,0,104,16,88,49,0,0
626,09/05/2021,3,1,101,28,73,49,0,0
357,04/05/2021,3,2,81,41,40,55,0,0
441,13/05/2021,3,0,168,11,157,55,0,0
835,06/05/2021,3,5,99,61,38,55,0,0
789,09/05/2021,3,0,72,14,58,49,0,0
310,06/05/2021,3,1,71,42,29,55,0,0
33,06/05/2021,3,8,72,30,42,49,0,0
238,03/05/2021,3,1,65,21,44,49,0,0
156,03/05/2021,3,3,145,42,103,49,0,0
460,03/05/2021,3,18,91,12,79,49,0,0
29,03/05/2021,3,0,54,0,54,NA,NA,NA
889,09/05/2021,3,1,123,10,113,45,0,0
459,10/05/2021,3,3,89,33,56,49,0,0
202,01/05/2021,3,0,76,53,23,49,0,0
417,01/05/2021,3,0,103,38,65,49,0,0
739,04/05/2021,3,4,71,26,45,52,0,0
401,11/05/2021,3,0,79,47,32,55,0,0
811,17/05/2021,3,3,87,35,52,52,0,0
226,01/05/2021,3,0,47,16,31,49,0,0
369,03/05/2021,3,5,85,15,70,55,0,0
183,05/05/2021,3,1,79,34,45,64,0,0
376,01/05/2021,3,1,63,52,11,57,0,0
133,09/05/2021,3,2,62,16,46,49,0,0
399,14/05/2021,3,1,60,21,39,49,0,0
797,07/05/2021,3,1,66,19,47,49,0,0
484,10/05/2021,3,0,40,16,24,55,0,0
184,08/05/2021,3,0,51,24,27,49,0,0
42,01/05/2021,3,2,97,29,68,49,0,0
857,09/05/2021,3,2,208,20,188,49,0,0
476,05/05/2021,3,0,173,16,157,49,0,0
203,11/05/2021,3,0,40,6,34,49,0,0
837,06/05/2021,3,6,320,21,299,66,0,0
779,08/05/2021,3,0,104,11,93,49,0,0
227,05/05/2021,3,3,41,8,33,49,0,0
860,06/05/2021,3,5,87,17,70,49,0,0
400,03/05/2021,3,1,29,6,23,49,0,0
653,03/05/2021,3,2,113,16,97,49,0,0
868,03/05/2021,3,4,79,9,70,49,0,0
549,02/05/2021,3,0,61,0,61,NA,NA,NA
504,08/05/2021,3,1,82,7,75,49,0,0
301,11/05/2021,3,1,100,34,66,49,0,0
642,01/05/2021,3,6,89,11,78,49,0,0
836,01/05/2021,3,7,94,61,33,49,0,0
142,03/05/2021,3,1,61,42,19,59,0,0
267,10/05/2021,3,2,81,64,17,52,0,0
456,17/05/2021,3,4,86,50,36,49,0,0
498,01/05/2021,3,0,87,12,75,49,0,0
511,03/05/2021,3,0,76,20,56,55,0,0
475,05/05/2021,3,1,98,53,45,67,0,0
372,01/05/2021,3,3,89,60,29,52,0,0
652,10/05/2021,3,0,69,57,12,80,0,0
683,14/05/2021,3,1,65,11,54,49,0,0
356,08/05/2021,3,2,134,30,104,49,0,0
714,09/05/2021,3,0,59,13,46,49,0,0
778,06/05/2021,3,1,80,59,21,67,0,0
287,01/05/2021,3,3,120,47,73,49,0,0
886,08/05/2021,3,5,147,43,104,49,0,0
757,12/05/2021,3,0,117,111,6,82,0,0
121,04/05/2021,3,1,109,81,28,67,0,0
515,09/05/2021,3,6,106,30,76,49,0,0
481,06/05/2021,3,0,56,32,24,49,0,0
429,05/05/2021,3,1,124,26,98,49,0,0
895,03/05/2021,3,0,69,6,63,49,0,0
828,03/05/2021,3,4,71,11,60,49,0,0
88,02/05/2021,3,1,41,3,38,49,0,0
549,05/05/2021,3,0,61,0,61,NA,NA,NA
175,09/05/2021,3,1,119,6,113,49,0,0
808,10/05/2021,3,12,156,97,59,55,0,0
754,03/05/2021,3,0,62,10,52,49,0,0
417,02/05/2021,3,0,103,14,89,49,0,0
173,03/05/2021,3,1,70,15,55,55,0,0
790,10/05/2021,3,1,98,45,53,66,0,0
587,17/05/2021,3,2,79,43,36,49,0,0
669,02/05/2021,3,0,87,4,83,49,0,0
841,03/05/2021,3,0,182,33,149,55,0,0
755,04/05/2021,3,0,87,54,33,72,0,0
197,01/05/2021,3,0,118,17,101,49,0,0
46,10/05/2021,3,3,57,50,7,83,0,0
350,15/05/2021,3,5,55,22,33,49,0,0
293,09/05/2021,3,1,59,21,38,49,0,0
728,09/05/2021,3,0,47,10,37,49,0,0
243,08/05/2021,3,1,126,96,30,60,0,0
42,02/05/2021,3,2,97,13,84,49,0,0
886,09/05/2021,3,4,148,53,95,49,0,0
830,17/05/2021,3,0,66,56,10,62,0,0
314,04/05/2021,3,1,68,33,35,60,0,0
869,08/05/2021,3,1,59,56,3,117,0,0
742,05/05/2021,3,1,73,27,46,55,0,0
588,06/05/2021,3,1,58,31,27,49,0,0
777,01/05/2021,3,4,116,23,93,49,0,0
741,04/05/2021,3,1,69,27,42,49,0,0
723,03/05/2021,3,1,80,19,61,49,0,0
549,04/05/2021,3,0,61,0,61,NA,NA,NA
477,08/05/2021,3,4,116,7,109,49,0,0
716,10/05/2021,3,0,104,66,38,60,0,0
422,01/05/2021,3,1,78,40,38,49,0,0
600,02/05/2021,3,1,49,9,40,49,0,0
527,03/05/2021,3,8,53,14,39,55,0,0
790,11/05/2021,3,1,98,44,54,66,0,0
159,17/05/2021,3,0,77,60,17,49,0,0
211,02/05/2021,3,4,56,22,34,49,0,0
841,02/05/2021,3,0,182,9,173,55,0,0
228,07/05/2021,3,3,39,9,30,49,0,0
659,01/05/2021,3,2,41,24,17,49,0,0
448,10/05/2021,3,3,150,43,107,66,0,0
683,15/05/2021,3,1,65,23,42,49,0,0
356,09/05/2021,3,2,134,40,94,49,0,0
714,11/05/2021,3,0,59,27,32,59,0,0
131,06/05/2021,3,2,47,10,37,49,0,0
776,02/05/2021,3,0,104,12,92,49,0,0
206,09/05/2021,3,17,196,50,146,55,0,0
256,17/05/2021,3,2,107,50,57,49,0,0
837,04/05/2021,3,5,321,38,283,66,0,0
869,09/05/2021,3,1,59,47,12,72,0,0
612,05/05/2021,3,2,40,14,26,49,0,0
274,04/05/2021,3,0,210,78,132,39,0,0
189,01/05/2021,3,0,165,29,136,49,0,0
343,04/05/2021,3,1,61,38,23,60,0,0
334,03/05/2021,3,0,58,9,49,49,0,0
549,03/05/2021,3,0,61,0,61,NA,NA,NA
477,09/05/2021,3,4,116,6,110,49,0,0
844,10/05/2021,3,0,61,7,54,55,0,0
813,01/05/2021,3,1,129,16,113,49,0,0
213,02/05/2021,3,4,144,111,33,57,0,0
529,03/05/2021,3,4,37,4,33,55,0,0
239,10/05/2021,3,0,40,36,4,80,0,0
673,17/05/2021,3,0,123,41,82,49,0,0
368,02/05/2021,3,1,84,12,72,49,0,0
263,02/05/2021,3,0,66,13,53,49,0,0
917,07/05/2021,3,2,104,1,103,35,0,0
270,01/05/2021,3,1,59,24,35,49,0,0
448,09/05/2021,3,3,150,14,136,66,0,0
350,16/05/2021,3,2,58,11,47,49,0,0
360,09/05/2021,3,1,43,5,38,49,0,0
686,11/05/2021,3,0,46,17,29,49,0,0
243,06/05/2021,3,1,126,34,92,49,0,0
413,01/05/2021,3,2,114,19,95,49,0,0
76,08/05/2021,3,2,91,13,78,49,0,0
339,17/05/2021,3,17,577,57,520,49,0,0
709,05/05/2021,3,1,82,20,62,55,0,0
335,08/05/2021,3,4,82,8,74,49,0,0
326,06/05/2021,3,4,77,36,41,55,0,0
250,04/05/2021,3,0,115,79,36,64,0,0
238,01/05/2021,3,1,65,34,31,49,0,0
358,04/05/2021,3,1,92,50,42,60,0,0
334,02/05/2021,3,0,58,11,47,49,0,0
80,02/05/2021,3,1,124,13,111,49,0,0
795,09/05/2021,3,8,97,29,68,49,0,0
319,10/05/2021,3,8,106,68,38,49,0,0
92,03/05/2021,3,1,121,10,111,49,0,0
209,03/05/2021,3,1,113,39,74,55,0,0
522,10/05/2021,3,1,61,27,34,52,0,0
736,17/05/2021,3,1,104,43,61,49,0,0
4,02/05/2021,3,2,62,61,1,63,0,0
216,03/05/2021,3,1,57,4,53,49,0,0
617,07/05/2021,3,1,43,2,41,49,0,0
674,01/05/2021,3,1,97,11,86,49,0,0
25,09/05/2021,3,2,50,15,35,49,0,0
597,16/05/2021,3,4,97,21,76,49,0,0
465,09/05/2021,3,22,245,46,199,49,0,0
136,11/05/2021,3,0,128,42,86,49,0,0
817,07/05/2021,3,1,82,15,67,49,0,0
607,02/05/2021,3,2,73,10,63,49,0,0
220,08/05/2021,3,5,98,25,73,49,0,0
490,17/05/2021,3,6,159,11,148,49,0,0
837,05/05/2021,3,6,320,50,270,66,0,0
781,08/05/2021,3,2,81,44,37,49,0,0
275,05/05/2021,3,6,111,37,74,55,0,0
177,06/05/2021,3,0,48,14,34,55,0,0
276,01/05/2021,3,1,203,20,183,49,0,0
445,04/05/2021,3,1,168,57,111,49,0,0
466,02/05/2021,3,0,140,11,129,49,0,0
499,02/05/2021,3,0,31,6,25,49,0,0
613,08/05/2021,3,0,56,11,45,49,0,0
698,10/05/2021,3,2,114,32,82,49,0,0
3,01/05/2021,3,4,109,46,63,49,0,0
496,03/05/2021,3,1,59,12,47,49,0,0
267,11/05/2021,3,3,80,56,24,52,0,0
229,17/05/2021,3,4,52,44,8,80,0,0
4,01/05/2021,3,2,62,62,0,NA,NA,NA
685,03/05/2021,3,3,137,36,101,49,0,0
183,07/05/2021,3,2,78,24,54,49,0,0
35,01/05/2021,3,0,110,12,98,49,0,0
145,09/05/2021,3,3,55,8,47,49,0,0
186,14/05/2021,3,1,57,32,25,49,0,0
465,07/05/2021,3,4,263,39,224,55,0,0
506,11/05/2021,3,0,195,11,184,49,0,0
593,08/05/2021,3,3,78,45,33,49,0,0
648,02/05/2021,3,1,63,30,33,49,0,0
805,08/05/2021,3,2,111,31,80,49,0,0
643,17/05/2021,3,1,102,52,50,49,0,0
32,04/05/2021,3,1,104,102,2,90,0,0
65,09/05/2021,3,1,77,3,74,49,0,0
772,05/05/2021,3,0,57,27,30,60,0,0
854,05/05/2021,3,0,110,29,81,55,0,0
380,01/05/2021,3,2,158,36,122,49,0,0
741,03/05/2021,3,1,69,9,60,49,0,0
485,03/05/2021,3,0,65,5,60,49,0,0
188,03/05/2021,3,5,116,14,102,49,0,0
558,09/05/2021,3,0,44,3,41,49,0,0
508,10/05/2021,3,22,58,36,22,49,0,0
92,01/05/2021,3,0,122,23,99,49,0,0
527,04/05/2021,3,8,53,39,14,55,0,0
182,02/05/2021,3,2,78,3,75,49,0,0
587,18/05/2021,3,2,79,51,28,60,0,0
211,01/05/2021,3,4,56,35,21,52,0,0
703,03/05/2021,3,1,90,25,65,49,0,0
451,07/05/2021,3,2,81,24,57,66,0,0
554,01/05/2021,3,1,41,10,31,49,0,0
231,09/05/2021,3,0,41,13,28,49,0,0
162,15/05/2021,3,0,122,29,93,49,0,0
114,09/05/2021,3,0,75,23,52,49,0,0
404,11/05/2021,3,0,67,45,22,64,0,0
365,08/05/2021,3,0,68,16,52,55,0,0
864,03/05/2021,3,2,83,28,55,49,0,0
143,09/05/2021,3,2,118,14,104,49,0,0
667,09/05/2021,3,0,10,0,10,NA,NA,NA
709,06/05/2021,3,0,83,31,52,55,0,0
335,09/05/2021,3,4,82,7,75,49,0,0
227,06/05/2021,3,3,41,6,35,49,0,0
392,06/05/2021,3,0,176,34,142,49,0,0
28,02/05/2021,3,1,127,16,111,49,0,0
494,03/05/2021,3,1,138,14,124,49,0,0
868,02/05/2021,3,4,79,13,66,49,0,0
656,03/05/2021,3,1,114,6,108,49,0,0
378,08/05/2021,3,0,84,14,70,49,0,0
891,10/05/2021,3,2,80,51,29,49,0,0
139,01/05/2021,3,2,57,25,32,49,0,0
496,04/05/2021,3,1,59,20,39,49,0,0
416,04/05/2021,3,0,34,5,29,49,0,0
27,17/05/2021,3,0,78,68,10,80,0,0
915,01/05/2021,3,2,187,7,180,35,0,0
731,03/05/2021,3,7,92,15,77,49,0,0
594,07/05/2021,3,43,64,40,24,49,0,0
665,01/05/2021,3,1,105,21,84,49,0,0
442,09/05/2021,3,1,157,19,138,49,0,0
192,15/05/2021,3,0,86,15,71,49,0,0
217,08/05/2021,3,1,40,31,9,57,0,0
404,10/05/2021,3,0,67,41,26,59,0,0
271,05/05/2021,3,0,70,40,30,60,0,0
198,03/05/2021,3,0,135,18,117,55,0,0
385,09/05/2021,3,1,62,14,48,49,0,0
667,10/05/2021,3,0,10,0,10,NA,NA,NA
277,04/05/2021,3,4,68,30,38,62,0,0
347,09/05/2021,3,12,50,9,41,49,0,0
612,06/05/2021,3,2,40,9,31,49,0,0
767,06/05/2021,3,0,67,30,37,49,0,0
276,02/05/2021,3,1,203,20,183,49,0,0
828,04/05/2021,3,4,71,19,52,49,0,0
101,03/05/2021,3,1,59,11,48,49,0,0
80,04/05/2021,3,1,124,37,87,49,0,0
858,08/05/2021,3,1,80,40,40,49,0,0
808,11/05/2021,3,11,157,101,56,55,0,0
3,02/05/2021,3,5,108,35,73,49,0,0
209,04/05/2021,3,1,113,68,45,55,0,0
281,03/05/2021,3,2,81,59,22,52,0,0
164,18/05/2021,3,0,62,44,18,52,0,0
915,02/05/2021,3,2,187,8,179,35,0,0
511,02/05/2021,3,0,76,14,62,49,0,0
519,07/05/2021,3,0,64,27,37,49,0,0
919,01/05/2021,3,1,122,20,102,49,0,0
507,09/05/2021,3,3,197,10,187,49,0,0
399,16/05/2021,3,1,60,21,39,49,0,0
311,09/05/2021,3,0,97,21,76,49,0,0
714,10/05/2021,3,0,59,26,33,55,0,0
365,05/05/2021,3,0,68,45,23,72,0,0
864,04/05/2021,3,1,84,48,36,67,0,0
294,08/05/2021,3,0,117,16,101,49,0,0
818,10/05/2021,3,1,80,80,0,NA,NA,NA
434,04/05/2021,3,3,57,19,38,49,0,0
396,09/05/2021,3,1,29,10,19,49,0,0
127,06/05/2021,3,1,59,21,38,55,0,0
274,05/05/2021,3,0,210,77,133,39,0,0
423,02/05/2021,3,1,49,29,20,62,0,0
621,04/05/2021,3,0,60,51,9,80,0,0
815,03/05/2021,3,12,117,15,102,49,0,0
859,05/05/2021,3,2,83,11,72,49,0,0
795,08/05/2021,3,9,96,43,53,49,0,0
508,11/05/2021,3,22,58,40,18,52,0,0
72,03/05/2021,3,3,57,25,32,49,0,0
739,05/05/2021,3,2,73,32,41,49,0,0
784,02/05/2021,3,4,45,12,33,49,0,0
149,18/05/2021,3,0,88,70,18,67,0,0
657,01/05/2021,3,0,48,41,7,57,0,0
583,02/05/2021,3,1,80,34,46,49,0,0
262,07/05/2021,3,2,49,31,18,49,0,0
307,01/05/2021,3,1,78,16,62,49,0,0
581,09/05/2021,3,160,65,22,43,49,0,0
683,16/05/2021,3,1,65,10,55,49,0,0
907,07/05/2021,3,3,77,18,59,49,0,0
352,10/05/2021,3,1,63,28,35,55,0,0
689,05/05/2021,3,0,130,37,93,49,0,0
17,05/05/2021,3,1,93,65,28,52,0,0
84,09/05/2021,3,0,20,6,14,49,0,0
158,09/05/2021,3,1,23,12,11,52,0,0
434,05/05/2021,3,3,57,27,30,49,0,0
779,09/05/2021,3,0,104,18,86,49,0,0
772,06/05/2021,3,0,57,25,32,55,0,0
623,04/05/2021,3,0,78,19,59,49,0,0
189,07/05/2021,3,0,165,43,122,49,0,0
653,04/05/2021,3,2,113,34,79,49,0,0
738,02/05/2021,3,1,123,16,107,49,0,0
610,04/05/2021,3,1,66,43,23,67,0,0
93,09/05/2021,3,3,138,21,117,49,0,0
98,10/05/2021,3,1,94,93,1,93,0,0
642,03/05/2021,3,6,89,22,67,49,0,0
862,07/05/2021,3,2,108,32,76,49,0,0
790,04/05/2021,3,1,98,41,57,66,0,0
456,18/05/2021,3,3,87,48,39,49,0,0
57,01/05/2021,3,1,139,29,110,49,0,0
685,02/05/2021,3,3,137,33,104,49,0,0
475,07/05/2021,3,1,98,31,67,49,0,0
639,01/05/2021,3,2,57,8,49,49,0,0
792,09/05/2021,3,0,102,3,99,49,0,0
512,15/05/2021,3,2,60,8,52,49,0,0
783,09/05/2021,3,1,79,13,66,49,0,0
431,10/05/2021,3,2,128,50,78,59,0,0
365,06/05/2021,3,0,68,31,37,59,0,0
864,05/05/2021,3,1,84,38,46,60,0,0
294,09/05/2021,3,0,117,8,109,49,0,0
531,09/05/2021,3,2,57,10,47,49,0,0
389,06/05/2021,3,2,124,35,89,49,0,0
207,09/05/2021,3,2,61,11,50,49,0,0
452,01/05/2021,3,6,54,22,32,55,0,0
108,06/05/2021,3,0,78,19,59,49,0,0
696,07/05/2021,3,1,88,15,73,49,0,0
343,03/05/2021,3,3,59,17,42,49,0,0
485,02/05/2021,3,0,65,5,60,49,0,0
870,05/05/2021,3,7,39,38,1,55,0,0
378,09/05/2021,3,0,84,11,73,49,0,0
716,11/05/2021,3,0,104,68,36,67,0,0
518,03/05/2021,3,1,16,5,11,49,0,0
862,05/05/2021,3,2,108,41,67,49,0,0
707,04/05/2021,3,1,39,33,6,82,0,0
811,18/05/2021,3,3,87,47,40,55,0,0
806,01/05/2021,3,2,134,37,97,49,0,0
583,03/05/2021,3,2,79,35,44,49,0,0
183,08/05/2021,3,3,77,21,56,49,0,0
627,01/05/2021,3,0,41,10,31,49,0,0
608,09/05/2021,3,13,127,15,112,49,0,0
56,16/05/2021,3,4,61,22,39,49,0,0
637,09/05/2021,3,2,72,14,58,49,0,0
584,10/05/2021,3,1,96,47,49,55,0,0
184,03/05/2021,3,0,51,8,43,59,0,0
607,05/05/2021,3,3,72,24,48,55,0,0
180,01/05/2021,3,0,41,3,38,49,0,0
732,09/05/2021,3,0,60,7,53,49,0,0
176,04/05/2021,3,4,96,25,71,49,0,0
676,08/05/2021,3,4,111,24,87,49,0,0
52,01/05/2021,3,6,136,34,102,49,0,0
480,04/05/2021,3,0,28,19,9,57,0,0
785,07/05/2021,3,2,108,11,97,49,0,0
562,03/05/2021,3,2,66,16,50,49,0,0
815,02/05/2021,3,12,117,29,88,49,0,0
355,04/05/2021,3,3,96,33,63,55,0,0
406,09/05/2021,3,1,38,10,28,49,0,0
550,10/05/2021,3,6,106,17,89,49,0,0
72,01/05/2021,3,3,57,15,42,49,0,0
12,06/05/2021,3,2,41,18,23,49,0,0
522,04/05/2021,3,1,61,24,37,49,0,0
164,17/05/2021,3,0,62,42,20,52,0,0
560,02/05/2021,3,0,80,11,69,49,0,0
703,02/05/2021,3,1,90,16,74,49,0,0
451,08/05/2021,3,2,81,49,32,66,0,0
25,10/05/2021,3,1,51,26,25,49,0,0
247,15/05/2021,3,2,91,42,49,55,0,0
114,08/05/2021,3,0,75,31,44,49,0,0
110,11/05/2021,3,1,86,65,21,55,0,0
243,02/05/2021,3,1,126,86,40,49,0,0
42,04/05/2021,3,2,97,57,40,55,0,0
699,03/05/2021,3,0,62,20,42,59,0,0
757,09/05/2021,3,0,117,27,90,49,0,0
389,05/05/2021,3,2,124,32,92,49,0,0
65,08/05/2021,3,1,77,5,72,49,0,0
275,01/05/2021,3,6,111,49,62,49,0,0
854,06/05/2021,3,0,110,17,93,55,0,0
570,07/05/2021,3,0,149,24,125,49,0,0
101,02/05/2021,3,1,59,32,27,49,0,0
656,02/05/2021,3,1,114,14,100,49,0,0
492,08/05/2021,3,3,34,6,28,49,0,0
55,10/05/2021,3,1,32,16,16,49,0,0
72,02/05/2021,3,3,57,16,41,49,0,0
816,06/05/2021,3,4,78,48,30,64,0,0
784,04/05/2021,3,4,45,22,23,49,0,0
770,18/05/2021,3,0,35,27,8,74,0,0
525,02/05/2021,3,4,71,29,42,49,0,0
86,02/05/2021,3,3,45,7,38,49,0,0
106,08/05/2021,3,1,30,6,24,49,0,0
677,10/05/2021,3,0,40,24,16,49,0,0
825,14/05/2021,3,2,144,17,127,49,0,0
846,09/05/2021,3,3,186,11,175,45,0,0
431,11/05/2021,3,2,128,55,73,59,0,0
259,02/05/2021,3,0,60,35,25,49,0,0
42,05/05/2021,3,2,97,48,49,55,0,0
76,02/05/2021,3,0,93,28,65,49,0,0
203,10/05/2021,3,0,40,7,33,49,0,0
505,05/05/2021,3,0,84,16,68,49,0,0
254,08/05/2021,3,1,77,10,67,49,0,0
326,01/05/2021,3,5,76,14,62,49,0,0
366,04/05/2021,3,0,80,68,12,77,0,0
895,06/05/2021,3,0,69,35,34,49,0,0
520,02/05/2021,3,0,58,13,45,49,0,0
499,04/05/2021,3,0,31,13,18,55,0,0
702,08/05/2021,3,1,49,8,41,49,0,0
337,10/05/2021,3,0,60,22,38,49,0,0
642,02/05/2021,3,6,89,11,78,49,0,0
739,06/05/2021,3,2,73,24,49,49,0,0
491,04/05/2021,3,6,173,36,137,49,0,0
524,18/05/2021,3,0,110,65,45,60,0,0
657,02/05/2021,3,0,48,21,27,49,0,0
748,03/05/2021,3,6,138,12,126,49,0,0
755,08/05/2021,3,0,87,52,35,49,0,0
687,10/05/2021,3,2,85,23,62,49,0,0
56,15/05/2021,3,4,61,9,52,49,0,0
566,07/05/2021,3,1,74,21,53,49,0,0
832,10/05/2021,3,1,99,27,72,49,0,0
689,04/05/2021,3,1,129,31,98,49,0,0
287,04/05/2021,3,3,120,48,72,49,0,0
699,02/05/2021,3,0,62,10,52,49,0,0
830,09/05/2021,3,0,66,11,55,49,0,0
855,06/05/2021,3,1,175,58,117,49,0,0
515,08/05/2021,3,6,106,36,70,49,0,0
426,01/05/2021,3,1,162,47,115,49,0,0
480,05/05/2021,3,0,28,18,10,57,0,0
187,06/05/2021,3,1,40,12,28,49,0,0
172,03/05/2021,3,2,83,18,65,49,0,0
97,03/05/2021,3,8,99,15,84,59,0,0
558,02/05/2021,3,0,44,1,43,49,0,0
856,10/05/2021,3,0,120,10,110,49,0,0
92,02/05/2021,3,1,121,12,109,49,0,0
142,07/05/2021,3,1,61,24,37,49,0,0
239,03/05/2021,3,0,40,17,23,55,0,0
794,18/05/2021,3,0,137,32,105,55,0,0
669,01/05/2021,3,0,87,14,73,49,0,0
263,03/05/2021,3,0,66,6,60,49,0,0
106,07/05/2021,3,1,30,9,21,49,0,0
608,10/05/2021,3,13,127,31,96,49,0,0
825,15/05/2021,3,2,144,20,124,49,0,0
333,08/05/2021,3,1,56,34,22,127,0,0
838,09/05/2021,3,4,61,36,25,49,0,0
271,10/05/2021,3,0,70,27,43,49,0,0
413,04/05/2021,3,4,112,60,52,49,0,0
220,02/05/2021,3,57,46,13,33,49,0,0
2,10/05/2021,3,2,57,57,0,NA,NA,NA
831,05/05/2021,3,2,148,29,119,49,0,0
629,09/05/2021,3,2,60,31,29,49,0,0
691,01/05/2021,3,1,31,19,12,49,0,0
366,06/05/2021,3,0,80,65,15,67,0,0
895,05/05/2021,3,0,69,31,38,49,0,0
466,03/05/2021,3,0,140,13,127,49,0,0
636,04/05/2021,3,1,119,61,58,55,0,0
586,02/05/2021,3,4,79,49,30,64,0,0
459,11/05/2021,3,3,89,38,51,49,0,0
292,03/05/2021,3,6,233,21,212,49,0,0
394,07/05/2021,3,4,64,7,57,49,0,0
296,04/05/2021,3,3,57,34,23,57,0,0
794,17/05/2021,3,0,137,33,104,55,0,0
437,01/05/2021,3,2,163,33,130,49,0,0
487,03/05/2021,3,0,39,5,34,49,0,0
193,07/05/2021,3,2,106,14,92,49,0,0
353,09/05/2021,3,3,49,12,37,49,0,0
251,15/05/2021,3,0,124,16,108,49,0,0
356,07/05/2021,3,0,136,20,116,49,0,0
439,10/05/2021,3,5,86,23,63,49,0,0
526,10/05/2021,3,0,38,27,11,49,0,0
589,04/05/2021,3,4,139,60,79,49,0,0
285,01/05/2021,3,0,80,8,72,49,0,0
53,10/05/2021,3,0,70,33,37,64,0,0
855,05/05/2021,3,1,175,59,116,49,0,0
781,09/05/2021,3,2,81,27,54,49,0,0
742,01/05/2021,3,2,72,12,60,49,0,0
108,04/05/2021,3,0,78,16,62,49,0,0
238,06/05/2021,3,0,66,36,30,49,0,0
803,03/05/2021,3,0,69,19,50,49,0,0
97,05/05/2021,3,6,101,70,31,72,0,0
883,01/05/2021,3,1,103,11,92,45,0,0
698,11/05/2021,3,2,114,29,85,49,0,0
422,03/05/2021,3,1,78,16,62,49,0,0
433,06/05/2021,3,2,316,65,251,66,0,0
790,02/05/2021,3,0,99,10,89,66,0,0
746,18/05/2021,3,2,58,41,17,72,0,0
525,01/05/2021,3,3,72,17,55,49,0,0
624,07/05/2021,3,1,78,11,67,49,0,0
519,08/05/2021,3,0,64,33,31,49,0,0
687,09/05/2021,3,4,83,12,71,49,0,0
474,15/05/2021,3,0,112,26,86,49,0,0
293,08/05/2021,3,0,60,36,24,49,0,0
647,10/05/2021,3,6,87,53,34,49,0,0
689,10/05/2021,3,0,130,29,101,49,0,0
413,05/05/2021,3,1,115,56,59,49,0,0
84,01/05/2021,3,0,20,19,1,63,0,0
96,10/05/2021,3,14,55,30,25,52,0,0
176,06/05/2021,3,4,96,23,73,49,0,0
20,08/05/2021,3,2,80,21,59,49,0,0
310,01/05/2021,3,1,71,14,57,49,0,0
392,04/05/2021,3,0,176,36,140,49,0,0
99,02/05/2021,3,1,166,36,130,49,0,0
610,03/05/2021,3,1,66,20,46,55,0,0
889,01/05/2021,3,1,123,6,117,45,0,0
814,11/05/2021,3,1,67,33,34,55,0,0
813,03/05/2021,3,1,129,28,101,49,0,0
816,07/05/2021,3,4,78,37,41,49,0,0
239,04/05/2021,3,0,40,39,1,115,0,0
721,18/05/2021,3,29,111,105,6,65,0,0
560,01/05/2021,3,0,80,19,61,49,0,0
369,07/05/2021,3,4,86,8,78,49,0,0
594,08/05/2021,3,43,64,38,26,49,0,0
133,10/05/2021,3,2,62,33,29,49,0,0
251,16/05/2021,3,0,124,25,99,49,0,0
783,08/05/2021,3,1,79,78,1,71,0,0
728,10/05/2021,3,2,45,22,23,49,0,0
365,10/05/2021,3,0,68,66,2,85,0,0
287,05/05/2021,3,3,120,41,79,49,0,0
84,03/05/2021,3,0,20,12,8,55,0,0
921,10/05/2021,3,12,163,29,134,45,0,0
505,06/05/2021,3,0,84,26,58,49,0,0
629,08/05/2021,3,2,60,27,33,49,0,0
127,01/05/2021,3,1,59,11,48,49,0,0
108,05/05/2021,3,0,78,23,55,49,0,0
172,02/05/2021,3,2,83,29,54,49,0,0
636,05/05/2021,3,1,119,59,60,55,0,0
492,03/05/2021,3,3,34,6,28,49,0,0
319,11/05/2021,3,8,106,82,24,67,0,0
813,02/05/2021,3,1,129,22,107,49,0,0
209,07/05/2021,3,1,113,72,41,55,0,0
882,04/05/2021,3,0,130,54,76,39,0,0
168,17/05/2021,3,0,48,29,19,72,0,0
67,02/05/2021,3,1,51,13,38,49,0,0
748,08/05/2021,3,5,139,18,121,49,0,0
755,07/05/2021,3,1,86,46,40,49,0,0
444,10/05/2021,3,4,115,45,70,49,0,0
350,05/05/2021,3,3,57,54,3,83,0,0
637,07/05/2021,3,1,73,22,51,49,0,0
647,11/05/2021,3,3,90,39,51,49,0,0
151,10/05/2021,3,5,71,37,34,55,0,0
776,04/05/2021,3,0,104,34,70,49,0,0
750,01/05/2021,3,10,102,93,9,65,0,0
921,09/05/2021,3,3,172,11,161,45,0,0
831,04/05/2021,3,2,148,35,113,49,0,0
130,09/05/2021,3,3,78,10,68,49,0,0
222,01/05/2021,3,0,77,5,72,49,0,0
392,05/05/2021,3,0,176,36,140,49,0,0
460,02/05/2021,3,7,102,23,79,49,0,0
733,05/05/2021,3,0,100,14,86,49,0,0
175,02/05/2021,3,1,119,12,107,49,0,0
55,11/05/2021,3,1,32,15,17,60,0,0
292,02/05/2021,3,0,239,53,186,49,0,0
529,02/05/2021,3,5,36,7,29,49,0,0
267,04/05/2021,3,4,79,67,12,62,0,0
168,18/05/2021,3,0,48,44,4,89,0,0
67,01/05/2021,3,1,51,17,34,49,0,0
86,08/05/2021,3,1,47,22,25,49,0,0
475,08/05/2021,3,1,98,33,65,49,0,0
507,10/05/2021,3,3,197,35,162,49,0,0
56,05/05/2021,3,2,63,27,36,59,0,0
360,08/05/2021,3,1,43,4,39,49,0,0
136,10/05/2021,3,1,127,39,88,49,0,0
778,10/05/2021,3,2,79,76,3,80,0,0
589,05/05/2021,3,4,139,51,88,49,0,0
34,02/05/2021,3,4,84,46,38,52,0,0
158,10/05/2021,3,1,23,20,3,84,0,0
855,04/05/2021,3,1,175,57,118,49,0,0
347,08/05/2021,3,0,62,15,47,49,0,0
612,01/05/2021,3,2,40,16,24,49,0,0
480,08/05/2021,3,0,28,9,19,49,0,0
723,02/05/2021,3,1,80,21,59,49,0,0
636,02/05/2021,3,1,119,31,88,49,0,0
175,03/05/2021,3,1,119,10,109,49,0,0
844,11/05/2021,3,0,61,10,51,55,0,0
754,02/05/2021,3,0,62,5,57,49,0,0
496,02/05/2021,3,1,59,10,49,49,0,0
707,03/05/2021,3,1,39,13,26,55,0,0
673,18/05/2021,3,0,123,50,73,49,0,0
806,02/05/2021,3,2,134,29,105,49,0,0
511,07/05/2021,3,3,73,10,63,49,0,0
848,07/05/2021,3,10,128,21,107,35,0,0
200,09/05/2021,3,56,63,18,45,49,0,0
253,05/05/2021,3,1,57,20,37,60,0,0
566,09/05/2021,3,1,74,13,61,49,0,0
574,10/05/2021,3,1,86,17,69,49,0,0
151,09/05/2021,3,7,69,11,58,49,0,0
776,08/05/2021,3,0,104,16,88,49,0,0
385,02/05/2021,3,2,61,43,18,57,0,0
410,09/05/2021,3,1,55,8,47,49,0,0
831,06/05/2021,3,1,149,31,118,49,0,0
396,08/05/2021,3,1,29,10,19,49,0,0
772,01/05/2021,3,0,57,9,48,49,0,0
854,07/05/2021,3,5,105,10,95,55,0,0
99,03/05/2021,3,1,166,27,139,49,0,0
601,03/05/2021,3,4,64,13,51,49,0,0
378,03/05/2021,3,1,83,17,66,49,0,0
329,11/05/2021,3,9,98,8,90,49,0,0
292,01/05/2021,3,0,239,89,150,49,0,0
173,02/05/2021,3,1,70,19,51,49,0,0
882,03/05/2021,3,0,130,52,78,39,0,0
149,07/05/2021,3,0,88,16,72,49,0,0
152,02/05/2021,3,1,90,15,75,49,0,0
731,07/05/2021,3,7,92,12,80,49,0,0
848,08/05/2021,3,10,128,20,108,35,0,0
444,13/05/2021,3,4,115,64,51,49,0,0
15,05/05/2021,3,0,31,13,18,59,0,0
311,08/05/2021,3,0,97,18,79,49,0,0
598,10/05/2021,3,0,146,147,-1,NA,NA,NA
190,10/05/2021,3,4,76,12,64,49,0,0
147,06/05/2021,3,0,80,36,44,49,0,0
385,03/05/2021,3,2,61,43,18,60,0,0
531,10/05/2021,3,2,57,11,46,49,0,0
277,02/05/2021,3,4,68,3,65,49,0,0
224,09/05/2021,3,1,56,15,41,49,0,0
227,01/05/2021,3,3,41,20,21,49,0,0
854,08/05/2021,3,9,101,12,89,55,0,0
738,03/05/2021,3,1,123,22,101,55,0,0
656,05/05/2021,3,0,115,56,59,49,0,0
537,02/05/2021,3,0,102,15,87,49,0,0
337,11/05/2021,3,0,60,20,40,49,0,0
782,02/05/2021,3,0,20,5,15,55,0,0
496,01/05/2021,3,1,59,5,54,49,0,0
401,03/05/2021,3,0,79,16,63,55,0,0
794,07/05/2021,3,0,137,14,123,55,0,0
226,02/05/2021,3,0,47,8,39,49,0,0
583,07/05/2021,3,1,80,29,51,49,0,0
262,08/05/2021,3,2,49,26,23,49,0,0
677,13/05/2021,3,1,39,18,21,49,0,0
654,05/05/2021,3,0,59,13,46,66,0,0
217,13/05/2021,3,1,40,25,15,52,0,0
352,03/05/2021,3,2,62,7,55,55,0,0
342,10/05/2021,3,0,114,51,63,49,0,0
413,06/05/2021,3,1,115,55,60,49,0,0
206,01/05/2021,3,2,211,51,160,55,0,0
820,09/05/2021,3,0,127,28,99,49,0,0
831,03/05/2021,3,2,148,14,134,49,0,0
65,13/05/2021,3,1,77,28,49,49,0,0
481,01/05/2021,3,0,56,6,50,49,0,0
232,07/05/2021,3,3,62,27,35,49,0,0
88,08/05/2021,3,1,41,5,36,49,0,0
97,02/05/2021,3,6,101,19,82,49,0,0
613,01/05/2021,3,0,56,11,45,49,0,0
911,11/05/2021,3,0,158,4,154,49,0,0
202,02/05/2021,3,0,76,19,57,49,0,0
167,01/05/2021,3,0,84,32,52,49,0,0
416,02/05/2021,3,1,33,8,25,49,0,0
673,08/05/2021,3,0,123,19,104,49,0,0
657,14/05/2021,3,0,48,16,32,49,0,0
841,01/05/2021,3,0,182,16,166,55,0,0
617,08/05/2021,3,1,43,3,40,49,0,0
687,12/05/2021,3,2,85,32,53,49,0,0
192,06/05/2021,3,0,86,41,45,49,0,0
333,13/05/2021,3,1,56,43,13,85,0,0
404,03/05/2021,3,1,66,23,43,59,0,0
151,01/05/2021,3,7,69,21,48,49,0,0
864,06/05/2021,3,1,84,39,45,49,0,0
34,03/05/2021,3,4,84,42,42,55,0,0
486,10/05/2021,3,0,124,12,112,49,0,0
314,01/05/2021,3,1,68,28,40,49,0,0
254,13/05/2021,3,1,77,31,46,49,0,0
861,01/05/2021,3,0,61,61,0,NA,NA,NA
33,08/05/2021,3,4,76,60,16,57,0,0
738,08/05/2021,3,1,123,22,101,49,0,0
188,02/05/2021,3,5,116,11,105,49,0,0
613,03/05/2021,3,0,56,19,37,49,0,0
698,09/05/2021,3,2,114,14,100,49,0,0
760,02/05/2021,3,2,34,6,28,49,0,0
209,01/05/2021,3,1,113,107,6,83,0,0
281,02/05/2021,3,4,79,19,60,49,0,0
90,06/05/2021,3,0,78,38,40,52,0,0
211,12/05/2021,3,3,57,41,16,60,0,0
624,01/05/2021,3,1,78,9,69,49,0,0
792,13/05/2021,3,0,102,16,86,49,0,0
269,05/05/2021,3,3,77,13,64,49,0,0
79,14/05/2021,3,2,44,12,32,49,0,0
110,04/05/2021,3,1,86,49,37,49,0,0
259,01/05/2021,3,0,60,60,0,NA,NA,NA
864,07/05/2021,3,1,84,29,55,49,0,0
180,02/05/2021,3,0,41,5,36,49,0,0
410,10/05/2021,3,0,56,23,33,49,0,0
389,01/05/2021,3,2,124,7,117,49,0,0
335,13/05/2021,3,4,82,31,51,49,0,0
742,04/05/2021,3,1,73,32,41,55,0,0
120,07/05/2021,3,2,152,16,136,49,0,0
99,07/05/2021,3,1,166,35,131,49,0,0
601,02/05/2021,3,4,64,29,35,49,0,0
883,03/05/2021,3,2,102,20,82,45,0,0
814,09/05/2021,3,1,67,13,54,49,0,0
3,03/05/2021,3,5,108,27,81,49,0,0
527,01/05/2021,3,7,54,15,39,49,0,0
446,02/05/2021,3,8,125,75,50,49,0,0
168,06/05/2021,3,0,48,36,12,80,0,0
437,14/05/2021,3,2,163,26,137,49,0,0
233,01/05/2021,3,4,63,4,59,49,0,0
133,13/05/2021,3,3,61,27,34,49,0,0
474,05/05/2021,3,0,112,37,75,49,0,0
500,14/05/2021,3,5,74,4,70,49,0,0
484,02/05/2021,3,0,40,7,33,49,0,0
420,01/05/2021,3,2,67,67,0,NA,NA,NA
17,08/05/2021,3,1,93,25,68,49,0,0
34,01/05/2021,3,5,83,38,45,49,0,0
339,10/05/2021,3,22,572,19,553,49,0,0
103,01/05/2021,3,3,158,146,12,62,0,0
396,13/05/2021,3,1,29,12,17,49,0,0
227,03/05/2021,3,3,41,6,35,49,0,0
392,08/05/2021,3,0,176,29,147,49,0,0
101,08/05/2021,3,1,59,22,37,49,0,0
80,03/05/2021,3,1,124,20,104,49,0,0
889,02/05/2021,3,1,123,14,109,45,0,0
181,08/05/2021,3,1,33,12,21,49,0,0
464,01/05/2021,3,2,264,12,252,66,0,0
529,01/05/2021,3,5,36,7,29,49,0,0
666,02/05/2021,3,3,63,17,46,49,0,0
90,08/05/2021,3,0,78,9,69,49,0,0
4,12/05/2021,3,1,63,50,13,80,0,0
731,01/05/2021,3,4,95,19,76,49,0,0
448,12/05/2021,3,3,150,55,95,66,0,0
15,07/05/2021,3,0,31,3,28,49,0,0
79,15/05/2021,3,2,44,16,28,49,0,0
484,03/05/2021,3,0,40,8,32,49,0,0
778,01/05/2021,3,4,77,77,0,NA,NA,NA
42,08/05/2021,3,2,97,32,65,49,0,0
294,01/05/2021,3,2,115,40,75,49,0,0
2,09/05/2021,3,2,57,25,32,49,0,0
837,01/05/2021,3,6,320,11,309,66,0,0
676,13/05/2021,3,3,112,49,63,49,0,0
861,02/05/2021,3,0,61,52,9,57,0,0
588,08/05/2021,3,1,58,12,46,49,0,0
88,07/05/2021,3,1,41,4,37,49,0,0
697,03/05/2021,3,1,108,26,82,49,0,0
889,03/05/2021,3,1,123,18,105,45,0,0
329,08/05/2021,3,9,98,18,80,49,0,0
760,01/05/2021,3,2,34,5,29,49,0,0
167,02/05/2021,3,0,84,25,59,49,0,0
182,03/05/2021,3,2,78,8,70,49,0,0
736,07/05/2021,3,1,104,6,98,49,0,0
525,13/05/2021,3,1,74,37,37,49,0,0
216,01/05/2021,3,1,57,3,54,49,0,0
507,12/05/2021,3,3,197,28,169,49,0,0
474,07/05/2021,3,0,112,15,97,49,0,0
500,15/05/2021,3,5,74,7,67,49,0,0
352,04/05/2021,3,2,62,40,22,60,0,0
365,01/05/2021,3,0,68,17,51,55,0,0
413,08/05/2021,3,2,114,20,94,49,0,0
805,01/05/2021,3,2,111,16,95,49,0,0
820,12/05/2021,3,0,127,97,30,72,0,0
176,01/05/2021,3,4,96,9,87,49,0,0
515,13/05/2021,3,5,107,50,57,49,0,0
861,03/05/2021,3,0,61,44,17,60,0,0
33,01/05/2021,3,5,75,73,2,71,0,0
101,07/05/2021,3,1,59,15,44,49,0,0
656,04/05/2021,3,1,114,44,70,49,0,0
586,03/05/2021,3,3,80,26,54,59,0,0
459,08/05/2021,3,3,89,29,60,49,0,0
139,02/05/2021,3,2,57,16,41,49,0,0
394,02/05/2021,3,3,65,7,58,49,0,0
296,03/05/2021,3,3,57,8,49,49,0,0
229,08/05/2021,3,1,55,27,28,49,0,0
657,13/05/2021,3,0,48,24,24,59,0,0
487,01/05/2021,3,0,39,4,35,49,0,0
809,12/05/2021,3,4,97,43,54,49,0,0
825,07/05/2021,3,0,146,18,128,49,0,0
114,04/05/2021,3,0,75,75,0,NA,NA,NA
838,04/05/2021,3,4,61,51,10,80,0,0
342,01/05/2021,3,0,114,26,88,49,0,0
607,08/05/2021,3,2,73,14,59,49,0,0
294,02/05/2021,3,2,115,25,90,49,0,0
830,12/05/2021,3,0,66,26,40,59,0,0
709,01/05/2021,3,1,82,12,70,49,0,0
65,12/05/2021,3,1,77,22,55,49,0,0
481,04/05/2021,3,0,56,37,19,57,0,0
860,01/05/2021,3,8,84,12,72,49,0,0
723,07/05/2021,3,1,80,18,62,49,0,0
188,05/05/2021,3,5,116,35,81,49,0,0
406,03/05/2021,3,1,38,11,27,55,0,0
698,08/05/2021,3,2,114,51,63,49,0,0
464,02/05/2021,3,2,264,9,255,66,0,0
816,02/05/2021,3,2,80,45,35,49,0,0
446,03/05/2021,3,8,125,55,70,49,0,0
547,06/05/2021,3,2,72,38,34,49,0,0
669,12/05/2021,3,0,87,44,43,49,0,0
634,01/05/2021,3,1,19,15,4,60,0,0
245,13/05/2021,3,5,92,36,56,49,0,0
683,06/05/2021,3,1,65,27,38,49,0,0
846,04/05/2021,3,2,187,21,166,45,0,0
832,03/05/2021,3,1,99,9,90,49,0,0
243,01/05/2021,3,1,126,100,26,60,0,0
857,02/05/2021,3,3,207,71,136,49,0,0
757,11/05/2021,3,0,117,107,10,85,0,0
831,01/05/2021,3,1,149,14,135,49,0,0
676,12/05/2021,3,3,112,61,51,49,0,0
861,04/05/2021,3,0,61,58,3,79,0,0
232,01/05/2021,3,1,64,46,18,49,0,0
803,07/05/2021,3,1,68,12,56,49,0,0
80,11/05/2021,3,2,123,38,85,49,0,0
883,02/05/2021,3,1,103,12,91,45,0,0
808,08/05/2021,3,12,156,63,93,49,0,0
622,03/05/2021,3,1,43,11,32,55,0,0
446,04/05/2021,3,8,125,39,86,49,0,0
746,08/05/2021,3,3,57,12,45,49,0,0
498,14/05/2021,3,0,87,15,72,49,0,0
583,01/05/2021,3,1,80,55,25,52,0,0
608,13/05/2021,3,11,129,39,90,49,0,0
162,05/05/2021,3,1,121,32,89,49,0,0
846,06/05/2021,3,3,186,14,172,45,0,0
484,04/05/2021,3,0,40,33,7,77,0,0
817,01/05/2021,3,1,82,18,64,49,0,0
143,02/05/2021,3,2,118,15,103,49,0,0
531,11/05/2021,3,2,57,13,44,49,0,0
121,01/05/2021,3,0,110,65,45,49,0,0
282,13/05/2021,3,26,675,41,634,49,0,0
426,02/05/2021,3,1,162,38,124,49,0,0
588,01/05/2021,3,1,58,18,40,49,0,0
99,08/05/2021,3,1,166,48,118,49,0,0
733,11/05/2021,3,0,100,12,88,49,0,0
558,01/05/2021,3,0,44,2,42,49,0,0
814,08/05/2021,3,1,67,25,42,49,0,0
782,01/05/2021,3,0,20,8,12,49,0,0
666,04/05/2021,3,3,63,29,34,49,0,0
587,07/05/2021,3,3,78,15,63,49,0,0
226,04/05/2021,3,0,47,29,18,74,0,0
685,01/05/2021,3,2,138,38,100,49,0,0
46,12/05/2021,3,2,58,49,9,59,0,0
251,05/05/2021,3,1,123,40,83,49,0,0
783,04/05/2021,3,1,79,73,6,90,0,0
714,03/05/2021,3,0,59,5,54,55,0,0
271,01/05/2021,3,0,70,16,54,49,0,0
143,03/05/2021,3,3,117,18,99,49,0,0
531,12/05/2021,3,2,57,21,36,49,0,0
32,01/05/2021,3,1,104,15,89,49,0,0
515,12/05/2021,3,5,107,41,66,49,0,0
612,02/05/2021,3,2,40,15,25,49,0,0
108,01/05/2021,3,0,78,13,65,49,0,0
723,08/05/2021,3,1,80,21,59,49,0,0
870,09/05/2021,3,6,40,9,31,49,0,0
613,02/05/2021,3,0,56,7,49,49,0,0
98,09/05/2021,3,1,94,39,55,49,0,0
622,01/05/2021,3,1,43,43,0,NA,NA,NA
182,04/05/2021,3,2,78,27,51,49,0,0
587,08/05/2021,3,3,78,14,64,49,0,0
560,05/05/2021,3,0,80,55,25,74,0,0
369,01/05/2021,3,2,88,7,81,49,0,0
353,12/05/2021,3,1,51,35,16,72,0,0
512,05/05/2021,3,1,61,28,33,49,0,0
217,05/05/2021,3,1,40,27,13,57,0,0
714,04/05/2021,3,0,59,29,30,55,0,0
131,01/05/2021,3,1,48,25,23,49,0,0
886,01/05/2021,3,0,152,25,127,49,0,0
486,13/05/2021,3,0,124,17,107,49,0,0
257,01/05/2021,3,1,43,12,31,49,0,0
130,12/05/2021,3,3,78,29,49,49,0,0
691,02/05/2021,3,1,31,16,15,49,0,0
392,01/05/2021,3,0,176,30,146,49,0,0
334,01/05/2021,3,0,58,11,47,57,0,0
80,09/05/2021,3,1,124,10,114,49,0,0
378,01/05/2021,3,0,84,14,70,49,0,0
319,09/05/2021,3,8,106,32,74,49,0,0
72,08/05/2021,3,3,57,27,30,49,0,0
522,03/05/2021,3,1,61,13,48,49,0,0
713,06/05/2021,3,2,59,56,3,85,0,0
657,03/05/2021,3,0,48,13,35,55,0,0
511,01/05/2021,3,0,76,17,59,49,0,0
591,13/05/2021,3,1,67,48,19,60,0,0
253,07/05/2021,3,1,57,7,50,49,0,0
783,05/05/2021,3,1,79,50,29,64,0,0
404,04/05/2021,3,0,67,26,41,59,0,0
190,01/05/2021,3,7,73,18,55,49,0,0
699,01/05/2021,3,0,62,18,44,49,0,0
531,13/05/2021,3,2,57,31,26,49,0,0
277,01/05/2021,3,4,68,13,55,49,0,0
347,12/05/2021,3,22,40,40,0,NA,NA,NA
481,03/05/2021,3,0,56,13,43,49,0,0
623,01/05/2021,3,0,78,9,69,49,0,0
460,01/05/2021,3,8,101,26,75,49,0,0
859,09/05/2021,3,1,84,7,77,49,0,0
492,01/05/2021,3,1,36,4,32,49,0,0
459,09/05/2021,3,3,89,46,43,49,0,0
622,06/05/2021,3,1,43,23,20,55,0,0
239,02/05/2021,3,0,40,25,15,49,0,0
168,07/05/2021,3,0,48,14,34,49,0,0
368,01/05/2021,3,1,84,18,66,49,0,0
748,01/05/2021,3,3,141,19,122,49,0,0
133,12/05/2021,3,3,61,42,19,57,0,0
683,07/05/2021,3,1,65,4,61,49,0,0
79,04/05/2021,3,2,44,41,3,123,0,0
584,04/05/2021,3,1,96,40,56,55,0,0
526,01/05/2021,3,0,38,10,28,49,0,0
76,03/05/2021,3,0,93,20,73,49,0,0
830,13/05/2021,3,0,66,35,31,49,0,0
505,01/05/2021,3,3,81,22,59,49,0,0
130,04/05/2021,3,2,79,38,41,52,0,0
310,04/05/2021,3,1,71,46,25,60,0,0
366,01/05/2021,3,1,79,27,52,49,0,0
101,01/05/2021,3,1,59,32,27,52,0,0
859,10/05/2021,3,1,84,10,74,49,0,0
69,03/05/2021,3,1,59,15,44,49,0,0
716,09/05/2021,3,0,104,26,78,49,0,0
72,06/05/2021,3,2,58,39,19,52,0,0
416,03/05/2021,3,0,34,5,29,49,0,0
159,08/05/2021,3,0,77,6,71,49,0,0
152,01/05/2021,3,1,90,14,76,49,0,0
703,01/05/2021,3,1,90,23,67,49,0,0
581,12/05/2021,3,29,196,102,94,59,0,0
162,07/05/2021,3,1,121,19,102,49,0,0
79,05/05/2021,3,2,44,36,8,77,0,0
362,02/05/2021,3,4,116,79,37,64,0,0
593,01/05/2021,3,5,76,21,55,49,0,0
180,03/05/2021,3,0,41,10,31,49,0,0
921,12/05/2021,3,13,162,9,153,45,0,0
434,01/05/2021,3,3,57,7,50,49,0,0
207,04/05/2021,3,3,60,20,40,55,0,0
691,04/05/2021,3,1,31,13,18,64,0,0
120,01/05/2021,3,2,152,26,126,49,0,0
815,01/05/2021,3,12,117,45,72,49,0,0
859,11/05/2021,3,1,84,8,76,49,0,0
93,01/05/2021,3,2,139,17,122,49,0,0
808,09/05/2021,3,11,157,40,117,49,0,0
202,06/05/2021,3,1,75,56,19,72,0,0
784,03/05/2021,3,4,45,9,36,49,0,0
547,08/05/2021,3,1,73,17,56,49,0,0
57,02/05/2021,3,1,139,18,121,49,0,0
86,01/05/2021,3,1,47,10,37,49,0,0
46,13/05/2021,3,3,57,47,10,79,0,0
251,07/05/2021,3,1,123,11,112,49,0,0
360,04/05/2021,3,1,43,17,26,59,0,0
352,02/05/2021,3,2,62,11,51,49,0,0
689,01/05/2021,3,1,129,20,109,49,0,0
285,03/05/2021,3,0,80,11,69,49,0,0
2,13/05/2021,3,2,57,46,11,80,0,0
835,01/05/2021,3,4,100,52,48,49,0,0
869,04/05/2021,3,2,58,38,20,90,0,0
742,03/05/2021,3,1,73,5,68,55,0,0
854,01/05/2021,3,11,99,10,89,55,0,0
88,01/05/2021,3,1,41,8,33,49,0,0
29,01/05/2021,3,0,54,0,54,NA,NA,NA
93,03/05/2021,3,2,139,15,124,49,0,0
724,08/05/2021,3,1,85,68,17,57,0,0
782,08/05/2021,3,0,20,20,0,NA,NA,NA
267,02/05/2021,3,3,80,10,70,49,0,0
770,06/05/2021,3,4,31,8,23,49,0,0
437,02/05/2021,3,2,163,23,140,49,0,0
263,01/05/2021,3,0,66,21,45,49,0,0
200,13/05/2021,3,7,112,89,23,67,0,0
192,05/05/2021,3,0,86,48,38,52,0,0
360,05/05/2021,3,2,42,8,34,59,0,0
838,02/05/2021,3,3,62,24,38,49,0,0
184,01/05/2021,3,0,51,21,30,49,0,0
886,03/05/2021,3,0,152,55,97,49,0,0
327,13/05/2021,3,2,66,44,22,64,0,0
855,01/05/2021,3,1,175,34,141,49,0,0
20,05/05/2021,3,2,80,44,36,55,0,0
127,03/05/2021,3,1,59,5,54,55,0,0
274,01/05/2021,3,0,210,11,199,39,0,0
485,01/05/2021,3,0,65,17,48,49,0,0
549,01/05/2021,3,0,61,0,61,NA,NA,NA
378,02/05/2021,3,0,84,16,68,49,0,0
301,08/05/2021,3,1,100,22,78,49,0,0
782,04/05/2021,3,0,20,17,3,189,0,0
450,02/05/2021,3,10,174,35,139,49,0,0
90,07/05/2021,3,0,78,9,69,49,0,0
498,02/05/2021,3,0,87,16,71,49,0,0
624,04/05/2021,3,1,78,28,50,49,0,0
448,13/05/2021,3,3,150,48,102,66,0,0
186,05/05/2021,3,1,57,28,29,52,0,0
311,04/05/2021,3,1,96,58,38,49,0,0
439,03/05/2021,3,9,82,4,78,49,0,0
285,02/05/2021,3,0,80,12,68,49,0,0
96,13/05/2021,3,14,55,33,22,52,0,0
592,05/05/2021,3,24,60,54,6,93,0,0
480,01/05/2021,3,0,28,8,20,49,0,0
868,01/05/2021,3,0,83,11,72,49,0,0
499,01/05/2021,3,0,31,5,26,49,0,0
406,01/05/2021,3,1,38,20,18,49,0,0
508,08/05/2021,3,26,54,13,41,49,0,0
782,05/05/2021,3,0,20,16,4,168,0,0
707,02/05/2021,3,1,39,10,29,49,0,0
794,08/05/2021,3,0,137,27,110,55,0,0
624,05/05/2021,3,1,78,25,53,49,0,0
555,13/05/2021,3,1,116,67,49,55,0,0
399,05/05/2021,3,1,60,50,10,79,0,0
500,04/05/2021,3,4,75,13,62,49,0,0
832,02/05/2021,3,1,99,7,92,49,0,0
626,02/05/2021,3,1,101,26,75,49,0,0
818,13/05/2021,3,1,80,79,1,95,0,0
396,04/05/2021,3,1,29,12,17,52,0,0
250,01/05/2021,3,0,115,93,22,72,0,0
466,01/05/2021,3,0,140,17,123,49,0,0
656,01/05/2021,3,0,115,33,82,49,0,0
477,01/05/2021,3,4,116,9,107,49,0,0
716,08/05/2021,3,0,104,20,84,49,0,0
754,04/05/2021,3,0,62,13,49,49,0,0
666,03/05/2021,3,3,63,18,45,49,0,0
721,08/05/2021,3,63,77,67,10,62,0,0
731,04/05/2021,3,7,92,42,50,49,0,0
652,12/05/2021,3,0,69,60,9,80,0,0
15,06/05/2021,3,0,31,15,16,55,0,0
566,04/05/2021,3,2,73,24,49,49,0,0
832,04/05/2021,3,1,99,26,73,49,0,0
220,03/05/2021,3,33,83,19,64,49,0,0
820,11/05/2021,3,0,127,106,21,72,0,0
781,04/05/2021,3,1,82,36,46,49,0,0
767,01/05/2021,3,0,67,6,61,49,0,0
520,01/05/2021,3,0,58,24,34,49,0,0
859,01/05/2021,3,2,83,83,0,NA,NA,NA
702,01/05/2021,3,1,49,4,45,49,0,0
337,08/05/2021,3,0,60,8,52,49,0,0
754,05/05/2021,3,0,62,17,45,49,0,0
450,04/05/2021,3,10,174,61,113,49,0,0
229,06/05/2021,3,1,55,46,9,84,0,0
233,06/05/2021,3,3,64,25,39,49,0,0
652,13/05/2021,3,0,69,56,13,72,0,0
654,06/05/2021,3,0,59,26,33,66,0,0
566,05/05/2021,3,2,73,16,57,49,0,0
110,02/05/2021,3,1,86,4,82,49,0,0
294,03/05/2021,3,3,114,19,95,49,0,0
757,13/05/2021,3,0,117,105,12,80,0,0
65,05/05/2021,3,1,77,22,55,49,0,0
429,01/05/2021,3,3,122,13,109,49,0,0
723,01/05/2021,3,1,80,20,60,49,0,0
697,01/05/2021,3,1,108,94,14,52,0,0
93,02/05/2021,3,2,139,15,124,49,0,0
337,09/05/2021,3,0,60,5,55,49,0,0
139,04/05/2021,3,2,57,22,35,52,0,0
296,02/05/2021,3,1,59,20,39,49,0,0
721,07/05/2021,3,63,77,61,16,57,0,0
841,05/05/2021,3,0,182,34,148,55,0,0
444,12/05/2021,3,4,115,58,57,49,0,0
399,06/05/2021,3,1,60,34,26,55,0,0
500,06/05/2021,3,5,74,18,56,49,0,0
574,02/05/2021,3,1,86,6,80,49,0,0
805,03/05/2021,3,2,111,15,96,49,0,0
643,11/05/2021,3,2,101,39,62,49,0,0
396,05/05/2021,3,1,29,9,20,49,0,0
177,01/05/2021,3,0,48,3,45,49,0,0
803,01/05/2021,3,1,68,11,57,49,0,0
636,01/05/2021,3,1,119,39,80,49,0,0
406,02/05/2021,3,1,38,15,23,49,0,0
508,09/05/2021,3,26,54,10,44,49,0,0
622,05/05/2021,3,1,43,17,26,55,0,0
401,02/05/2021,3,0,79,18,61,49,0,0
713,07/05/2021,3,1,60,57,3,80,0,0
511,04/05/2021,3,0,76,38,38,60,0,0
442,13/05/2021,3,1,157,36,121,49,0,0
56,06/05/2021,3,4,61,24,37,55,0,0
114,05/05/2021,3,0,75,72,3,80,0,0
728,02/05/2021,3,1,46,9,37,49,0,0
143,01/05/2021,3,2,118,28,90,49,0,0
791,11/05/2021,3,16,112,35,77,49,0,0
867,05/05/2021,3,1,59,42,17,64,0,0
429,02/05/2021,3,3,122,5,117,49,0,0
172,01/05/2021,3,1,84,44,40,49,0,0
601,01/05/2021,3,4,64,27,37,49,0,0
477,02/05/2021,3,5,115,6,109,49,0,0
313,08/05/2021,3,0,31,11,20,49,0,0
72,04/05/2021,3,3,57,41,16,67,0,0
491,02/05/2021,3,0,179,19,160,49,0,0
673,07/05/2021,3,0,123,23,100,49,0,0
703,05/05/2021,3,1,90,58,32,60,0,0
507,13/05/2021,3,3,197,38,159,49,0,0
247,05/05/2021,3,2,91,55,36,49,0,0
293,04/05/2021,3,0,60,22,38,49,0,0
647,04/05/2021,3,1,92,39,53,49,0,0
805,02/05/2021,3,2,111,13,98,49,0,0
486,12/05/2021,3,0,124,17,107,49,0,0
789,04/05/2021,3,0,72,34,38,55,0,0
33,03/05/2021,3,5,75,20,55,49,0,0
19,01/05/2021,3,2,92,5,87,49,0,0
97,01/05/2021,3,6,101,21,80,49,0,0
492,02/05/2021,3,3,34,7,27,49,0,0
313,09/05/2021,3,0,31,9,22,49,0,0
202,04/05/2021,3,2,74,56,18,72,0,0
267,03/05/2021,3,4,79,41,38,49,0,0
811,08/05/2021,3,3,87,16,71,49,0,0
703,04/05/2021,3,1,90,69,21,55,0,0
687,13/05/2021,3,1,86,46,40,49,0,0
436,05/05/2021,3,2,204,69,135,49,0,0
293,05/05/2021,3,0,60,20,40,49,0,0
714,02/05/2021,3,0,59,5,54,49,0,0
886,02/05/2021,3,0,152,34,118,49,0,0
386,13/05/2021,3,6,79,52,27,49,0,0
789,05/05/2021,3,0,72,24,48,55,0,0
120,03/05/2021,3,2,152,19,133,49,0,0
99,01/05/2021,3,1,166,46,120,49,0,0
80,01/05/2021,3,1,124,23,101,49,0,0
504,01/05/2021,3,0,83,17,66,49,0,0
891,09/05/2021,3,2,80,5,75,49,0,0
518,05/05/2021,3,1,16,15,1,57,0,0
450,03/05/2021,3,10,174,40,134,49,0,0
587,06/05/2021,3,3,78,25,53,49,0,0
369,05/05/2021,3,5,85,57,28,55,0,0
809,13/05/2021,3,5,96,44,52,49,0,0
597,05/05/2021,3,3,98,23,75,49,0,0
783,06/05/2021,3,1,79,59,20,72,0,0
136,04/05/2021,3,0,128,53,75,49,0,0
76,01/05/2021,3,0,93,34,59,49,0,0
410,13/05/2021,3,1,55,21,34,49,0,0
629,05/05/2021,3,0,62,23,39,49,0,0
429,03/05/2021,3,3,122,7,115,49,0,0
738,01/05/2021,3,1,123,15,108,49,0,0
733,01/05/2021,3,0,100,8,92,49,0,0
537,01/05/2021,3,0,102,24,78,49,0,0
550,09/05/2021,3,5,107,12,95,49,0,0
464,04/05/2021,3,2,264,36,228,66,0,0
491,03/05/2021,3,0,179,20,159,49,0,0
547,07/05/2021,3,2,72,14,58,49,0,0
685,05/05/2021,3,3,137,56,81,55,0,0
652,08/05/2021,3,0,69,7,62,49,0,0
269,06/05/2021,3,2,78,11,67,49,0,0
797,05/05/2021,3,1,66,39,27,55,0,0
686,04/05/2021,3,0,46,16,30,49,0,0
220,01/05/2021,3,45,58,20,38,49,0,0
643,13/05/2021,3,2,101,38,63,49,0,0
254,05/05/2021,3,1,77,41,36,52,0,0
588,03/05/2021,3,1,58,9,49,49,0,0
460,05/05/2021,3,9,100,22,78,49,0,0
188,01/05/2021,3,5,116,7,109,49,0,0
504,02/05/2021,3,0,83,13,70,49,0,0
313,05/05/2021,3,0,31,16,15,57,0,0
202,05/05/2021,3,1,75,51,24,72,0,0
281,04/05/2021,3,3,80,61,19,76,0,0
149,08/05/2021,3,0,88,14,74,49,0,0
841,06/05/2021,3,0,182,33,149,55,0,0
652,07/05/2021,3,0,69,9,60,49,0,0
825,06/05/2021,3,0,146,22,124,49,0,0
293,06/05/2021,3,0,60,24,36,49,0,0
686,03/05/2021,3,0,46,15,31,49,0,0
626,01/05/2021,3,1,101,21,80,49,0,0
732,13/05/2021,3,0,60,16,44,49,0,0
867,04/05/2021,3,1,59,54,5,80,0,0
860,03/05/2021,3,12,80,9,71,49,0,0
466,06/05/2021,3,0,140,18,122,49,0,0
355,01/05/2021,3,2,97,14,83,49,0,0
378,07/05/2021,3,0,84,11,73,49,0,0
724,05/05/2021,3,0,86,84,2,92,0,0
72,05/05/2021,3,2,58,43,15,74,0,0
882,02/05/2021,3,0,130,22,108,39,0,0
567,08/05/2021,3,0,61,27,34,49,0,0
748,04/05/2021,3,3,141,48,93,49,0,0
231,08/05/2021,3,1,40,7,33,49,0,0
56,07/05/2021,3,4,61,4,57,49,0,0
311,06/05/2021,3,0,97,56,41,49,0,0
136,02/05/2021,3,2,126,16,110,49,0,0
857,01/05/2021,3,1,209,139,70,49,0,0
791,13/05/2021,3,21,107,44,63,49,0,0
396,10/05/2021,3,1,29,21,8,57,0,0
250,02/05/2021,3,0,115,57,58,59,0,0
815,05/05/2021,3,12,117,28,89,49,0,0
610,01/05/2021,3,1,66,26,40,49,0,0
477,06/05/2021,3,4,116,16,100,49,0,0
313,04/05/2021,3,0,31,18,13,57,0,0
760,05/05/2021,3,2,34,12,22,55,0,0
522,08/05/2021,3,1,61,30,31,49,0,0
561,06/05/2021,3,1,59,27,32,49,0,0
216,05/05/2021,3,1,57,17,40,49,0,0
591,07/05/2021,3,1,67,21,46,49,0,0
512,06/05/2021,3,1,61,40,21,49,0,0
356,04/05/2021,3,2,134,78,56,52,0,0
439,07/05/2021,3,8,83,12,71,49,0,0
750,03/05/2021,3,11,101,23,78,49,0,0
667,05/05/2021,3,0,10,0,10,NA,NA,NA
419,10/05/2021,3,3,107,41,66,66,0,0
274,02/05/2021,3,0,210,25,185,39,0,0
101,05/05/2021,3,1,59,19,40,49,0,0
870,01/05/2021,3,7,39,12,27,49,0,0
492,06/05/2021,3,2,35,9,26,49,0,0
550,13/05/2021,3,3,109,24,85,49,0,0
292,04/05/2021,3,6,233,23,210,49,0,0
267,08/05/2021,3,2,81,14,67,49,0,0
736,06/05/2021,3,5,100,15,85,49,0,0
624,06/05/2021,3,1,78,21,57,49,0,0
25,07/05/2021,3,2,50,11,39,49,0,0
393,07/05/2021,3,1,59,9,50,49,0,0
465,06/05/2021,3,4,263,67,196,55,0,0
431,08/05/2021,3,4,126,42,84,49,0,0
857,03/05/2021,3,1,209,20,189,49,0,0
667,04/05/2021,3,0,10,0,10,NA,NA,NA
869,10/05/2021,3,1,59,36,23,89,0,0
274,03/05/2021,3,0,210,64,146,39,0,0
101,06/05/2021,3,1,59,21,38,49,0,0
355,03/05/2021,3,3,96,8,88,55,0,0
795,07/05/2021,3,8,97,34,63,49,0,0
698,13/05/2021,3,2,114,25,89,49,0,0
292,05/05/2021,3,6,233,41,192,49,0,0
450,07/05/2021,3,10,174,46,128,49,0,0
27,07/05/2021,3,0,78,49,29,49,0,0
511,06/05/2021,3,1,75,36,39,55,0,0
46,07/05/2021,3,3,57,15,42,49,0,0
192,07/05/2021,3,0,86,9,77,49,0,0
360,06/05/2021,3,2,42,10,32,55,0,0
110,08/05/2021,3,1,86,12,74,49,0,0
750,02/05/2021,3,11,101,72,29,52,0,0
2,04/05/2021,3,2,57,57,0,NA,NA,NA
789,11/05/2021,3,0,72,48,24,64,0,0
392,02/05/2021,3,0,176,19,157,49,0,0
334,04/05/2021,3,0,58,19,39,49,0,0
870,03/05/2021,3,6,40,10,30,55,0,0
537,06/05/2021,3,3,99,96,3,88,0,0
181,13/05/2021,3,1,33,17,16,55,0,0
422,04/05/2021,3,1,78,26,52,49,0,0
666,07/05/2021,3,2,64,19,45,49,0,0
811,07/05/2021,3,3,87,18,69,49,0,0
511,05/05/2021,3,0,76,40,36,55,0,0
353,07/05/2021,3,3,49,9,40,49,0,0
597,07/05/2021,3,3,98,16,82,49,0,0
217,06/05/2021,3,1,40,25,15,52,0,0
352,08/05/2021,3,1,63,8,55,49,0,0
84,02/05/2021,3,0,20,15,5,52,0,0
818,04/05/2021,3,1,80,80,0,NA,NA,NA
592,06/05/2021,3,24,60,43,17,72,0,0
767,02/05/2021,3,0,67,6,61,49,0,0
466,04/05/2021,3,0,140,20,120,49,0,0
697,05/05/2021,3,1,108,53,55,55,0,0
69,06/05/2021,3,1,59,38,21,52,0,0
313,13/05/2021,3,0,31,28,3,77,0,0
518,04/05/2021,3,1,16,11,5,49,0,0
401,07/05/2021,3,0,79,10,69,49,0,0
770,08/05/2021,3,4,31,8,23,49,0,0
634,05/05/2021,3,1,19,18,1,127,0,0
46,08/05/2021,3,2,58,8,50,49,0,0
393,05/05/2021,3,3,57,22,35,49,0,0
356,05/05/2021,3,0,136,63,73,49,0,0
584,08/05/2021,3,1,96,28,68,49,0,0
626,03/05/2021,3,2,100,30,70,55,0,0
158,04/05/2021,3,1,23,17,6,80,0,0
869,06/05/2021,3,3,57,44,13,82,0,0
480,02/05/2021,3,0,28,7,21,49,0,0
466,05/05/2021,3,0,140,22,118,49,0,0
697,02/05/2021,3,1,108,79,29,52,0,0
702,07/05/2021,3,1,49,8,41,55,0,0
844,12/05/2021,3,0,61,15,46,55,0,0
92,05/05/2021,3,1,121,25,96,49,0,0
446,07/05/2021,3,8,125,34,91,49,0,0
811,06/05/2021,3,3,87,34,53,49,0,0
731,05/05/2021,3,7,92,55,37,57,0,0
119,08/05/2021,3,2,66,19,47,49,0,0
825,05/05/2021,3,0,146,33,113,49,0,0
846,05/05/2021,3,3,186,20,166,45,0,0
714,01/05/2021,3,0,59,7,52,49,0,0
206,03/05/2021,3,3,210,47,163,59,0,0
158,05/05/2021,3,1,23,20,3,119,0,0
419,07/05/2021,3,5,105,18,87,66,0,0
108,03/05/2021,3,0,78,8,70,49,0,0
485,05/05/2021,3,0,65,24,41,49,0,0
97,04/05/2021,3,6,101,68,33,72,0,0
175,06/05/2021,3,1,119,21,98,49,0,0
844,13/05/2021,3,0,61,10,51,55,0,0
3,04/05/2021,3,5,108,38,70,49,0,0
522,07/05/2021,3,1,61,26,35,49,0,0
164,06/05/2021,3,1,61,17,44,49,0,0
703,06/05/2021,3,1,90,58,32,52,0,0
904,08/05/2021,3,9,265,4,261,66,0,0
597,06/05/2021,3,3,98,20,78,49,0,0
712,06/05/2021,3,2,83,14,69,49,0,0
110,01/05/2021,3,1,86,5,81,49,0,0
385,01/05/2021,3,2,61,58,3,63,0,0
327,05/05/2021,3,2,66,62,4,79,0,0
130,06/05/2021,3,2,79,31,48,49,0,0
767,03/05/2021,3,0,67,14,53,49,0,0
19,06/05/2021,3,1,93,14,79,49,0,0
601,04/05/2021,3,4,64,29,35,52,0,0
504,06/05/2021,3,1,82,17,65,49,0,0
550,12/05/2021,3,6,106,19,87,49,0,0
642,05/05/2021,3,6,89,38,51,49,0,0
707,07/05/2021,3,1,39,18,21,49,0,0
164,07/05/2021,3,1,61,8,53,49,0,0
748,05/05/2021,3,3,141,40,101,49,0,0
608,08/05/2021,3,12,128,8,120,49,0,0
247,07/05/2021,3,3,90,44,46,49,0,0
637,06/05/2021,3,1,73,28,45,49,0,0
686,01/05/2021,3,0,46,11,35,49,0,0
206,02/05/2021,3,2,211,52,159,55,0,0
531,05/05/2021,3,2,57,37,20,57,0,0
224,07/05/2021,3,1,56,15,41,49,0,0
623,03/05/2021,3,0,78,8,70,49,0,0
868,05/05/2021,3,4,79,26,53,49,0,0
870,04/05/2021,3,6,40,34,6,55,0,0
492,07/05/2021,3,3,34,10,24,49,0,0
55,07/05/2021,3,1,32,2,30,49,0,0
642,04/05/2021,3,6,89,37,52,49,0,0
450,08/05/2021,3,10,174,49,125,49,0,0
524,07/05/2021,3,4,106,30,76,49,0,0
748,06/05/2021,3,3,141,38,103,49,0,0
448,08/05/2021,3,3,150,32,118,66,0,0
512,07/05/2021,3,2,60,15,45,49,0,0
907,05/05/2021,3,3,77,35,42,55,0,0
362,01/05/2021,3,4,116,102,14,72,0,0
34,04/05/2021,3,4,84,41,43,59,0,0
203,04/05/2021,3,1,39,2,37,49,0,0
254,07/05/2021,3,1,77,9,68,49,0,0
108,02/05/2021,3,0,78,7,71,49,0,0
460,06/05/2021,3,9,100,24,76,49,0,0
610,05/05/2021,3,1,66,35,31,60,0,0
702,06/05/2021,3,1,49,26,23,55,0,0
911,07/05/2021,3,0,158,1,157,49,0,0
3,05/05/2021,3,5,108,37,71,49,0,0
707,08/05/2021,3,1,39,15,24,49,0,0
164,08/05/2021,3,1,61,6,55,49,0,0
792,07/05/2021,3,0,102,16,86,49,0,0
683,05/05/2021,3,1,65,29,36,49,0,0
79,06/05/2021,3,2,44,37,7,74,0,0
838,01/05/2021,3,4,61,30,31,49,0,0
206,05/05/2021,3,17,196,146,50,64,0,0
203,05/05/2021,3,1,39,3,36,49,0,0
396,07/05/2021,3,1,29,8,21,49,0,0
366,03/05/2021,3,1,79,31,48,55,0,0
485,06/05/2021,3,0,65,16,49,49,0,0
499,05/05/2021,3,0,31,17,14,60,0,0
883,06/05/2021,3,5,99,19,80,45,0,0
181,06/05/2021,3,1,33,19,14,55,0,0
182,01/05/2021,3,2,78,3,75,49,0,0
561,07/05/2021,3,1,59,18,41,49,0,0
677,07/05/2021,3,0,40,6,34,49,0,0
162,06/05/2021,3,1,121,26,95,49,0,0
43,04/05/2021,3,1,72,40,32,60,0,0
647,01/05/2021,3,2,91,11,80,49,0,0
294,04/05/2021,3,3,114,38,76,49,0,0
830,04/05/2021,3,0,66,24,42,55,0,0
224,06/05/2021,3,1,56,12,44,49,0,0
854,02/05/2021,3,6,104,4,100,55,0,0
99,04/05/2021,3,1,166,37,129,49,0,0
499,03/05/2021,3,0,31,10,21,55,0,0
93,07/05/2021,3,3,138,23,115,49,0,0
814,06/05/2021,3,1,67,26,41,55,0,0
446,01/05/2021,3,14,119,72,47,49,0,0
561,08/05/2021,3,1,59,11,48,49,0,0
442,07/05/2021,3,0,158,22,136,49,0,0
269,07/05/2021,3,1,79,7,72,49,0,0
333,04/05/2021,3,1,56,52,4,85,0,0
728,01/05/2021,3,1,46,12,34,49,0,0
294,05/05/2021,3,12,105,45,60,49,0,0
53,05/05/2021,3,0,70,36,34,60,0,0
396,06/05/2021,3,1,29,15,14,49,0,0
588,02/05/2021,3,1,58,29,29,49,0,0
520,04/05/2021,3,0,58,17,41,49,0,0
697,04/05/2021,3,1,108,35,73,55,0,0
858,06/05/2021,3,1,80,40,40,52,0,0
55,06/05/2021,3,1,32,10,22,49,0,0
239,01/05/2021,3,0,40,34,6,57,0,0
673,06/05/2021,3,0,123,25,98,49,0,0
792,08/05/2021,3,0,102,16,86,49,0,0
350,07/05/2021,3,5,55,13,42,49,0,0
566,06/05/2021,3,1,74,16,58,49,0,0
404,01/05/2021,3,1,66,19,47,49,0,0
180,05/05/2021,3,0,41,20,21,49,0,0
256,04/05/2021,3,0,109,35,74,49,0,0
867,07/05/2021,3,1,59,25,34,49,0,0
366,02/05/2021,3,1,79,23,56,49,0,0
99,05/05/2021,3,1,166,48,118,49,0,0
355,05/05/2021,3,3,96,29,67,55,0,0
889,06/05/2021,3,1,123,25,98,45,0,0
698,07/05/2021,3,2,114,30,84,49,0,0
707,01/05/2021,3,1,39,15,24,49,0,0
567,07/05/2021,3,0,61,29,32,49,0,0
444,07/05/2021,3,5,114,33,81,49,0,0
186,06/05/2021,3,1,57,33,24,49,0,0
465,04/05/2021,3,0,267,79,188,55,0,0
484,01/05/2021,3,0,40,19,21,49,0,0
385,04/05/2021,3,2,61,52,9,55,0,0
486,04/05/2021,3,0,124,11,113,49,0,0
347,06/05/2021,3,0,62,23,39,49,0,0
177,03/05/2021,3,0,48,7,41,55,0,0
99,06/05/2021,3,1,166,39,127,49,0,0
355,02/05/2021,3,2,97,9,88,49,0,0
795,06/05/2021,3,3,102,55,47,55,0,0
329,07/05/2021,3,9,98,11,87,49,0,0
281,01/05/2021,3,4,79,9,70,49,0,0
168,08/05/2021,3,0,48,9,39,49,0,0
581,07/05/2021,3,121,104,33,71,49,0,0
251,06/05/2021,3,1,123,39,84,49,0,0
907,04/05/2021,3,3,77,34,43,55,0,0
832,01/05/2021,3,1,99,7,92,49,0,0
626,04/05/2021,3,2,100,52,48,60,0,0
96,04/05/2021,3,13,56,17,39,49,0,0
789,07/05/2021,3,0,72,10,62,49,0,0
623,02/05/2021,3,0,78,4,74,49,0,0
520,06/05/2021,3,0,58,17,41,49,0,0
870,02/05/2021,3,7,39,11,28,49,0,0
93,06/05/2021,3,3,138,36,102,49,0,0
508,07/05/2021,3,22,58,12,46,49,0,0
450,01/05/2021,3,10,174,41,133,49,0,0
159,07/05/2021,3,0,77,11,66,49,0,0
119,07/05/2021,3,2,66,20,46,49,0,0
436,06/05/2021,3,2,204,70,134,49,0,0
333,05/05/2021,3,1,56,39,17,85,0,0
431,01/05/2021,3,3,127,49,78,49,0,0
34,05/05/2021,3,3,85,43,42,64,0,0
643,05/05/2021,3,1,102,38,64,49,0,0
207,06/05/2021,3,3,60,16,44,55,0,0
392,03/05/2021,3,0,176,14,162,49,0,0
815,06/05/2021,3,12,117,27,90,49,0,0
859,03/05/2021,3,2,83,6,77,49,0,0
378,06/05/2021,3,0,84,30,54,49,0,0
550,07/05/2021,3,3,109,6,103,49,0,0
296,01/05/2021,3,1,59,28,31,49,0,0
713,08/05/2021,3,1,60,59,1,148,0,0
687,07/05/2021,3,4,83,9,74,49,0,0
399,07/05/2021,3,1,60,23,37,49,0,0
43,06/05/2021,3,1,72,33,39,55,0,0
598,01/05/2021,3,0,146,44,102,49,0,0
76,04/05/2021,3,1,92,66,26,52,0,0
732,05/05/2021,3,0,60,16,44,57,0,0
676,07/05/2021,3,4,111,21,90,49,0,0
177,02/05/2021,3,0,48,3,45,49,0,0
723,06/05/2021,3,1,80,49,31,52,0,0
733,02/05/2021,3,0,100,9,91,49,0,0
613,06/05/2021,3,0,56,27,29,49,0,0
313,07/05/2021,3,0,31,8,23,49,0,0
416,01/05/2021,3,1,33,5,28,49,0,0
746,06/05/2021,3,3,57,28,29,55,0,0
809,07/05/2021,3,8,93,13,80,49,0,0
436,07/05/2021,3,2,204,21,183,49,0,0
465,05/05/2021,3,0,267,71,196,55,0,0
136,01/05/2021,3,2,126,37,89,49,0,0
385,05/05/2021,3,1,62,56,6,77,0,0
327,04/05/2021,3,2,66,60,6,77,0,0
515,06/05/2021,3,6,106,31,75,49,0,0
480,03/05/2021,3,0,28,3,25,49,0,0
172,05/05/2021,3,2,83,33,50,55,0,0
733,03/05/2021,3,0,100,7,93,49,0,0
406,05/05/2021,3,1,38,27,11,80,0,0
98,06/05/2021,3,1,94,71,23,67,0,0
522,01/05/2021,3,1,61,61,0,NA,NA,NA
721,06/05/2021,3,63,77,64,13,57,0,0
200,08/05/2021,3,58,61,12,49,49,0,0
247,06/05/2021,3,2,91,57,34,49,0,0
217,04/05/2021,3,1,40,29,11,62,0,0
584,01/05/2021,3,1,96,38,58,49,0,0
857,04/05/2021,3,1,209,30,179,49,0,0
921,04/05/2021,3,24,151,35,116,45,0,0
629,06/05/2021,3,0,62,29,33,49,0,0
723,04/05/2021,3,1,80,52,28,60,0,0
859,04/05/2021,3,2,83,12,71,49,0,0
586,04/05/2021,3,3,80,40,40,59,0,0
337,07/05/2021,3,0,60,17,43,49,0,0
401,01/05/2021,3,0,79,25,54,49,0,0
27,08/05/2021,3,0,78,67,11,57,0,0
809,08/05/2021,3,7,94,13,81,49,0,0
393,06/05/2021,3,3,57,23,34,49,0,0
114,06/05/2021,3,0,75,67,8,89,0,0
574,01/05/2021,3,1,86,19,67,49,0,0
750,05/05/2021,3,8,104,57,47,52,0,0
818,05/05/2021,3,1,80,79,1,90,0,0
676,06/05/2021,3,6,109,42,67,49,0,0
88,05/05/2021,3,1,41,10,31,55,0,0
601,05/05/2021,3,3,65,23,42,49,0,0
795,04/05/2021,3,6,99,45,54,55,0,0
891,06/05/2021,3,1,81,35,46,49,0,0
666,01/05/2021,3,3,63,21,42,49,0,0
27,06/05/2021,3,0,78,43,35,55,0,0
444,08/05/2021,3,4,115,42,73,49,0,0
350,06/05/2021,3,3,57,29,28,49,0,0
43,05/05/2021,3,1,72,40,32,67,0,0
352,01/05/2021,3,1,63,12,51,49,0,0
206,04/05/2021,3,17,196,134,62,59,0,0
2,05/05/2021,3,2,57,47,10,83,0,0
779,07/05/2021,3,0,104,14,90,49,0,0
723,05/05/2021,3,1,80,43,37,55,0,0
188,04/05/2021,3,5,116,35,81,49,0,0
69,04/05/2021,3,1,59,38,21,57,0,0
319,07/05/2021,3,8,106,34,72,49,0,0
784,01/05/2021,3,3,46,18,28,49,0,0
567,06/05/2021,3,0,61,30,31,55,0,0
608,07/05/2021,3,14,126,9,117,49,0,0
474,06/05/2021,3,0,112,42,70,49,0,0
311,05/05/2021,3,1,96,61,35,52,0,0
439,01/05/2021,3,7,84,14,70,49,0,0
805,04/05/2021,3,2,111,46,65,60,0,0
921,05/05/2021,3,24,151,35,116,45,0,0
130,07/05/2021,3,1,80,16,64,49,0,0
738,04/05/2021,3,1,123,55,68,55,0,0
733,04/05/2021,3,0,100,13,87,49,0,0
406,04/05/2021,3,1,38,25,13,80,0,0
716,06/05/2021,3,0,104,65,39,55,0,0
491,01/05/2021,3,0,179,46,133,49,0,0
794,06/05/2021,3,0,137,24,113,55,0,0
133,07/05/2021,3,2,62,17,45,49,0,0
186,07/05/2021,3,1,57,22,35,49,0,0
333,06/05/2021,3,1,56,33,23,85,0,0
110,05/05/2021,3,1,86,49,37,49,0,0
626,05/05/2021,3,2,100,56,44,55,0,0
643,04/05/2021,3,1,102,49,53,49,0,0
207,07/05/2021,3,3,60,13,47,49,0,0
88,06/05/2021,3,1,41,11,30,55,0,0
610,02/05/2021,3,1,66,8,58,49,0,0
889,04/05/2021,3,1,123,21,102,45,0,0
808,06/05/2021,3,12,156,77,79,55,0,0
267,01/05/2021,3,2,81,17,64,49,0,0
149,06/05/2021,3,0,88,39,49,49,0,0
507,07/05/2021,3,3,197,21,176,49,0,0
654,07/05/2021,3,2,57,25,32,66,0,0
797,06/05/2021,3,1,66,30,36,55,0,0
439,05/05/2021,3,8,83,15,68,49,0,0
857,05/05/2021,3,2,208,29,179,49,0,0
791,04/05/2021,3,5,123,45,78,49,0,0
629,07/05/2021,3,1,61,24,37,49,0,0
859,02/05/2021,3,2,83,56,27,49,0,0
537,04/05/2021,3,0,102,94,8,140,0,0
724,07/05/2021,3,3,83,54,29,52,0,0
790,01/05/2021,3,0,99,28,71,66,0,0
159,06/05/2021,3,0,77,17,60,49,0,0
245,07/05/2021,3,4,93,42,51,49,0,0
253,06/05/2021,3,1,57,19,38,55,0,0
797,04/05/2021,3,2,65,39,26,55,0,0
439,06/05/2021,3,9,82,19,63,49,0,0
76,07/05/2021,3,2,91,21,70,49,0,0
791,05/05/2021,3,2,126,54,72,49,0,0
419,06/05/2021,3,3,107,32,75,66,0,0
636,03/05/2021,3,1,119,23,96,49,0,0
613,04/05/2021,3,0,56,32,24,49,0,0
319,06/05/2021,3,8,106,61,45,49,0,0
882,01/05/2021,3,0,130,9,121,39,0,0
524,06/05/2021,3,5,105,31,74,49,0,0
555,11/05/2021,3,0,117,46,71,59,0,0
253,13/05/2021,3,1,57,22,35,55,0,0
637,04/05/2021,3,2,72,31,41,49,0,0
647,06/05/2021,3,2,91,49,42,49,0,0
220,07/05/2021,3,11,92,13,79,49,0,0
757,05/05/2021,3,1,116,96,20,67,0,0
789,06/05/2021,3,0,72,41,31,60,0,0
80,05/05/2021,3,1,124,37,87,49,0,0
504,05/05/2021,3,1,82,12,70,49,0,0
508,06/05/2021,3,22,58,31,27,49,0,0
790,03/05/2021,3,0,99,14,85,66,0,0
229,07/05/2021,3,1,55,26,29,49,0,0
591,11/05/2021,3,1,67,53,14,72,0,0
350,13/05/2021,3,5,55,40,15,52,0,0
824,12/05/2021,3,0,339,10,329,55,0,0
728,06/05/2021,3,1,46,28,18,49,0,0
750,07/05/2021,3,3,109,47,62,49,0,0
410,05/05/2021,3,1,55,16,39,55,0,0
867,09/05/2021,3,1,59,18,41,49,0,0
870,08/05/2021,3,6,40,11,29,49,0,0
889,05/05/2021,3,1,123,22,101,45,0,0
698,06/05/2021,3,2,114,18,96,49,0,0
522,02/05/2021,3,1,61,43,18,52,0,0
746,07/05/2021,3,3,57,16,41,49,0,0
200,11/05/2021,3,6,113,85,28,67,0,0
399,13/05/2021,3,1,60,40,20,64,0,0
293,12/05/2021,3,1,59,25,34,49,0,0
714,05/05/2021,3,0,59,29,30,55,0,0
626,07/05/2021,3,2,100,27,73,49,0,0
732,04/05/2021,3,0,60,19,41,62,0,0
676,09/05/2021,3,4,111,21,90,49,0,0
355,07/05/2021,3,3,96,7,89,49,0,0
378,04/05/2021,3,1,83,32,51,55,0,0
716,04/05/2021,3,0,104,57,47,67,0,0
401,04/05/2021,3,0,79,51,28,55,0,0
229,13/05/2021,3,1,55,39,16,80,0,0
581,11/05/2021,3,29,196,121,75,64,0,0
251,11/05/2021,3,0,124,63,61,52,0,0
333,12/05/2021,3,1,56,46,10,85,0,0
404,05/05/2021,3,0,67,31,36,59,0,0
699,07/05/2021,3,0,62,12,50,49,0,0
531,04/05/2021,3,2,57,24,33,49,0,0
592,08/05/2021,3,3,81,31,50,49,0,0
601,06/05/2021,3,3,65,23,42,49,0,0
613,05/05/2021,3,0,56,35,21,52,0,0
337,04/05/2021,3,0,60,26,34,49,0,0
281,06/05/2021,3,4,79,64,15,62,0,0
561,13/05/2021,3,1,59,41,18,52,0,0
448,11/05/2021,3,3,150,63,87,66,0,0
350,12/05/2021,3,5,55,34,21,55,0,0
907,12/05/2021,3,3,77,37,40,55,0,0
574,05/05/2021,3,0,87,15,72,49,0,0
220,06/05/2021,3,15,88,28,60,49,0,0
830,05/05/2021,3,0,66,31,35,55,0,0
867,08/05/2021,3,1,59,26,33,49,0,0
97,07/05/2021,3,6,101,24,77,49,0,0
795,05/05/2021,3,3,102,54,48,55,0,0
301,05/05/2021,3,1,100,18,82,49,0,0
790,05/05/2021,3,1,98,43,55,66,0,0
159,11/05/2021,3,0,77,37,40,57,0,0
444,11/05/2021,3,4,115,58,57,49,0,0
251,12/05/2021,3,0,124,44,80,52,0,0
846,12/05/2021,3,3,186,7,179,45,0,0
686,06/05/2021,3,0,46,12,34,49,0,0
34,07/05/2021,3,3,85,30,55,49,0,0
820,05/05/2021,3,1,126,114,12,80,0,0
20,09/05/2021,3,2,80,25,55,49,0,0
558,04/05/2021,3,0,44,17,27,49,0,0
98,04/05/2021,3,1,94,82,12,80,0,0
239,06/05/2021,3,0,40,29,11,60,0,0
168,12/05/2021,3,0,48,32,16,72,0,0
119,11/05/2021,3,2,66,25,41,49,0,0
654,13/05/2021,3,6,53,19,34,66,0,0
824,10/05/2021,3,0,339,10,329,55,0,0
598,05/05/2021,3,0,146,102,44,55,0,0
385,07/05/2021,3,1,62,16,46,49,0,0
327,14/05/2021,3,2,66,12,54,49,0,0
592,09/05/2021,3,8,76,35,41,49,0,0
702,05/05/2021,3,1,49,42,7,55,0,0
181,05/05/2021,3,1,33,23,10,67,0,0
547,12/05/2021,3,0,74,44,30,64,0,0
442,11/05/2021,3,1,157,41,116,49,0,0
436,12/05/2021,3,2,204,71,133,49,0,0
824,11/05/2021,3,0,339,10,329,55,0,0
136,05/05/2021,3,0,128,37,91,49,0,0
34,06/05/2021,3,3,85,36,49,55,0,0
386,15/05/2021,3,4,81,11,70,49,0,0
419,08/05/2021,3,8,102,28,74,66,0,0
504,04/05/2021,3,1,82,12,70,49,0,0
814,04/05/2021,3,1,67,21,46,55,0,0
567,12/05/2021,3,0,61,28,33,55,0,0
507,11/05/2021,3,3,197,30,167,49,0,0
597,12/05/2021,3,3,98,46,52,49,0,0
907,01/05/2021,3,2,78,19,59,49,0,0
136,06/05/2021,3,0,128,36,92,49,0,0
206,07/05/2021,3,17,196,46,150,55,0,0
757,16/05/2021,3,0,117,27,90,49,0,0
419,09/05/2021,3,6,104,20,84,66,0,0
477,05/05/2021,3,4,116,22,94,49,0,0
814,05/05/2021,3,1,67,27,40,55,0,0
736,05/05/2021,3,5,100,18,82,49,0,0
687,11/05/2021,3,2,85,25,60,49,0,0
269,13/05/2021,3,1,79,17,62,49,0,0
333,02/05/2021,3,1,56,56,0,NA,NA,NA
484,06/05/2021,3,0,40,36,4,62,0,0
76,06/05/2021,3,1,92,71,21,52,0,0
921,14/05/2021,3,13,162,5,157,39,0,0
254,02/05/2021,3,1,77,5,72,49,0,0
69,02/05/2021,3,1,59,19,40,49,0,0
329,04/05/2021,3,9,98,15,83,49,0,0
159,04/05/2021,3,18,59,29,30,57,0,0
677,11/05/2021,3,0,40,18,22,49,0,0
825,13/05/2021,3,3,143,23,120,49,0,0
356,01/05/2021,3,1,135,13,122,49,0,0
484,05/05/2021,3,0,40,37,3,84,0,0
285,07/05/2021,3,0,80,11,69,49,0,0
921,15/05/2021,3,13,162,9,153,39,0,0
335,02/05/2021,3,5,81,4,77,49,0,0
858,02/05/2021,3,1,80,40,40,49,0,0
329,05/05/2021,3,9,98,12,86,49,0,0
770,04/05/2021,3,4,31,16,15,55,0,0
608,11/05/2021,3,10,130,37,93,49,0,0
597,13/05/2021,3,4,97,48,49,49,0,0
360,01/05/2021,3,1,43,14,29,49,0,0
431,06/05/2021,3,4,126,47,79,59,0,0
180,07/05/2021,3,0,41,5,36,49,0,0
410,14/05/2021,3,1,55,16,39,49,0,0
130,03/05/2021,3,2,79,8,71,49,0,0
504,03/05/2021,3,1,82,17,65,49,0,0
508,05/05/2021,3,22,58,29,29,49,0,0
721,05/05/2021,3,63,77,76,1,77,0,0
809,11/05/2021,3,4,97,37,60,49,0,0
162,02/05/2021,3,1,121,14,107,49,0,0
43,02/05/2021,3,1,72,8,64,49,0,0
110,06/05/2021,3,1,86,37,49,49,0,0
294,07/05/2021,3,1,116,22,94,49,0,0
53,15/05/2021,3,0,70,24,46,49,0,0
207,03/05/2021,3,2,61,8,53,55,0,0
795,01/05/2021,3,7,98,28,70,49,0,0
550,05/05/2021,3,3,109,26,83,49,0,0
770,05/05/2021,3,4,31,16,15,60,0,0
792,11/05/2021,3,6,96,28,68,49,0,0
436,02/05/2021,3,2,204,10,194,49,0,0
360,02/05/2021,3,1,43,7,36,49,0,0
686,05/05/2021,3,0,46,19,27,49,0,0
857,06/05/2021,3,2,208,23,185,49,0,0
732,14/05/2021,3,0,60,6,54,49,0,0
869,03/05/2021,3,2,58,52,6,85,0,0
795,02/05/2021,3,7,98,29,69,49,0,0
319,05/05/2021,3,7,107,71,36,60,0,0
746,05/05/2021,3,3,57,39,18,67,0,0
46,11/05/2021,3,2,58,43,15,93,0,0
186,02/05/2021,3,1,57,27,30,49,0,0
783,02/05/2021,3,1,79,12,67,49,0,0
362,05/05/2021,3,4,116,79,37,80,0,0
490,15/05/2021,3,5,160,8,152,49,0,0
347,02/05/2021,3,1,61,12,49,49,0,0
477,03/05/2021,3,6,114,14,100,49,0,0
716,05/05/2021,3,0,104,59,45,67,0,0
229,04/05/2021,3,1,55,39,16,74,0,0
46,05/05/2021,3,2,58,53,5,59,0,0
251,02/05/2021,3,1,123,14,109,49,0,0
500,01/05/2021,3,6,73,13,60,49,0,0
832,05/05/2021,3,0,100,28,72,49,0,0
643,15/05/2021,3,2,101,16,85,49,0,0
396,02/05/2021,3,1,29,6,23,49,0,0
558,03/05/2021,3,0,44,9,35,49,0,0
459,04/05/2021,3,3,89,36,53,49,0,0
90,04/05/2021,3,0,78,40,38,67,0,0
145,05/05/2021,3,2,56,14,42,55,0,0
253,02/05/2021,3,1,57,11,46,49,0,0
356,02/05/2021,3,1,135,9,126,49,0,0
431,05/05/2021,3,4,126,57,69,59,0,0
732,15/05/2021,3,0,60,7,53,49,0,0
789,02/05/2021,3,0,72,13,59,49,0,0
69,01/05/2021,3,1,59,30,29,49,0,0
459,05/05/2021,3,2,90,44,46,49,0,0
168,04/05/2021,3,0,48,39,9,89,0,0
904,05/05/2021,3,9,265,3,262,66,0,0
393,02/05/2021,3,1,59,10,49,49,0,0
293,01/05/2021,3,0,60,59,1,75,0,0
352,06/05/2021,3,2,62,29,33,55,0,0
757,15/05/2021,3,0,117,31,86,49,0,0
869,02/05/2021,3,2,58,59,-1,NA,NA,NA
175,01/05/2021,3,1,119,13,106,49,0,0
55,04/05/2021,3,1,32,11,21,52,0,0
794,04/05/2021,3,0,137,27,110,55,0,0
133,06/05/2021,3,2,62,23,39,55,0,0
399,02/05/2021,3,1,60,20,40,49,0,0
114,03/05/2021,3,0,75,31,44,59,0,0
404,06/05/2021,3,0,67,29,38,59,0,0
791,15/05/2021,3,21,107,27,80,49,0,0
867,03/05/2021,3,1,59,26,33,59,0,0
702,02/05/2021,3,1,49,2,47,49,0,0
55,05/05/2021,3,1,32,10,22,49,0,0
794,05/05/2021,3,0,137,24,113,55,0,0
608,06/05/2021,3,14,126,10,116,49,0,0
683,02/05/2021,3,1,65,8,57,49,0,0
43,03/05/2021,3,1,72,12,60,55,0,0
598,06/05/2021,3,0,146,105,41,60,0,0
820,15/05/2021,3,1,126,44,82,49,0,0
781,02/05/2021,3,5,78,54,24,52,0,0
858,03/05/2021,3,1,80,26,54,49,0,0
508,04/05/2021,3,22,58,35,23,52,0,0
149,05/05/2021,3,0,88,43,45,49,0,0
904,06/05/2021,3,9,265,7,258,66,0,0
512,03/05/2021,3,2,60,3,57,49,0,0
79,01/05/2021,3,1,45,24,21,49,0,0
714,06/05/2021,3,0,59,19,40,55,0,0
53,16/05/2021,3,0,70,21,49,49,0,0
20,03/05/2021,3,2,80,22,58,55,0,0
586,01/05/2021,3,4,79,78,1,85,0,0
724,04/05/2021,3,4,82,76,6,59,0,0
229,05/05/2021,3,1,55,38,17,74,0,0
25,05/05/2021,3,1,51,39,12,74,0,0
247,04/05/2021,3,2,91,56,35,49,0,0
637,01/05/2021,3,5,69,18,51,49,0,0
404,02/05/2021,3,1,66,21,45,49,0,0
820,16/05/2021,3,0,127,30,97,49,0,0
20,02/05/2021,3,4,78,17,61,49,0,0
858,01/05/2021,3,1,80,49,31,52,0,0
808,05/05/2021,3,11,157,84,73,55,0,0
561,05/05/2021,3,1,59,27,32,60,0,0
231,05/05/2021,3,1,40,18,22,55,0,0
393,04/05/2021,3,2,58,12,46,49,0,0
311,03/05/2021,3,1,96,37,59,49,0,0
439,02/05/2021,3,7,84,9,75,49,0,0
830,14/05/2021,3,0,66,31,35,49,0,0
130,02/05/2021,3,4,77,10,67,49,0,0
537,03/05/2021,3,0,102,68,34,55,0,0
550,04/05/2021,3,4,108,25,83,49,0,0
27,04/05/2021,3,0,78,49,29,55,0,0
555,05/05/2021,3,1,116,49,67,59,0,0
512,04/05/2021,3,2,60,29,31,49,0,0
356,03/05/2021,3,2,134,17,117,49,0,0
584,02/05/2021,3,1,96,22,74,49,0,0
531,15/05/2021,3,1,58,15,43,49,0,0
207,02/05/2021,3,2,61,11,50,49,0,0
795,03/05/2021,3,6,99,19,80,55,0,0
181,04/05/2021,3,1,33,20,13,55,0,0
567,04/05/2021,3,0,61,35,26,55,0,0
677,05/05/2021,3,0,40,5,35,49,0,0
56,03/05/2021,3,2,63,6,57,55,0,0
637,03/05/2021,3,2,72,12,60,49,0,0
686,02/05/2021,3,0,46,13,33,49,0,0
2,16/05/2021,3,2,57,28,29,49,0,0
629,02/05/2021,3,2,60,16,44,49,0,0
702,03/05/2021,3,1,49,6,43,55,0,0
319,04/05/2021,3,7,107,66,41,55,0,0
27,05/05/2021,3,0,78,46,32,60,0,0
792,05/05/2021,3,0,102,19,83,49,0,0
56,04/05/2021,3,2,63,25,38,59,0,0
114,01/05/2021,3,0,75,43,32,49,0,0
110,03/05/2021,3,1,86,8,78,49,0,0
732,16/05/2021,3,0,60,14,46,49,0,0
867,02/05/2021,3,1,59,11,48,49,0,0
808,04/05/2021,3,11,157,91,66,55,0,0
168,05/05/2021,3,0,48,40,8,80,0,0
353,06/05/2021,3,2,50,29,21,60,0,0
253,03/05/2021,3,1,57,8,49,55,0,0
712,01/05/2021,3,3,82,8,74,49,0,0
728,03/05/2021,3,1,46,14,32,49,0,0
818,07/05/2021,3,1,80,80,0,NA,NA,NA
65,03/05/2021,3,1,77,3,74,49,0,0
98,05/05/2021,3,1,94,76,18,80,0,0
567,05/05/2021,3,0,61,35,26,60,0,0
448,05/05/2021,3,2,151,44,107,66,0,0
654,04/05/2021,3,0,59,14,45,66,0,0
79,02/05/2021,3,2,44,17,27,49,0,0
439,04/05/2021,3,9,82,15,67,49,0,0
818,08/05/2021,3,1,80,80,0,NA,NA,NA
254,03/05/2021,3,1,77,11,66,49,0,0
337,05/05/2021,3,0,60,28,32,52,0,0
721,04/05/2021,3,63,77,70,7,77,0,0
46,06/05/2021,3,3,57,36,21,67,0,0
15,04/05/2021,3,0,31,15,16,72,0,0
217,02/05/2021,3,1,40,26,14,49,0,0
647,02/05/2021,3,2,91,21,70,49,0,0
667,06/05/2021,3,0,10,0,10,NA,NA,NA
629,04/05/2021,3,0,62,26,36,49,0,0
698,04/05/2021,3,2,114,18,96,49,0,0
159,05/05/2021,3,18,59,29,30,52,0,0
145,06/05/2021,3,2,56,17,39,55,0,0
654,03/05/2021,3,0,59,10,49,66,0,0
293,02/05/2021,3,0,60,35,25,49,0,0
431,02/05/2021,3,3,127,49,78,49,0,0
667,08/05/2021,3,0,10,0,10,NA,NA,NA
779,04/05/2021,3,0,104,48,56,55,0,0
55,02/05/2021,3,2,31,2,29,49,0,0
721,09/05/2021,3,89,51,34,17,49,0,0
555,06/05/2021,3,1,116,47,69,55,0,0
192,04/05/2021,3,0,86,48,38,52,0,0
566,03/05/2021,3,2,73,17,56,49,0,0
598,02/05/2021,3,0,146,30,116,49,0,0
667,07/05/2021,3,0,10,0,10,NA,NA,NA
419,04/05/2021,3,6,104,47,57,66,0,0
313,02/05/2021,3,0,31,1,30,49,0,0
770,09/05/2021,3,4,31,8,23,49,0,0
591,05/05/2021,3,1,67,50,17,57,0,0
436,04/05/2021,3,2,204,75,129,49,0,0
907,03/05/2021,3,2,78,11,67,49,0,0
136,03/05/2021,3,2,126,18,108,49,0,0
2,06/05/2021,3,2,57,38,19,60,0,0
676,04/05/2021,3,5,110,50,60,52,0,0
301,02/05/2021,3,1,100,23,77,49,0,0
587,10/05/2021,3,2,79,35,44,49,0,0
25,06/05/2021,3,1,51,36,15,57,0,0
350,04/05/2021,3,3,57,33,24,60,0,0
465,01/05/2021,3,0,267,73,194,55,0,0
574,03/05/2021,3,1,86,17,69,49,0,0
327,06/05/2021,3,2,66,43,23,67,0,0
207,05/05/2021,3,4,59,19,40,55,0,0
181,03/05/2021,3,1,33,9,24,55,0,0
811,10/05/2021,3,2,88,36,52,49,0,0
652,06/05/2021,3,0,69,55,14,67,0,0
399,04/05/2021,3,1,60,61,-1,NA,NA,NA
465,03/05/2021,3,1,266,41,225,55,0,0
647,03/05/2021,3,4,89,11,78,49,0,0
410,06/05/2021,3,1,55,15,40,55,0,0
869,05/05/2021,3,2,58,38,20,80,0,0
55,03/05/2021,3,2,31,1,30,49,0,0
587,09/05/2021,3,3,78,14,64,49,0,0
448,06/05/2021,3,2,151,44,107,66,0,0
399,03/05/2021,3,1,60,14,46,55,0,0
797,03/05/2021,3,2,65,16,49,55,0,0
838,03/05/2021,3,3,62,23,39,49,0,0
921,08/05/2021,3,3,172,5,167,39,0,0
335,05/05/2021,3,4,82,31,51,49,0,0
329,03/05/2021,3,12,95,7,88,49,0,0
746,09/05/2021,3,3,57,12,45,49,0,0
809,06/05/2021,3,7,94,60,34,52,0,0
15,02/05/2021,3,0,31,7,24,49,0,0
797,02/05/2021,3,2,65,17,48,49,0,0
574,04/05/2021,3,1,86,22,64,49,0,0
386,08/05/2021,3,4,81,10,71,49,0,0
224,05/05/2021,3,1,56,13,43,49,0,0
508,03/05/2021,3,22,58,12,46,49,0,0
811,09/05/2021,3,3,87,22,65,49,0,0
652,05/05/2021,3,0,69,60,9,80,0,0
512,02/05/2021,3,2,60,2,58,49,0,0
797,01/05/2021,3,2,65,26,39,49,0,0
362,03/05/2021,3,3,117,59,58,59,0,0
256,07/05/2021,3,0,109,8,101,49,0,0
515,05/05/2021,3,6,106,34,72,49,0,0
98,03/05/2021,3,1,94,28,66,55,0,0
547,09/05/2021,3,1,73,14,59,49,0,0
507,05/05/2021,3,3,197,37,160,49,0,0
436,03/05/2021,3,2,204,28,176,49,0,0
907,02/05/2021,3,2,78,9,69,49,0,0
431,03/05/2021,3,4,126,38,88,59,0,0
256,08/05/2021,3,0,109,8,101,49,0,0
130,05/05/2021,3,2,79,38,41,49,0,0
808,03/05/2021,3,11,157,36,121,55,0,0
547,10/05/2021,3,1,73,52,21,49,0,0
608,05/05/2021,3,14,126,15,111,49,0,0
825,03/05/2021,3,2,144,11,133,49,0,0
846,03/05/2021,3,2,187,28,159,45,0,0
584,03/05/2021,3,2,95,17,78,55,0,0
486,08/05/2021,3,0,124,21,103,49,0,0
347,05/05/2021,3,0,62,20,42,49,0,0
724,03/05/2021,3,4,82,45,37,59,0,0
524,10/05/2021,3,1,109,39,70,49,0,0
444,06/05/2021,3,5,114,52,62,49,0,0
474,04/05/2021,3,0,112,33,79,49,0,0
783,03/05/2021,3,1,79,15,64,59,0,0
362,04/05/2021,3,3,117,71,46,72,0,0
732,08/05/2021,3,0,60,7,53,49,0,0
65,04/05/2021,3,1,77,13,64,49,0,0
808,02/05/2021,3,11,157,55,102,49,0,0
736,10/05/2021,3,1,104,30,74,49,0,0
687,06/05/2021,3,5,82,39,43,49,0,0
683,04/05/2021,3,1,65,34,31,49,0,0
333,01/05/2021,3,1,56,55,1,127,0,0
728,04/05/2021,3,1,46,26,20,52,0,0
53,06/05/2021,3,0,70,30,40,55,0,0
20,04/05/2021,3,2,80,39,41,55,0,0
319,03/05/2021,3,0,114,20,94,49,0,0
736,09/05/2021,3,1,104,10,94,49,0,0
245,06/05/2021,3,4,93,34,59,49,0,0
597,04/05/2021,3,4,97,28,69,49,0,0
311,01/05/2021,3,0,97,37,60,49,0,0
431,04/05/2021,3,4,126,55,71,59,0,0
818,06/05/2021,3,1,80,75,5,85,0,0
779,05/05/2021,3,0,104,45,59,55,0,0
459,03/05/2021,3,3,89,27,62,49,0,0
164,10/05/2021,3,1,61,22,39,49,0,0
119,05/05/2021,3,3,65,30,35,49,0,0
269,04/05/2021,3,2,78,14,64,49,0,0
114,02/05/2021,3,0,75,31,44,49,0,0
598,03/05/2021,3,0,146,28,118,55,0,0
757,06/05/2021,3,1,116,77,39,60,0,0
335,04/05/2021,3,3,83,31,52,49,0,0
698,03/05/2021,3,2,114,12,102,49,0,0
524,09/05/2021,3,0,110,17,93,49,0,0
687,05/05/2021,3,3,84,44,40,49,0,0
825,04/05/2021,3,2,144,30,114,49,0,0
465,02/05/2021,3,1,266,50,216,49,0,0
598,04/05/2021,3,0,146,95,51,55,0,0
158,08/05/2021,3,1,23,17,6,52,0,0
347,04/05/2021,3,1,61,20,41,49,0,0
459,02/05/2021,3,3,89,28,61,49,0,0
456,10/05/2021,3,0,90,41,49,49,0,0
677,06/05/2021,3,0,40,8,32,49,0,0
192,02/05/2021,3,0,86,13,73,49,0,0
712,02/05/2021,3,2,83,1,82,49,0,0
921,07/05/2021,3,13,162,9,153,39,0,0
254,04/05/2021,3,1,77,39,38,52,0,0
716,02/05/2021,3,0,104,28,76,49,0,0
159,10/05/2021,3,0,77,28,49,49,0,0
444,05/05/2021,3,2,117,64,53,49,0,0
474,02/05/2021,3,0,112,24,88,49,0,0
217,03/05/2021,3,1,40,26,14,49,0,0
96,07/05/2021,3,14,55,17,38,49,0,0
592,04/05/2021,3,16,68,65,3,115,0,0
814,02/05/2021,3,1,67,16,51,49,0,0
149,09/05/2021,3,0,88,18,70,49,0,0
119,06/05/2021,3,1,67,21,46,49,0,0
474,03/05/2021,3,0,112,21,91,49,0,0
43,01/05/2021,3,1,72,9,63,49,0,0
327,07/05/2021,3,1,67,16,51,49,0,0
419,05/05/2021,3,6,104,41,63,66,0,0
891,02/05/2021,3,2,80,9,71,49,0,0
149,10/05/2021,3,0,88,43,45,49,0,0
231,06/05/2021,3,1,40,16,24,49,0,0
269,02/05/2021,3,1,79,4,75,49,0,0
783,01/05/2021,3,1,79,20,59,49,0,0
410,07/05/2021,3,1,55,13,42,49,0,0
781,05/05/2021,3,1,82,48,34,57,0,0
337,03/05/2021,3,0,60,7,53,49,0,0
90,09/05/2021,3,0,78,11,67,49,0,0
353,05/05/2021,3,2,50,41,9,74,0,0
683,03/05/2021,3,1,65,13,52,49,0,0
311,02/05/2021,3,0,97,34,63,49,0,0
531,07/05/2021,3,2,57,6,51,49,0,0
676,05/05/2021,3,4,111,49,62,49,0,0
329,02/05/2021,3,9,98,12,86,49,0,0
673,10/05/2021,3,0,123,25,98,49,0,0
591,06/05/2021,3,1,67,41,26,60,0,0
162,04/05/2021,3,1,121,27,94,49,0,0
500,02/05/2021,3,6,73,7,66,49,0,0
327,08/05/2021,3,1,67,12,55,49,0,0
224,04/05/2021,3,1,56,14,42,49,0,0
698,02/05/2021,3,2,114,68,46,49,0,0
27,09/05/2021,3,0,78,36,42,49,0,0
200,06/05/2021,3,3,116,58,58,55,0,0
597,02/05/2021,3,3,98,6,92,49,0,0
566,02/05/2021,3,2,73,12,61,49,0,0
410,08/05/2021,3,1,55,10,45,49,0,0
515,04/05/2021,3,6,106,45,61,49,0,0
891,03/05/2021,3,2,80,8,72,49,0,0
159,09/05/2021,3,0,77,10,67,49,0,0
245,05/05/2021,3,4,93,41,52,49,0,0
825,02/05/2021,3,2,144,8,136,49,0,0
500,03/05/2021,3,6,73,12,61,49,0,0
643,08/05/2021,3,1,102,17,85,49,0,0
335,01/05/2021,3,5,81,4,77,49,0,0
313,03/05/2021,3,0,31,6,25,49,0,0
168,09/05/2021,3,0,48,6,42,49,0,0
442,05/05/2021,3,1,157,30,127,49,0,0
247,03/05/2021,3,2,91,34,57,49,0,0
566,01/05/2021,3,1,74,27,47,49,0,0
791,08/05/2021,3,4,124,25,99,49,0,0
347,01/05/2021,3,1,61,16,45,49,0,0
814,03/05/2021,3,1,67,11,56,55,0,0
770,01/05/2021,3,4,31,8,23,49,0,0
442,06/05/2021,3,1,157,31,126,49,0,0
251,03/05/2021,3,1,123,18,105,49,0,0
360,03/05/2021,3,1,43,5,38,55,0,0
830,07/05/2021,3,0,66,17,49,49,0,0
419,01/05/2021,3,4,106,16,90,66,0,0
716,03/05/2021,3,0,104,31,73,55,0,0
713,01/05/2021,3,1,60,60,0,NA,NA,NA
809,09/05/2021,3,5,96,17,79,49,0,0
474,09/05/2021,3,0,112,16,96,49,0,0
217,01/05/2021,3,1,40,30,10,57,0,0
757,08/05/2021,3,0,117,47,70,49,0,0
254,01/05/2021,3,1,77,7,70,49,0,0
337,02/05/2021,3,0,60,12,48,49,0,0
713,02/05/2021,3,1,60,60,0,NA,NA,NA
809,10/05/2021,3,4,97,37,60,49,0,0
436,10/05/2021,3,2,204,57,147,49,0,0
333,03/05/2021,3,1,56,27,29,85,0,0
820,07/05/2021,3,0,127,29,98,49,0,0
335,03/05/2021,3,5,81,6,75,49,0,0
98,02/05/2021,3,1,94,16,78,49,0,0
27,02/05/2021,3,0,78,78,0,NA,NA,NA
119,10/05/2021,3,2,66,20,46,49,0,0
474,10/05/2021,3,0,112,47,65,49,0,0
846,01/05/2021,3,2,187,12,175,55,0,0
203,06/05/2021,3,1,39,8,31,49,0,0
676,03/05/2021,3,4,111,20,91,49,0,0
301,07/05/2021,3,1,100,27,73,49,0,0
164,01/05/2021,3,1,61,9,52,49,0,0
245,10/05/2021,3,5,92,30,62,49,0,0
162,08/05/2021,3,0,122,13,109,49,0,0
846,02/05/2021,3,2,187,8,179,45,0,0
386,06/05/2021,3,3,82,36,46,49,0,0
629,03/05/2021,3,3,59,17,42,49,0,0
891,07/05/2021,3,1,81,9,72,49,0,0
524,02/05/2021,3,2,108,20,88,49,0,0
442,10/05/2021,3,1,157,48,109,49,0,0
247,08/05/2021,3,3,90,53,37,49,0,0
79,03/05/2021,3,2,44,9,35,55,0,0
158,07/05/2021,3,1,23,11,12,49,0,0
781,03/05/2021,3,4,79,30,49,49,0,0
808,07/05/2021,3,11,157,49,108,49,0,0
547,02/05/2021,3,1,73,10,63,49,0,0
245,09/05/2021,3,5,92,28,64,49,0,0
192,09/05/2021,3,0,86,32,54,49,0,0
637,02/05/2021,3,5,69,18,51,49,0,0
203,07/05/2021,3,1,39,13,26,49,0,0
224,03/05/2021,3,1,56,14,42,49,0,0
724,06/05/2021,3,2,84,68,16,80,0,0
229,03/05/2021,3,1,55,18,37,55,0,0
444,09/05/2021,3,4,115,28,87,49,0,0
436,09/05/2021,3,2,204,21,183,49,0,0
712,03/05/2021,3,2,83,1,82,49,0,0
96,08/05/2021,3,14,55,18,37,49,0,0
347,03/05/2021,3,1,61,5,56,49,0,0
301,06/05/2021,3,1,100,23,77,49,0,0
561,01/05/2021,3,1,59,18,41,49,0,0
555,09/05/2021,3,0,117,25,92,49,0,0
597,09/05/2021,3,2,99,9,90,49,0,0
293,03/05/2021,3,0,60,22,38,49,0,0
96,09/05/2021,3,14,55,10,45,49,0,0
396,03/05/2021,3,1,29,9,20,49,0,0
329,06/05/2021,3,9,98,10,88,49,0,0
587,02/05/2021,3,3,78,14,64,49,0,0
591,09/05/2021,3,1,67,16,51,49,0,0
393,10/05/2021,3,1,59,27,32,49,0,0
500,08/05/2021,3,5,74,16,58,49,0,0
327,09/05/2021,3,1,67,7,60,49,0,0
65,02/05/2021,3,0,78,2,76,49,0,0
459,06/05/2021,3,2,90,44,46,49,0,0
736,01/05/2021,3,5,100,12,88,49,0,0
353,10/05/2021,3,1,51,49,2,59,0,0
186,10/05/2021,3,1,57,36,21,57,0,0
907,08/05/2021,3,3,77,15,62,49,0,0
386,09/05/2021,3,4,81,7,74,49,0,0
676,02/05/2021,3,5,110,22,88,49,0,0
98,07/05/2021,3,1,94,27,67,49,0,0
794,01/05/2021,3,0,137,9,128,55,0,0
145,10/05/2021,3,4,54,24,30,55,0,0
350,10/05/2021,3,5,55,40,15,52,0,0
846,07/05/2021,3,3,186,6,180,45,0,0
643,09/05/2021,3,2,101,20,81,49,0,0
779,02/05/2021,3,0,104,12,92,49,0,0
459,07/05/2021,3,2,90,45,45,49,0,0
27,03/05/2021,3,0,78,16,62,55,0,0
200,10/05/2021,3,1,118,76,42,55,0,0
462,10/05/2021,3,0,189,3,186,55,0,0
333,09/05/2021,3,1,56,24,32,79,0,0
53,09/05/2021,3,0,70,35,35,49,0,0
224,02/05/2021,3,1,56,18,38,49,0,0
716,07/05/2021,3,0,104,30,74,49,0,0
149,01/05/2021,3,0,88,8,80,49,0,0
231,10/05/2021,3,0,41,29,12,57,0,0
15,10/05/2021,3,0,31,16,15,64,0,0
79,09/05/2021,3,1,45,12,33,49,0,0
256,09/05/2021,3,0,109,8,101,49,0,0
592,02/05/2021,3,22,62,30,32,49,0,0
313,06/05/2021,3,0,31,24,7,63,0,0
90,03/05/2021,3,0,78,8,70,49,0,0
555,10/05/2021,3,0,117,54,63,55,0,0
192,10/05/2021,3,0,86,56,30,52,0,0
217,09/05/2021,3,1,40,21,19,49,0,0
830,10/05/2021,3,0,66,25,41,49,0,0
515,02/05/2021,3,6,106,17,89,49,0,0
550,06/05/2021,3,2,110,14,96,49,0,0
168,01/05/2021,3,0,48,16,32,49,0,0
581,10/05/2021,3,29,196,110,86,52,0,0
253,10/05/2021,3,1,57,19,38,55,0,0
712,04/05/2021,3,2,83,16,67,49,0,0
203,09/05/2021,3,0,40,7,33,49,0,0
515,03/05/2021,3,6,106,24,82,49,0,0
181,07/05/2021,3,1,33,12,21,49,0,0
90,02/05/2021,3,1,77,8,69,49,0,0
591,10/05/2021,3,1,67,51,16,67,0,0
654,10/05/2021,3,5,54,13,41,66,0,0
500,05/05/2021,3,5,74,14,60,49,0,0
486,09/05/2021,3,0,124,12,112,49,0,0
419,03/05/2021,3,6,104,22,82,66,0,0
337,06/05/2021,3,0,60,18,42,49,0,0
159,03/05/2021,3,18,59,16,43,49,0,0
904,09/05/2021,3,9,265,2,263,66,0,0
654,01/05/2021,3,0,59,12,47,66,0,0
637,05/05/2021,3,2,72,31,41,49,0,0
643,10/05/2021,3,2,101,39,62,49,0,0
789,03/05/2021,3,0,72,14,58,55,0,0
814,07/05/2021,3,1,67,21,46,49,0,0
27,01/05/2021,3,1,77,77,0,NA,NA,NA
904,10/05/2021,3,9,265,5,260,66,0,0
251,01/05/2021,3,1,123,19,104,49,0,0
712,05/05/2021,3,2,83,27,56,49,0,0
791,09/05/2021,3,0,128,17,111,49,0,0
419,02/05/2021,3,4,106,9,97,66,0,0
313,01/05/2021,3,0,31,3,28,49,0,0
721,01/05/2021,3,64,76,57,19,62,0,0
677,04/05/2021,3,0,40,6,34,49,0,0
15,01/05/2021,3,0,31,10,21,49,0,0
907,06/05/2021,3,3,77,32,45,49,0,0
256,10/05/2021,3,0,109,37,72,49,0,0
592,03/05/2021,3,23,61,27,34,59,0,0
98,01/05/2021,3,1,94,16,78,49,0,0
713,03/05/2021,3,1,60,39,21,85,0,0
792,04/05/2021,3,0,102,24,78,49,0,0
192,01/05/2021,3,0,86,20,66,49,0,0
356,06/05/2021,3,0,136,56,80,49,0,0
386,10/05/2021,3,3,82,45,37,49,0,0
779,03/05/2021,3,0,104,25,79,55,0,0
508,01/05/2021,3,1,79,16,63,49,0,0
721,02/05/2021,3,64,76,46,30,57,0,0
119,04/05/2021,3,2,66,25,41,49,0,0
393,01/05/2021,3,1,59,10,49,49,0,0
490,10/05/2021,3,5,160,5,155,49,0,0
20,01/05/2021,3,4,78,18,60,49,0,0
698,01/05/2021,3,2,114,114,0,NA,NA,NA
746,03/05/2021,3,2,58,14,44,55,0,0
245,04/05/2021,3,4,93,34,59,49,0,0
512,01/05/2021,3,2,60,7,53,49,0,0
791,10/05/2021,3,17,111,29,82,49,0,0
130,01/05/2021,3,4,77,28,49,49,0,0
716,01/05/2021,3,0,104,33,71,49,0,0
567,03/05/2021,3,0,61,16,45,55,0,0
608,04/05/2021,3,13,127,14,113,49,0,0
436,01/05/2021,3,2,204,13,191,49,0,0
818,09/05/2021,3,1,80,78,2,85,0,0
592,01/05/2021,3,20,64,43,21,49,0,0
329,01/05/2021,3,9,98,15,83,49,0,0
794,02/05/2021,3,0,137,8,129,55,0,0
353,04/05/2021,3,2,50,36,14,55,0,0
683,01/05/2021,3,1,65,15,50,49,0,0
327,10/05/2021,3,1,67,43,24,59,0,0
515,01/05/2021,3,2,110,22,88,49,0,0
337,01/05/2021,3,0,60,10,50,49,0,0
168,03/05/2021,3,0,48,15,33,59,0,0
904,04/05/2021,3,9,265,3,262,66,0,0
597,01/05/2021,3,4,97,6,91,49,0,0
441,10/05/2021,3,0,168,18,150,55,0,0
629,01/05/2021,3,0,62,16,46,49,0,0
724,01/05/2021,3,4,82,45,37,49,0,0
794,03/05/2021,3,0,137,15,122,55,0,0
231,04/05/2021,3,1,40,14,26,55,0,0
825,01/05/2021,3,2,144,15,129,49,0,0
820,10/05/2021,3,0,127,93,34,64,0,0
779,01/05/2021,3,0,104,16,88,49,0,0
808,01/05/2021,3,11,157,88,69,49,0,0
168,02/05/2021,3,0,48,11,37,49,0,0
555,04/05/2021,3,1,116,55,61,59,0,0
162,01/05/2021,3,1,121,17,104,49,0,0
732,10/05/2021,3,0,60,22,38,57,0,0
396,01/05/2021,3,1,29,7,22,49,0,0
814,01/05/2021,3,1,67,50,17,52,0,0
567,02/05/2021,3,0,61,8,53,49,0,0
133,08/05/2021,3,2,62,15,47,49,0,0
186,04/05/2021,3,1,57,36,21,49,0,0
757,10/05/2021,3,0,117,103,14,80,0,0
65,01/05/2021,3,0,78,11,67,49,0,0
55,01/05/2021,3,2,31,7,24,49,0,0
673,02/05/2021,3,0,123,25,98,49,0,0
145,08/05/2021,3,3,55,6,49,49,0,0
162,03/05/2021,3,1,121,13,108,49,0,0
203,01/05/2021,3,1,39,26,13,57,0,0
676,01/05/2021,3,5,110,24,86,49,0,0
181,01/05/2021,3,2,32,16,16,49,0,0
587,01/05/2021,3,3,78,18,60,49,0,0
442,08/05/2021,3,0,158,29,129,49,0,0
186,03/05/2021,3,1,57,16,41,49,0,0
410,01/05/2021,3,2,54,8,46,49,0,0
207,01/05/2021,3,2,61,12,49,49,0,0
891,04/05/2021,3,2,80,41,39,49,0,0
746,01/05/2021,3,2,58,10,48,49,0,0
555,08/05/2021,3,1,116,15,101,49,0,0
393,03/05/2021,3,2,58,11,47,49,0,0
203,02/05/2021,3,1,39,4,35,49,0,0
224,01/05/2021,3,1,56,19,37,49,0,0
891,05/05/2021,3,2,80,37,43,49,0,0
159,02/05/2021,3,18,59,15,44,49,0,0
581,08/05/2021,3,137,88,29,59,49,0,0
597,03/05/2021,3,4,97,15,82,49,0,0
327,02/05/2021,3,2,66,9,57,49,0,0
789,01/05/2021,3,0,72,15,57,49,0,0
698,05/05/2021,3,2,114,21,93,49,0,0
164,03/05/2021,3,1,61,6,55,49,0,0
145,07/05/2021,3,2,56,13,43,49,0,0
350,02/05/2021,3,3,57,12,45,49,0,0
410,02/05/2021,3,1,55,6,49,49,0,0
867,01/05/2021,3,1,59,20,39,49,0,0
301,04/05/2021,3,1,100,22,78,49,0,0
524,03/05/2021,3,4,106,20,86,49,0,0
200,07/05/2021,3,56,63,15,48,49,0,0
192,03/05/2021,3,0,86,19,67,49,0,0
203,03/05/2021,3,1,39,3,36,49,0,0
869,01/05/2021,3,2,58,57,1,93,0,0
301,01/05/2021,3,1,100,50,50,49,0,0
561,03/05/2021,3,1,59,16,43,49,0,0
555,07/05/2021,3,1,116,22,94,49,0,0
269,03/05/2021,3,1,79,4,75,49,0,0
386,02/05/2021,3,3,82,8,74,49,0,0
781,01/05/2021,3,3,80,66,14,52,0,0
319,01/05/2021,3,0,114,26,88,49,0,0
770,03/05/2021,3,4,31,7,24,49,0,0
687,08/05/2021,3,4,83,11,72,49,0,0
56,02/05/2021,3,4,61,5,56,49,0,0
53,03/05/2021,3,0,70,14,56,55,0,0
65,06/05/2021,3,1,77,13,64,49,0,0
459,01/05/2021,3,3,89,44,45,49,0,0
561,02/05/2021,3,1,59,11,48,49,0,0
25,08/05/2021,3,2,50,17,33,49,0,0
350,03/05/2021,3,3,57,9,48,49,0,0
643,01/05/2021,3,0,103,13,90,49,0,0
254,06/05/2021,3,1,77,45,32,49,0,0
891,01/05/2021,3,2,80,6,74,49,0,0
159,01/05/2021,3,18,59,16,43,49,0,0
507,08/05/2021,3,3,197,17,180,49,0,0
654,02/05/2021,3,0,59,17,42,66,0,0
256,02/05/2021,3,0,109,5,104,49,0,0
347,07/05/2021,3,0,62,14,48,49,0,0
550,01/05/2021,3,3,109,11,98,49,0,0
547,01/05/2021,3,1,73,15,58,49,0,0
591,08/05/2021,3,1,67,14,53,49,0,0
251,04/05/2021,3,1,123,53,70,52,0,0
667,01/05/2021,3,0,10,0,10,NA,NA,NA
20,07/05/2021,3,2,80,16,64,49,0,0
181,02/05/2021,3,1,33,11,22,49,0,0
567,01/05/2021,3,0,61,34,27,49,0,0
353,08/05/2021,3,3,49,12,37,49,0,0
253,04/05/2021,3,1,57,31,26,55,0,0
667,03/05/2021,3,0,10,0,10,NA,NA,NA
781,07/05/2021,3,1,82,36,46,49,0,0
301,03/05/2021,3,1,100,11,89,49,0,0
164,02/05/2021,3,1,61,13,48,49,0,0
677,08/05/2021,3,0,40,5,35,49,0,0
247,02/05/2021,3,2,91,59,32,52,0,0
667,02/05/2021,3,0,10,0,10,NA,NA,NA
781,06/05/2021,3,1,82,53,29,52,0,0
508,02/05/2021,3,22,58,11,47,49,0,0
736,02/05/2021,3,5,100,4,96,49,0,0
448,07/05/2021,3,2,151,23,128,66,0,0
15,03/05/2021,3,0,31,12,19,55,0,0
818,03/05/2021,3,1,80,80,0,NA,NA,NA
779,06/05/2021,3,0,104,48,56,55,0,0
550,02/05/2021,3,3,109,4,105,49,0,0
770,02/05/2021,3,4,31,4,27,49,0,0
231,07/05/2021,3,1,40,27,13,52,0,0
269,01/05/2021,3,1,79,5,74,49,0,0
818,01/05/2021,3,1,80,77,3,95,0,0
515,07/05/2021,3,6,106,30,76,49,0,0
550,03/05/2021,3,4,108,5,103,49,0,0
587,03/05/2021,3,3,78,16,62,49,0,0
245,08/05/2021,3,4,93,67,26,55,0,0
253,01/05/2021,3,1,57,19,38,49,0,0
921,02/05/2021,3,22,153,3,150,45,0,0
335,07/05/2021,3,4,82,8,74,49,0,0
724,02/05/2021,3,4,82,31,51,49,0,0
811,03/05/2021,3,3,87,33,54,49,0,0
904,07/05/2021,3,9,265,6,259,66,0,0
399,01/05/2021,3,1,60,21,39,49,0,0
2,01/05/2021,3,2,57,48,9,62,0,0
592,07/05/2021,3,13,71,28,43,49,0,0
319,02/05/2021,3,0,114,19,95,49,0,0
673,01/05/2021,3,0,123,32,91,49,0,0
591,03/05/2021,3,1,67,3,64,55,0,0
247,01/05/2021,3,2,91,61,30,49,0,0
2,02/05/2021,3,2,57,38,19,52,0,0
867,06/05/2021,3,1,59,47,12,72,0,0
90,01/05/2021,3,1,77,12,65,49,0,0
652,02/05/2021,3,0,69,4,65,49,0,0
350,01/05/2021,3,3,57,20,37,49,0,0
2,03/05/2021,3,2,57,35,22,55,0,0
20,06/05/2021,3,1,81,37,44,55,0,0
229,01/05/2021,3,1,55,18,37,49,0,0
652,03/05/2021,3,0,69,4,65,55,0,0
474,01/05/2021,3,0,112,39,73,49,0,0
327,03/05/2021,3,2,66,10,56,55,0,0
335,06/05/2021,3,4,82,40,42,49,0,0
524,01/05/2021,3,2,108,22,86,49,0,0
792,02/05/2021,3,0,102,26,76,49,0,0
56,01/05/2021,3,4,61,11,50,49,0,0
921,01/05/2021,3,3,172,5,167,45,0,0
65,07/05/2021,3,1,77,4,73,49,0,0
746,02/05/2021,3,2,58,5,53,49,0,0
677,02/05/2021,3,0,40,4,36,49,0,0
186,01/05/2021,3,1,57,38,19,49,0,0
158,03/05/2021,3,1,23,9,14,55,0,0
869,07/05/2021,3,2,58,58,0,NA,NA,NA
811,02/05/2021,3,3,87,29,58,49,0,0
677,03/05/2021,3,0,40,2,38,49,0,0
410,03/05/2021,3,1,55,7,48,55,0,0
547,03/05/2021,3,3,71,16,55,49,0,0
442,03/05/2021,3,1,157,11,146,49,0,0
327,01/05/2021,3,2,66,24,42,49,0,0
149,02/05/2021,3,0,88,9,79,49,0,0
353,02/05/2021,3,3,49,14,35,49,0,0
386,01/05/2021,3,3,82,20,62,49,0,0
811,01/05/2021,3,3,87,22,65,49,0,0
904,02/05/2021,3,9,265,2,263,66,0,0
531,01/05/2021,3,2,57,4,53,49,0,0
229,02/05/2021,3,1,55,12,43,49,0,0
448,03/05/2021,3,2,151,11,140,66,0,0
531,02/05/2021,3,2,57,15,42,49,0,0
149,03/05/2021,3,0,88,13,75,49,0,0
904,03/05/2021,3,9,265,2,263,66,0,0
791,03/05/2021,3,4,124,18,106,49,0,0
673,03/05/2021,3,0,123,18,105,49,0,0
555,03/05/2021,3,1,116,15,101,55,0,0
757,01/05/2021,3,0,117,30,87,49,0,0
736,03/05/2021,3,5,100,12,88,49,0,0
353,03/05/2021,3,3,49,10,39,55,0,0
757,02/05/2021,3,0,117,11,106,49,0,0
721,03/05/2021,3,63,77,44,33,49,0,0
200,03/05/2021,3,57,62,17,45,55,0,0
732,03/05/2021,3,0,60,11,49,49,0,0
770,07/05/2021,3,4,31,5,26,49,0,0
145,03/05/2021,3,2,56,5,51,55,0,0
830,01/05/2021,3,0,66,16,50,49,0,0
524,08/05/2021,3,1,109,12,97,49,0,0
46,03/05/2021,3,1,59,9,50,55,0,0
158,01/05/2021,3,1,23,11,12,49,0,0
736,08/05/2021,3,1,104,9,95,49,0,0
25,02/05/2021,3,1,51,14,37,49,0,0
158,02/05/2021,3,1,23,7,16,49,0,0
713,04/05/2021,3,1,60,57,3,85,0,0
46,02/05/2021,3,1,59,4,55,49,0,0
96,03/05/2021,3,13,56,12,44,49,0,0
547,04/05/2021,3,2,72,44,28,60,0,0
200,02/05/2021,3,57,62,15,47,49,0,0
386,03/05/2021,3,3,82,5,77,49,0,0
746,04/05/2021,3,3,57,28,29,55,0,0
555,02/05/2021,3,1,116,13,103,49,0,0
531,03/05/2021,3,2,57,10,47,49,0,0
547,05/05/2021,3,2,72,47,25,60,0,0
608,02/05/2021,3,11,129,12,117,49,0,0
486,01/05/2021,3,0,124,19,105,49,0,0
561,04/05/2021,3,1,59,27,32,60,0,0
809,02/05/2021,3,8,93,17,76,49,0,0
643,02/05/2021,3,0,103,11,92,49,0,0
713,05/05/2021,3,1,60,59,1,85,0,0
507,02/05/2021,3,4,196,12,184,49,0,0
830,02/05/2021,3,0,66,8,58,49,0,0
90,05/05/2021,3,0,78,39,39,60,0,0
687,02/05/2021,3,5,82,7,75,49,0,0
256,03/05/2021,3,0,109,12,97,49,0,0
524,04/05/2021,3,1,109,40,69,49,0,0
687,03/05/2021,3,3,84,27,57,49,0,0
830,03/05/2021,3,0,66,6,60,49,0,0
673,04/05/2021,3,0,123,29,94,49,0,0
809,03/05/2021,3,8,93,10,83,49,0,0
732,02/05/2021,3,0,60,6,54,49,0,0
811,04/05/2021,3,3,87,34,53,49,0,0
245,03/05/2021,3,4,93,23,70,49,0,0
53,01/05/2021,3,0,70,32,38,49,0,0
164,05/05/2021,3,1,61,24,37,49,0,0
608,03/05/2021,3,11,129,11,118,49,0,0
256,01/05/2021,3,0,109,14,95,49,0,0
524,05/05/2021,3,2,108,38,70,49,0,0
792,03/05/2021,3,0,102,13,89,49,0,0
791,01/05/2021,3,0,128,21,107,49,0,0
587,05/05/2021,3,3,78,31,47,49,0,0
119,02/05/2021,3,2,66,15,51,49,0,0
53,02/05/2021,3,0,70,23,47,49,0,0
811,05/05/2021,3,3,87,37,50,49,0,0
231,02/05/2021,3,1,40,6,34,49,0,0
486,02/05/2021,3,0,124,10,114,49,0,0
149,04/05/2021,3,0,88,47,41,49,0,0
591,02/05/2021,3,1,67,4,63,49,0,0
791,02/05/2021,3,0,128,21,107,49,0,0
164,04/05/2021,3,1,61,26,35,49,0,0
145,02/05/2021,3,2,56,8,48,49,0,0
643,03/05/2021,3,1,102,17,85,49,0,0
587,04/05/2021,3,3,78,38,40,49,0,0
133,02/05/2021,3,2,62,13,49,49,0,0
96,02/05/2021,3,13,56,27,29,49,0,0
736,04/05/2021,3,5,100,27,73,49,0,0
581,02/05/2021,3,151,74,27,47,49,0,0
732,01/05/2021,3,0,60,8,52,49,0,0
673,05/05/2021,3,0,123,29,94,49,0,0
25,03/05/2021,3,1,51,19,32,49,0,0
820,01/05/2021,3,0,127,30,97,49,0,0
507,06/05/2021,3,3,197,32,165,49,0,0
820,02/05/2021,3,0,127,15,112,49,0,0
809,05/05/2021,3,7,94,63,31,52,0,0
486,03/05/2021,3,0,124,8,116,49,0,0
133,05/05/2021,3,3,61,26,35,55,0,0
757,03/05/2021,3,0,117,28,89,55,0,0
200,05/05/2021,3,3,116,65,51,55,0,0
820,03/05/2021,3,0,127,33,94,55,0,0
581,05/05/2021,3,5,220,117,103,55,0,0
818,02/05/2021,3,1,80,78,2,95,0,0
581,06/05/2021,3,6,219,96,123,49,0,0
96,01/05/2021,3,13,56,37,19,57,0,0
792,06/05/2021,3,0,102,23,79,49,0,0
921,03/05/2021,3,23,152,24,128,45,0,0
904,01/05/2021,3,8,266,2,264,66,0,0
410,04/05/2021,3,1,55,24,31,55,0,0
245,01/05/2021,3,5,92,81,11,67,0,0
386,04/05/2021,3,3,82,36,46,49,0,0
25,01/05/2021,3,1,51,15,36,49,0,0
256,05/05/2021,3,0,109,39,70,49,0,0
353,01/05/2021,3,3,49,16,33,49,0,0
386,05/05/2021,3,2,83,39,44,49,0,0
444,01/05/2021,3,5,114,28,86,49,0,0
757,04/05/2021,3,0,117,83,34,60,0,0
555,01/05/2021,3,2,115,16,99,49,0,0
820,04/05/2021,3,0,127,109,18,72,0,0
687,01/05/2021,3,4,83,14,69,49,0,0
53,04/05/2021,3,0,70,39,31,60,0,0
809,01/05/2021,3,8,93,18,75,49,0,0
96,05/05/2021,3,13,56,19,37,49,0,0
231,01/05/2021,3,1,40,8,32,49,0,0
486,05/05/2021,3,0,124,18,106,49,0,0
792,01/05/2021,3,0,102,39,63,49,0,0
531,08/05/2021,3,2,57,5,52,49,0,0
652,01/05/2021,3,0,69,5,64,49,0,0
486,07/05/2021,3,0,124,13,111,49,0,0
46,01/05/2021,3,4,56,18,38,49,0,0
203,08/05/2021,3,0,40,11,29,49,0,0
145,01/05/2021,3,2,56,11,45,49,0,0
643,07/05/2021,3,2,101,22,79,49,0,0
448,01/05/2021,3,2,151,12,139,66,0,0
158,06/05/2021,3,1,23,15,8,67,0,0
119,01/05/2021,3,2,66,36,30,49,0,0
2,08/05/2021,3,2,57,45,12,57,0,0
200,01/05/2021,3,55,64,31,33,49,0,0
732,06/05/2021,3,0,60,24,36,57,0,0
581,01/05/2021,3,126,99,38,61,49,0,0
820,06/05/2021,3,0,127,107,20,74,0,0
591,01/05/2021,3,1,67,8,59,49,0,0
486,06/05/2021,3,0,124,15,109,49,0,0
133,01/05/2021,3,0,64,8,56,49,0,0
531,06/05/2021,3,2,57,18,39,49,0,0
442,01/05/2021,3,1,157,20,137,49,0,0
791,06/05/2021,3,2,126,50,76,49,0,0
200,04/05/2021,3,3,116,57,59,55,0,0
830,06/05/2021,3,0,66,22,44,49,0,0
581,04/05/2021,3,5,220,127,93,55,0,0
2,07/05/2021,3,3,56,35,21,49,0,0
448,04/05/2021,3,2,151,39,112,66,0,0
53,07/05/2021,3,0,70,24,46,49,0,0
652,04/05/2021,3,0,69,49,20,59,0,0
732,07/05/2021,3,0,60,10,50,49,0,0
145,04/05/2021,3,2,56,23,33,55,0,0
757,07/05/2021,3,0,117,42,75,49,0,0
687,04/05/2021,3,3,84,45,39,49,0,0
791,07/05/2021,3,1,127,23,104,49,0,0
809,04/05/2021,3,7,94,45,49,49,0,0
820,08/05/2021,3,0,127,26,101,49,0,0
25,04/05/2021,3,1,51,42,9,83,0,0
921,06/05/2021,3,25,150,32,118,45,0,0
133,04/05/2021,3,2,62,33,29,55,0,0
96,06/05/2021,3,13,56,28,28,49,0,0
507,04/05/2021,3,3,197,38,159,49,0,0
256,06/05/2021,3,0,109,33,76,49,0,0
442,04/05/2021,3,1,157,39,118,49,0,0
643,06/05/2021,3,2,101,44,57,49,0,0
444,04/05/2021,3,2,117,67,50,49,0,0
386,07/05/2021,3,4,81,7,74,49,0,0
591,04/05/2021,3,1,67,41,26,49,0,0
53,08/05/2021,3,0,70,23,47,49,0,0
46,04/05/2021,3,1,59,46,13,59,0,0
830,08/05/2021,3,0,66,13,53,49,0,0
119,03/05/2021,3,3,65,8,57,49,0,0
444,03/05/2021,3,5,114,28,86,49,0,0
507,03/05/2021,3,4,196,13,183,49,0,0
245,02/05/2021,3,5,92,62,30,49,0,0
442,02/05/2021,3,1,157,15,142,49,0,0
444,02/05/2021,3,5,114,22,92,49,0,0
231,03/05/2021,3,1,40,11,29,49,0,0
581,03/05/2021,3,5,220,34,186,49,0,0
448,02/05/2021,3,2,151,13,138,66,0,0
133,03/05/2021,3,2,62,16,46,55,0,0
507,01/05/2021,3,1,199,22,177,49,0,0
608,01/05/2021,3,13,127,13,114,49,0,0
677,01/05/2021,3,0,40,10,30,49,0,0
